key,other,oligo,astrocyte,microglia,neuron,n_cells
ACGCCTGACACGCGCT-1_V12N28-333_D1,0,0,0,0,0,0
TACCGATCCAACACTT-1_V12N28-333_D1,3,0,1,0,0,4
GATAAGGGACGATTAG-1_V12N28-333_D1,3,2,0,2,0,7
TGTTGGCTGGCGGAAG-1_V12N28-333_D1,5,1,0,0,0,6
GCGAGGGACTGCTAGA-1_V12N28-333_D1,2,5,2,0,0,9
GCGCGTTTAAATCGTA-1_V12N28-333_D1,5,2,2,0,0,9
GACGACTTTCCAAGAA-1_V12N28-333_D1,1,0,3,0,0,4
ATACCCTGGCTCAAAT-1_V12N28-333_D1,1,2,4,0,0,7
TAACCGTCCAGTTCAT-1_V12N28-333_D1,5,0,1,0,0,6
CAAGGGAGTGTATTTG-1_V12N28-333_D1,3,0,1,0,0,4
TTATTTCATCCCAAAC-1_V12N28-333_D1,2,0,0,0,0,2
TATGGCAGACTTTCGA-1_V12N28-333_D1,2,0,0,0,0,2
AAACGGGTTGGTATCC-1_V12N28-333_D1,0,1,2,1,0,4
GACGGGATGTCTTATG-1_V12N28-333_D1,1,0,2,1,0,4
CGCGTGCTATCAACGA-1_V12N28-333_D1,0,0,1,0,0,1
CACATAAGGCGACCGT-1_V12N28-333_D1,1,0,0,0,0,1
ATACGCCGATCTACCG-1_V12N28-333_D1,0,0,0,0,0,0
GTGTGAGCCGAGGTGC-1_V12N28-333_D1,0,0,0,0,0,0
GGGAACCACCTGTTTC-1_V12N28-333_D1,0,0,0,0,0,0
ACAGGAGGCGCAGCCG-1_V12N28-333_D1,1,0,1,2,0,4
AGGCAATACGGAGGAC-1_V12N28-333_D1,2,0,0,0,0,2
TGGTGTGACAGACGAT-1_V12N28-333_D1,1,1,0,2,0,4
ATCTATCGATGATCAA-1_V12N28-333_D1,3,0,0,3,0,6
CGGTAACAAGATACAT-1_V12N28-333_D1,2,0,0,0,0,2
TCGCCGGAGAGTCTTA-1_V12N28-333_D1,3,0,0,1,0,4
GGAGGAGTGTGTTTAT-1_V12N28-333_D1,2,0,1,0,0,3
TTAGGTGTGACTGGTC-1_V12N28-333_D1,4,3,0,0,0,7
CAGGGCTAACGAAACC-1_V12N28-333_D1,1,0,2,0,0,3
CCCGTGGGTTAATTGA-1_V12N28-333_D1,1,3,1,1,0,6
GACCGACCGCTAATAT-1_V12N28-333_D1,5,3,1,0,0,9
GGTATCAAGCATAGAA-1_V12N28-333_D1,1,0,1,0,0,2
TGCATGAGTAGATTCG-1_V12N28-333_D1,2,1,0,1,0,4
AATTCCAACTTGGTGA-1_V12N28-333_D1,3,0,2,0,0,5
TGCCGATGTCATCAAT-1_V12N28-333_D1,2,2,0,2,0,6
GCTGGGTCCGCTGTTA-1_V12N28-333_D1,3,0,0,1,0,4
TGAACACCCGAAGCAG-1_V12N28-333_D1,2,0,3,1,0,6
AACATTGGTCAGCCGT-1_V12N28-333_D1,3,0,0,0,0,3
GTGGGTCTTCTTTGCG-1_V12N28-333_D1,0,4,1,2,0,7
CATCGAATGGATCTCT-1_V12N28-333_D1,1,0,2,0,0,3
GCTACACTGTCCGAAC-1_V12N28-333_D1,5,3,0,0,0,8
CGGGTTGTAGCTTTGG-1_V12N28-333_D1,0,2,3,0,0,5
CCTAAGTGTCTAACCG-1_V12N28-333_D1,2,1,0,3,0,6
TCTGTGACTGACCGTT-1_V12N28-333_D1,1,1,2,0,0,4
TTATCATACTCGCAAA-1_V12N28-333_D1,3,0,2,3,0,8
AGCGTAGCGCTAGACC-1_V12N28-333_D1,0,1,1,0,0,2
TCCCTCCGAAATCGTT-1_V12N28-333_D1,0,0,5,1,0,6
AGGTCGCCACTTCGGT-1_V12N28-333_D1,2,0,1,1,0,4
CTAGCAACTAATTTAC-1_V12N28-333_D1,1,2,2,1,0,6
TTGCTAGCTACCAATC-1_V12N28-333_D1,2,2,1,0,0,5
GCCGGTTTGGGCGGAT-1_V12N28-333_D1,2,0,5,0,0,7
TGTAACTTGTCAACCT-1_V12N28-333_D1,3,0,2,0,0,5
CGAGATGTTGCCTATA-1_V12N28-333_D1,3,0,1,1,0,5
GTTACGAAATCCACGC-1_V12N28-333_D1,2,1,2,0,0,5
CTTGTCGTACGTGTCA-1_V12N28-333_D1,1,1,3,0,0,5
GCGTCCAGCTCGTGGC-1_V12N28-333_D1,2,0,1,0,0,3
CCCTTCTCGTACGCGA-1_V12N28-333_D1,3,2,2,0,0,7
CCAAAGTCCCGCTAAC-1_V12N28-333_D1,0,0,5,1,0,6
CCGCTTCGCGGTTAAC-1_V12N28-333_D1,3,3,4,0,0,10
GTTACGGCCCGACTGC-1_V12N28-333_D1,4,1,0,0,0,5
CCCGCTTGCCCTCGTC-1_V12N28-333_D1,3,4,0,1,0,8
TAGTGAGAAGTGGTTG-1_V12N28-333_D1,2,1,1,0,0,4
CGCTACCGCCCTATGA-1_V12N28-333_D1,2,4,1,1,0,8
AAACAATCTACTAGCA-1_V12N28-333_D1,2,1,2,1,0,6
GCGCGATGGGTCAAGT-1_V12N28-333_D1,4,1,1,0,0,6
ATAAACCATTGGACGG-1_V12N28-333_D1,0,0,1,1,0,2
TCGGGCACTTCTGGAT-1_V12N28-333_D1,2,3,1,0,0,6
TCTGTGGCTACATTTC-1_V12N28-333_D1,2,4,2,0,0,8
CTCTGTGCCTGCTATG-1_V12N28-333_D1,2,1,0,0,0,3
CACGACTAAAGTTCTG-1_V12N28-333_D1,3,3,0,0,0,6
GAGGAGTAATTCCTAC-1_V12N28-333_D1,0,0,0,0,0,0
AGAGGTATCTCGGTCC-1_V12N28-333_D1,4,1,1,1,0,7
GGCGTACCCTATATAA-1_V12N28-333_D1,0,0,0,0,0,0
GCCGGAAACACATCTT-1_V12N28-333_D1,1,0,1,0,0,2
ACCAGGAGTGTGATCT-1_V12N28-333_D1,1,0,1,0,0,2
AAGGAGAACTTATAAG-1_V12N28-333_D1,2,1,4,0,0,7
ACTGTTTAGTGTAGGC-1_V12N28-333_D1,5,1,2,0,0,8
GCGTGTATGTCGTATT-1_V12N28-333_D1,3,0,2,0,0,5
CAGCCCTCACAGGCAG-1_V12N28-333_D1,0,0,5,0,0,5
GAAGACTTCAATGCCG-1_V12N28-333_D1,1,0,0,0,0,1
ACCAAACTAGAAATCC-1_V12N28-333_D1,1,0,0,0,0,1
GACCAGGTCATTCATA-1_V12N28-333_D1,2,0,0,0,0,2
ACGCCCAGCTGTCGAT-1_V12N28-333_D1,0,0,0,0,0,0
CCTCGACCCACTGCCT-1_V12N28-333_D1,0,0,0,0,0,0
CTAATGCGCCCAACAA-1_V12N28-333_D1,2,0,0,0,0,2
GCCACCCATTCCACTT-1_V12N28-333_D1,0,0,0,0,0,0
TACTCACAACGTAGTA-1_V12N28-333_D1,4,1,0,0,0,5
GTTCGGTGTGGATTTA-1_V12N28-333_D1,2,0,0,0,0,2
TCTTTCGGCGGGACAC-1_V12N28-333_D1,2,1,0,0,0,3
GGAGACATTCACGGGC-1_V12N28-333_D1,2,3,0,0,0,5
GGGATTATCTCACAAC-1_V12N28-333_D1,2,0,2,0,0,4
TAGAACGCCAGTAACG-1_V12N28-333_D1,7,2,2,0,0,11
ACGAGTCGCCGGCGTT-1_V12N28-333_D1,5,0,0,0,0,5
TGATGGGACTAAGTCA-1_V12N28-333_D1,0,2,1,0,0,3
TGCGAGAAACGTTACG-1_V12N28-333_D1,5,0,0,0,0,5
TCGCCTCGACCTGTTG-1_V12N28-333_D1,2,0,0,0,0,2
AACTCGATAAACACGT-1_V12N28-333_D1,8,3,0,1,0,12
AGGAAAGCCTCTGATG-1_V12N28-333_D1,1,0,2,0,0,3
GAAGGACTAAATTGAA-1_V12N28-333_D1,7,1,0,0,0,8
GTATCGGGACGAGCTG-1_V12N28-333_D1,0,0,0,1,0,1
CCTGTGCATAGGAGAC-1_V12N28-333_D1,0,0,0,0,0,0
CATACGGGTGCATGAT-1_V12N28-333_D1,3,1,1,0,0,5
CCACTAAACTGAATCG-1_V12N28-333_D1,0,0,1,1,0,2
AAATTGCGGCGGTTCT-1_V12N28-333_D1,1,0,3,2,0,6
AGTCCAGCGGGTACGT-1_V12N28-333_D1,3,3,2,0,0,8
CATTCAGGTCAGTGCG-1_V12N28-333_D1,1,0,1,0,0,2
CTAAAGTCCGAAGCTA-1_V12N28-333_D1,2,0,2,2,0,6
AATCAGACTGCAGGAC-1_V12N28-333_D1,1,1,2,0,0,4
AGTATCCATAATAACG-1_V12N28-333_D1,1,0,1,1,0,3
CTGGCTGCTAACGTAA-1_V12N28-333_D1,0,0,2,0,0,2
GTTCCAAGACAGCGAC-1_V12N28-333_D1,4,0,0,0,0,4
AAGACTAACCCGTTGT-1_V12N28-333_D1,1,2,3,0,0,6
GATTAATCCTGGCTCA-1_V12N28-333_D1,0,0,3,0,0,3
CGCGCAAGGAACTACA-1_V12N28-333_D1,0,0,2,0,0,2
CAGTAGCGAGGTAGTA-1_V12N28-333_D1,0,0,4,0,0,4
ACGGCGGGTTGCCCTG-1_V12N28-333_D1,0,0,5,0,0,5
CTAGGCGGCAGAGAAT-1_V12N28-333_D1,1,0,2,0,0,3
GTGCGCAGCTTGCTCC-1_V12N28-333_D1,2,0,4,0,0,6
TCACTATCGTGCAATC-1_V12N28-333_D1,2,0,4,0,0,6
TATGATTCTGCTTGGT-1_V12N28-333_D1,2,2,5,0,0,9
TAAGATTTAGCGGGAG-1_V12N28-333_D1,0,3,6,0,0,9
TTACGGTGTCACCGAG-1_V12N28-333_D1,0,1,3,1,0,5
CTACACTAGCTTGTTC-1_V12N28-333_D1,0,0,4,0,0,4
TGAGCAGTCGTGAAGT-1_V12N28-333_D1,4,0,3,0,0,7
CGCTGAGGACGTCCAA-1_V12N28-333_D1,3,2,3,0,0,8
GTGTATGACTTTAAAG-1_V12N28-333_D1,1,1,2,0,0,4
CTAAACGGGTGTAATC-1_V12N28-333_D1,2,0,4,0,0,6
TGTACTGTGCCAAAGT-1_V12N28-333_D1,7,1,2,0,0,10
GGCCACAAGCGATGGC-1_V12N28-333_D1,2,1,1,0,0,4
GTCAATTGTACTGAAG-1_V12N28-333_D1,0,1,1,0,0,2
AGGGACAGCACGGCGG-1_V12N28-333_D1,4,1,1,0,0,6
AGCTTATAGAGACCTG-1_V12N28-333_D1,2,2,1,0,0,5
AACTAGCGTATCGCAC-1_V12N28-333_D1,1,0,1,0,0,2
AACTTTAGCTGCTGAG-1_V12N28-333_D1,0,3,2,0,0,5
CCCAAGACAGAGTATG-1_V12N28-333_D1,5,0,3,0,0,8
GGCATCAACGAGCACG-1_V12N28-333_D1,2,0,0,0,0,2
ATGCATTCCGTGATGG-1_V12N28-333_D1,1,3,0,1,0,5
TTATAGATGCACATTA-1_V12N28-333_D1,3,1,0,0,0,4
GAACCATCTGGGAGAC-1_V12N28-333_D1,1,0,3,1,0,5
TGCTATACAAACGGAC-1_V12N28-333_D1,0,1,1,0,0,2
ACTTGCCATATTGTAC-1_V12N28-333_D1,2,1,0,0,0,3
TATTCCGGCAGTCCTA-1_V12N28-333_D1,1,0,3,0,0,4
GACGGACCGCGTTCCT-1_V12N28-333_D1,0,2,1,0,0,3
ATGTGTAGTTTAGTCA-1_V12N28-333_D1,0,1,1,0,0,2
ATACCAGCAAATTGCT-1_V12N28-333_D1,3,1,2,0,0,6
AAGTTTACTAATGGCA-1_V12N28-333_D1,1,2,1,0,0,4
CTCTCGATGTGCGCCT-1_V12N28-333_D1,4,1,0,0,0,5
GATTGACACTCTGCTC-1_V12N28-333_D1,0,0,1,0,0,1
TATCACAGCACGGGCA-1_V12N28-333_D1,4,1,0,0,0,5
ACCGTTCCCGCTCTGA-1_V12N28-333_D1,0,0,1,0,0,1
CCGCCACCACAATCCA-1_V12N28-333_D1,2,0,0,0,0,2
CATTCACTGACAGCTA-1_V12N28-333_D1,2,1,3,0,0,6
CGGCTGCAAGATTAAG-1_V12N28-333_D1,3,1,0,0,0,4
CATGAACCTCTTATCA-1_V12N28-333_D1,1,1,0,0,0,2
TTAATGCGAGGTAACT-1_V12N28-333_D1,1,1,1,0,0,3
AATAAGTCCTCGAGAC-1_V12N28-333_D1,2,2,0,0,0,4
ACCAGCCCGGTCTTTG-1_V12N28-333_D1,2,0,0,0,0,2
CTACGAACTAGGTCGA-1_V12N28-333_D1,0,0,0,0,0,0
ACATCTCAACGCGTAA-1_V12N28-333_D1,2,0,2,0,0,4
CACTACTCAGTTCTGT-1_V12N28-333_D1,2,1,0,0,0,3
CCGACTCGCATAGTCT-1_V12N28-333_D1,1,0,5,0,0,6
CATTTATCGTTCAAGA-1_V12N28-333_D1,0,0,0,0,0,0
CAAACGTGGTCTTGCG-1_V12N28-333_D1,3,0,1,0,0,4
TAGAAACCACTAAGTA-1_V12N28-333_D1,0,1,4,0,0,5
ACTGATTTAGTGATTC-1_V12N28-333_D1,3,0,2,0,0,5
TCGTATTTCGTCCGGA-1_V12N28-333_D1,2,2,1,0,0,5
CGGAAATTTCACATCC-1_V12N28-333_D1,2,0,1,0,0,3
ATCCACGCTAAATGTT-1_V12N28-333_D1,2,0,1,0,0,3
GTTCAATCTATGTCAA-1_V12N28-333_D1,1,0,0,0,0,1
ATAAAGGTCAAGTACG-1_V12N28-333_D1,2,3,2,0,0,7
CAACTCCAACGTTTAG-1_V12N28-333_D1,0,0,0,0,0,0
TAGGAACAGCCTCCAG-1_V12N28-333_D1,2,1,4,0,0,7
CACACGTTTCAATGGG-1_V12N28-333_D1,1,0,7,0,0,8
AGTAACGTTCATCCTG-1_V12N28-333_D1,0,0,3,0,0,3
TCTACACGTTCATGCA-1_V12N28-333_D1,1,0,2,0,0,3
TCGGTTAGCCATGTAG-1_V12N28-333_D1,0,1,2,0,0,3
TAAGTAAATGTGCCGC-1_V12N28-333_D1,0,1,7,0,0,8
TGGCACGAGCTCGAGT-1_V12N28-333_D1,0,0,2,0,0,2
GAACTTAGCGCCCGGT-1_V12N28-333_D1,0,0,1,0,0,1
ATAGGAATCTAAGCTT-1_V12N28-333_D1,0,0,1,0,0,1
AGTGGGAGTATACACG-1_V12N28-333_D1,1,0,1,2,0,4
GGTCTTGGTGTTAACT-1_V12N28-333_D1,2,1,0,1,0,4
GGCTGGCAGCTTTATG-1_V12N28-333_D1,2,0,0,0,0,2
CGCCAATTATTGCGTT-1_V12N28-333_D1,0,0,2,0,0,2
GGTAACCGGCAAAGGT-1_V12N28-333_D1,2,2,1,1,0,6
TGGGACCATTGGGAGT-1_V12N28-333_D1,1,0,1,1,0,3
CTGCAGGTGCTCGGCC-1_V12N28-333_D1,1,0,0,0,0,1
CCGGTGCGAGTGATAG-1_V12N28-333_D1,4,3,1,0,0,8
GGGTACACTCTGGAGG-1_V12N28-333_D1,5,0,0,1,0,6
TAGCCAGAGGGTCCGG-1_V12N28-333_D1,1,0,0,1,0,2
CTTGTGAGGACAGCGG-1_V12N28-333_D1,4,1,1,2,0,8
GAAGGGCATAACCATG-1_V12N28-333_D1,4,0,1,0,0,5
CAACATGGCCTGATAA-1_V12N28-333_D1,0,2,2,1,0,5
CAATTTGACCGGGAAG-1_V12N28-333_D1,4,2,1,0,0,7
TCTGACTGTAATGGTT-1_V12N28-333_D1,1,0,0,0,0,1
TTCATAGCCTTGTAAC-1_V12N28-333_D1,1,0,2,1,0,4
TGGAAACGGAGTGAAC-1_V12N28-333_D1,0,0,1,1,0,2
ATCGCACGATTGTTCA-1_V12N28-333_D1,3,2,0,1,0,6
CGCCACCCGCATTAAC-1_V12N28-333_D1,2,1,2,0,0,5
TGGACCACGGCGTTGA-1_V12N28-333_D1,2,2,3,0,0,7
GTATATGTTACGGCGG-1_V12N28-333_D1,1,1,1,0,0,3
GTATTCTTACCGTGCT-1_V12N28-333_D1,0,2,3,0,0,5
TTCAGAGTAACCTGAC-1_V12N28-333_D1,0,2,2,0,0,4
GCGGTAACCCAAATGA-1_V12N28-333_D1,1,1,2,0,0,4
CTACGTGTTGCCACCA-1_V12N28-333_D1,1,2,0,0,0,3
CTAGATAAACTCCTCG-1_V12N28-333_D1,0,0,6,0,0,6
TCCATTAGTTGGATAG-1_V12N28-333_D1,1,2,1,0,0,4
CTGGCTCCTGCGGGAT-1_V12N28-333_D1,0,0,2,0,0,2
CAGTCTCTCGGCTAAT-1_V12N28-333_D1,2,2,0,0,0,4
GTATGACGTGGGAAAC-1_V12N28-333_D1,0,1,2,0,0,3
AGTCACTCCGCCTCAT-1_V12N28-333_D1,0,0,5,0,0,5
GCAGCGGTGGGCATTA-1_V12N28-333_D1,0,1,5,0,0,6
TATGGAGTTTCTCGTT-1_V12N28-333_D1,2,4,3,0,0,9
ACTCAACGAATGTATT-1_V12N28-333_D1,1,0,3,0,0,4
AACACGCGGCCGCGAA-1_V12N28-333_D1,1,0,1,0,0,2
CGATATTAGCCGCAGG-1_V12N28-333_D1,1,1,3,0,0,5
AGCGTCTGAACCCGCA-1_V12N28-333_D1,0,2,3,0,0,5
GATGTCCGGATCACAT-1_V12N28-333_D1,0,2,1,0,0,3
GGTCACGTTAGATTCA-1_V12N28-333_D1,0,1,7,1,0,9
TTAAGGATACGGAGGT-1_V12N28-333_D1,0,1,2,0,0,3
GTGCGGGACCATCGGC-1_V12N28-333_D1,1,5,3,0,0,9
CCATCTTGTTCACAAT-1_V12N28-333_D1,0,1,2,0,0,3
TCCGAGAAGGCTAAGC-1_V12N28-333_D1,0,1,4,0,0,5
TGGCGGTGTGCGATTG-1_V12N28-333_D1,0,0,8,0,0,8
ATCCTGCTGCAGATAG-1_V12N28-333_D1,0,0,3,0,0,3
TTATGCGTCCCGGTCC-1_V12N28-333_D1,0,0,4,0,0,4
CATAATGAGCGGGCGA-1_V12N28-333_D1,1,0,1,0,0,2
AGACATAGATCCTTCC-1_V12N28-333_D1,0,1,4,0,0,5
GGTGAAACCGGGAATG-1_V12N28-333_D1,3,0,1,0,0,4
AACTGGTGTGGGCCTT-1_V12N28-333_D1,3,1,2,0,0,6
GTAGCGCTGTTGTAGT-1_V12N28-333_D1,2,2,2,0,0,6
TTGTTTGTGTAAATTC-1_V12N28-333_D1,2,1,2,0,0,5
GGATCAAAGGACGAGG-1_V12N28-333_D1,2,0,2,0,0,4
CGTAGCGCCGACGTTG-1_V12N28-333_D1,3,1,1,0,0,5
CAAGTGAACTTTGGTT-1_V12N28-333_D1,2,1,3,0,0,6
GTAGACAACCGATGAA-1_V12N28-333_D1,0,0,0,0,0,0
CAATGGTCGGCCTGGG-1_V12N28-333_D1,4,0,0,0,0,4
ACAGATTAGGTTAGTG-1_V12N28-333_D1,1,2,2,0,0,5
GTTATCACCTTCTGAA-1_V12N28-333_D1,0,0,6,0,0,6
TGGTATCGGTCTGTAT-1_V12N28-333_D1,1,1,3,0,0,5
GGAATAACCTCAAGAA-1_V12N28-333_D1,2,1,3,0,0,6
ATTATCTCGACAGATC-1_V12N28-333_D1,1,0,2,0,0,3
CCGAGGGATGTTAGGC-1_V12N28-333_D1,2,0,1,0,0,3
TGAGATCAAATACTCA-1_V12N28-333_D1,3,0,3,0,0,6
AAACGAAGAACATACC-1_V12N28-333_D1,0,0,2,0,0,2
CTGGTCCTAACTTGGC-1_V12N28-333_D1,2,1,5,0,0,8
TGCACGAGTCGGCAGC-1_V12N28-333_D1,0,1,2,0,0,3
ATAGTCTTTGACGTGC-1_V12N28-333_D1,2,0,2,0,0,4
TGGAGCTAAAGTTCCC-1_V12N28-333_D1,0,1,0,0,0,1
GGGTGGTCCAGCCTGT-1_V12N28-333_D1,1,0,0,0,0,1
CATGCATGGAGACCCT-1_V12N28-333_D1,1,1,1,0,0,3
ACACGGCACTATGCAT-1_V12N28-333_D1,0,1,5,0,0,6
CCCTGGTATGGGCGGC-1_V12N28-333_D1,3,0,2,0,0,5
GGAGGATTGAAAGGAG-1_V12N28-333_D1,1,0,4,0,0,5
CCGCTGGTGCCATTCA-1_V12N28-333_D1,2,1,2,0,0,5
GTTAGAGTGTGCCGCT-1_V12N28-333_D1,0,0,2,0,0,2
TCGGAATGACCATCAA-1_V12N28-333_D1,1,1,3,0,0,5
TTCAATTAGCCATAAT-1_V12N28-333_D1,0,1,5,0,0,6
GATGTGTTGTCACAAG-1_V12N28-333_D1,0,2,1,0,0,3
TCTTTCTCTTAAGGAG-1_V12N28-333_D1,0,1,2,0,0,3
ACCCTTTAGTTCTCCA-1_V12N28-333_D1,0,0,3,0,0,3
ACCACAACTCAGAACA-1_V12N28-333_D1,0,0,6,1,0,7
TATGATAAATCTAACG-1_V12N28-333_D1,0,1,6,0,0,7
GATCCTCTTGCGCTTA-1_V12N28-333_D1,0,0,4,0,0,4
TTCTACCTTTATGTTG-1_V12N28-333_D1,0,2,2,0,0,4
GAAATACCTGCTGGCT-1_V12N28-333_D1,0,0,4,0,0,4
ATTCTGAGTATGAACT-1_V12N28-333_D1,1,0,2,0,0,3
GGATTAAGCTAAGGTC-1_V12N28-333_D1,0,0,3,0,0,3
AGTACGTGGCCTGTCT-1_V12N28-333_D1,0,0,1,0,0,1
TCAGGGTGCACGAAAC-1_V12N28-333_D1,0,1,3,0,0,4
AAATTTACCGAAATCC-1_V12N28-333_D1,1,1,1,0,0,3
TTGAGGCATTTAACTC-1_V12N28-333_D1,0,0,4,0,0,4
AACCAGTATCACTCTT-1_V12N28-333_D1,0,0,3,0,0,3
CACCGGAGATATCTCC-1_V12N28-333_D1,0,0,5,0,0,5
GACTGGGCGCCGCAAC-1_V12N28-333_D1,2,0,5,0,0,7
CACGTCTATGATGTGG-1_V12N28-333_D1,0,0,4,0,1,5
TTAAGACGAACGAACC-1_V12N28-333_D1,0,0,6,0,0,6
TGACCAGCTTCAAAGT-1_V12N28-333_D1,0,0,5,0,1,6
AGAGTTAGAGACCGAT-1_V12N28-333_D1,0,0,4,0,0,4
TTCGGACTGATGCCTT-1_V12N28-333_D1,0,1,6,0,0,7
CTCGAATGGAACGTAT-1_V12N28-333_D1,0,0,4,0,0,4
GGACGGCTTGCGCAAC-1_V12N28-333_D1,0,1,6,0,0,7
CTAAGTACAGGGCTAC-1_V12N28-333_D1,0,0,4,0,1,5
ACAAATTCAGATCTGA-1_V12N28-333_D1,0,0,3,0,0,3
CATGGAAATGGGACCA-1_V12N28-333_D1,1,0,2,0,0,3
GGTGGACCACGTGTTA-1_V12N28-333_D1,0,0,4,0,0,4
CACGACGTAATAGTAA-1_V12N28-333_D1,2,0,4,0,0,6
CGGGTTCGGCACGTAT-1_V12N28-333_D1,0,0,0,0,0,0
CTGGGCTATCCTTTGG-1_V12N28-333_D1,1,0,4,0,0,5
GTATTAGGGTTCGCGT-1_V12N28-333_D1,0,0,7,0,0,7
TCATTCGTATAATTTG-1_V12N28-333_D1,0,0,4,0,0,4
AATAGCAAGCCTCCTG-1_V12N28-333_D1,3,0,6,0,0,9
CATCTACCCGAGAACG-1_V12N28-333_D1,1,1,2,0,0,4
GCTTCAGTGGGATTAC-1_V12N28-333_D1,0,0,4,0,0,4
TCTGTGATGGAGGTTG-1_V12N28-333_D1,0,0,3,0,0,3
ATCCACTTTCAGACTA-1_V12N28-333_D1,0,1,4,0,0,5
ATGGTTACGAAACATG-1_V12N28-333_D1,0,0,0,0,0,0
GGCCCAATCTAGAGGG-1_V12N28-333_D1,1,0,2,0,0,3
GATGGTGAAATAACCC-1_V12N28-333_D1,0,0,0,0,0,0
AGAGGGACAATTGTCC-1_V12N28-333_D1,2,0,4,0,0,6
CGCGTACATTCTGGAA-1_V12N28-333_D1,0,0,2,0,0,2
CAAGAAACCCTAAACT-1_V12N28-333_D1,1,0,2,0,0,3
TTGGTGCGGTGTTGAA-1_V12N28-333_D1,0,0,0,0,0,0
GGTTCCCTAGTGTCTC-1_V12N28-333_D1,3,1,0,0,0,4
CGATAACCAATTTGAG-1_V12N28-333_D1,1,0,0,0,0,1
GCCCACTGGTCCACAA-1_V12N28-333_D1,6,0,0,0,0,6
GAGGGCCGGCAGAGTC-1_V12N28-333_D1,1,0,2,0,0,3
CGACACGGATGCCCAC-1_V12N28-333_D1,7,0,0,1,0,8
CTGTCTGTGGCTGGCT-1_V12N28-333_D1,0,0,0,0,0,0
ATATTATCCCGTATTT-1_V12N28-333_D1,3,0,1,1,0,5
GCGCTGGCGGAAAGTC-1_V12N28-333_D1,1,2,0,3,0,6
ATCTAACGTCCCTATG-1_V12N28-333_D1,2,0,1,0,0,3
GTCAGACAGCGTTGGA-1_V12N28-333_D1,4,0,0,0,0,4
GCCAGGCTTAGTGGTA-1_V12N28-333_D1,3,0,0,0,0,3
ATTCAAAGTACCTGTT-1_V12N28-333_D1,3,0,2,0,0,5
TGGACGTAGGCGAATC-1_V12N28-333_D1,2,1,2,0,0,5
ACACATTGACGCAACA-1_V12N28-333_D1,2,0,1,1,0,4
GATATCAGTATGTATC-1_V12N28-333_D1,0,2,2,1,0,5
TGGGCCTTGCCTGCAT-1_V12N28-333_D1,5,0,0,0,0,5
CAAAGTCAGGTTAGCT-1_V12N28-333_D1,0,1,4,1,0,6
GGATCCCTACCAGCTA-1_V12N28-333_D1,4,0,2,0,0,6
ATCGTCCAATCGAGTC-1_V12N28-333_D1,1,0,0,1,0,2
ACATGGCTCAATTTAG-1_V12N28-333_D1,1,4,1,1,0,7
AGGCCCAGTGACTGGT-1_V12N28-333_D1,0,6,2,0,0,8
GCTTCCAGCTTAGATT-1_V12N28-333_D1,1,1,4,0,0,6
TGCTTGAAACCATGCA-1_V12N28-333_D1,2,3,0,0,0,5
CAATATTGGACTAGTG-1_V12N28-333_D1,1,6,1,0,0,8
CGTGCTGGCCTAGTCG-1_V12N28-333_D1,2,6,2,1,0,11
CCTGCGATAGAACTGT-1_V12N28-333_D1,3,2,1,1,0,7
GGGTAATGCTGTGTTT-1_V12N28-333_D1,1,2,2,1,0,6
AACGCGAACGGCAACA-1_V12N28-333_D1,2,0,3,0,0,5
TGTCGGCATGGTGGAA-1_V12N28-333_D1,0,0,0,0,0,0
AGCGTACGAGAGCTAG-1_V12N28-333_D1,1,1,1,1,0,4
ATACTCTCGCCACTCT-1_V12N28-333_D1,0,0,2,0,0,2
AATCCATGCAAGGGTG-1_V12N28-333_D1,1,1,6,0,0,8
TTAAACAGAGTCCCGC-1_V12N28-333_D1,0,0,3,1,0,4
CCACAGCTGAAATCAT-1_V12N28-333_D1,0,0,4,0,0,4
CGGTTCCGGCTTCTTG-1_V12N28-333_D1,0,0,1,0,0,1
GACGTGAGACTCCATG-1_V12N28-333_D1,0,3,3,0,0,6
TCGTTGGCTCGTCAAT-1_V12N28-333_D1,1,0,1,0,0,2
GGTGAACGGGCTAGCC-1_V12N28-333_D1,0,0,2,0,0,2
GCACTGTGCAAATGTA-1_V12N28-333_D1,1,0,0,0,0,1
ACGAGAACCCATCACG-1_V12N28-333_D1,0,0,2,0,1,3
CCAGCTACGCCTCATA-1_V12N28-333_D1,0,0,1,0,0,1
TCCCGGTCAGGAATTT-1_V12N28-333_D1,0,1,5,0,0,6
TCGCATTCAATGACTT-1_V12N28-333_D1,0,0,0,0,0,0
CTGGTTCAACGCATCA-1_V12N28-333_D1,0,0,5,0,0,5
GGTGATTTCATCTTGT-1_V12N28-333_D1,0,2,1,0,0,3
CACCCTTTCCTCGCTC-1_V12N28-333_D1,0,0,0,0,0,0
CAACTTGTAGTGGGCA-1_V12N28-333_D1,0,0,2,0,0,2
AATATCAAGGTCGGAT-1_V12N28-333_D1,0,1,1,0,0,2
ACTCAGACCTGCTTCT-1_V12N28-333_D1,0,4,3,0,2,9
TTGGAGTCTCCCTTCT-1_V12N28-333_D1,0,0,4,0,0,4
GGATACTCATGAATTG-1_V12N28-333_D1,0,0,3,0,1,4
TGGGCACAAACAGAAC-1_V12N28-333_D1,0,2,3,0,0,5
GAGCCACGGTAGTAGG-1_V12N28-333_D1,0,1,7,0,0,8
TCGATAGGCTAGTCGC-1_V12N28-333_D1,0,0,3,0,0,3
TAACCGCCCGCAGTGC-1_V12N28-333_D1,0,0,3,0,0,3
GCCTATTTGCTACACA-1_V12N28-333_D1,0,0,5,0,0,5
TTGACGATTCAGCACG-1_V12N28-333_D1,0,1,2,0,0,3
TTAAACCGGTAGCGAC-1_V12N28-333_D1,1,0,1,0,0,2
ACCGAAAGGGCCCTGC-1_V12N28-333_D1,0,0,1,0,0,1
ACGTTCCGCGCTCCGT-1_V12N28-333_D1,2,2,2,0,0,6
ATACCAGGCTAATAGA-1_V12N28-333_D1,0,1,1,0,0,2
CGGCTTTGTATGATAA-1_V12N28-333_D1,0,1,3,0,0,4
CTTGACCCGAAAGATA-1_V12N28-333_D1,0,0,7,0,0,7
CGCAGAAACATTTGCG-1_V12N28-333_D1,0,0,2,0,0,2
GACCCGTCGCCGGCTA-1_V12N28-333_D1,0,0,6,0,0,6
AATCGGGACACTACGA-1_V12N28-333_D1,0,0,4,0,0,4
GTCACAAAGTTTCCAA-1_V12N28-333_D1,0,1,3,0,0,4
TATATTCGCGTCGATA-1_V12N28-333_D1,0,1,4,0,0,5
CCTCCCGACAATCCCT-1_V12N28-333_D1,0,1,3,0,0,4
CGACATGCGATCTTCT-1_V12N28-333_D1,0,0,5,0,0,5
AACACGACTGTACTGA-1_V12N28-333_D1,0,1,2,0,0,3
CCCAACCACACTAACA-1_V12N28-333_D1,0,0,3,0,0,3
CACCGCCGACCAGCGA-1_V12N28-333_D1,0,0,2,0,0,2
TGGTATCGCATCCCAA-1_V12N28-333_D1,0,0,7,0,0,7
CAGAGTGATTTAACGT-1_V12N28-333_D1,0,0,2,0,0,2
AACCCTGGTGGAACCA-1_V12N28-333_D1,0,0,4,0,0,4
GTCAGTTGTGCTCGTT-1_V12N28-333_D1,0,1,1,0,0,2
ATTGACGTAACTCGGT-1_V12N28-333_D1,0,0,4,0,0,4
GATGTCGGTCAACTGC-1_V12N28-333_D1,0,0,2,0,0,2
AGGGCAGCGGCGTGGT-1_V12N28-333_D1,0,0,6,0,0,6
ACATCGTTAACCTAGT-1_V12N28-333_D1,0,0,1,0,0,1
TCCATTGTGACCTCGT-1_V12N28-333_D1,0,0,1,0,0,1
TGTTTAATACTTCATC-1_V12N28-333_D1,0,0,2,0,0,2
TTGCTGGCCGGGCTTC-1_V12N28-333_D1,0,0,0,0,0,0
CATATTATTTGCCCTA-1_V12N28-333_D1,0,0,1,0,0,1
CTGCCTAGCCACCAAG-1_V12N28-333_D1,0,0,1,0,0,1
ACGAGATATTTGCTTA-1_V12N28-333_D1,0,0,2,0,0,2
GACTACAATTGCTCGT-1_V12N28-333_D1,0,0,0,0,0,0
AACGTGATGAAGGACA-1_V12N28-333_D1,0,0,2,0,0,2
ACTCTCTTATACACGA-1_V12N28-333_D1,0,0,1,0,0,1
CGCATCATGGCTTCAG-1_V12N28-333_D1,0,0,4,0,0,4
CGGCTCTTCGTCGAAC-1_V12N28-333_D1,0,0,5,0,0,5
ATTCTTCGTACTTATG-1_V12N28-333_D1,0,0,1,0,1,2
AGTGAGGGTTTCTGAC-1_V12N28-333_D1,0,0,2,0,0,2
GCCAGGCGTTCGCATG-1_V12N28-333_D1,0,0,0,0,0,0
GACTAACACAGCACCT-1_V12N28-333_D1,0,0,3,0,0,3
CAATGGAATCTACATA-1_V12N28-333_D1,0,1,2,0,0,3
GTGGTCAGCGAAGTAT-1_V12N28-333_D1,0,0,1,0,0,1
ATGGCTGGAAATGGCC-1_V12N28-333_D1,0,0,2,0,0,2
ATCAGGTCGCCATTGC-1_V12N28-333_D1,0,0,2,0,0,2
TATCACCATGTAAAGT-1_V12N28-333_D1,0,0,0,0,0,0
AGCGCTTATGGGCAAG-1_V12N28-333_D1,0,0,0,0,0,0
AAGCGGCGTCATGGGT-1_V12N28-333_D1,0,0,0,0,0,0
ACTAATACGTCAGGCG-1_V12N28-333_D1,0,0,5,0,0,5
GGCTGAGCATCGTAAG-1_V12N28-333_D1,0,0,4,0,0,4
CGGTTGGGTTCAAGTT-1_V12N28-333_D1,0,0,6,0,0,6
GACTGATTGGTCACAA-1_V12N28-333_D1,0,0,3,0,0,3
AGACGGGCCGATTTAA-1_V12N28-333_D1,0,0,6,0,1,7
ACCAGTGCCCGGTCAA-1_V12N28-333_D1,0,0,4,0,0,4
GTCCTTTAATGACTTC-1_V12N28-333_D1,1,0,3,0,0,4
CCTACAAGTCCGGAAT-1_V12N28-333_D1,0,0,3,0,0,3
GCCTGCTACACTGAGA-1_V12N28-333_D1,0,0,0,0,0,0
GACTCGGTCGGCGGAT-1_V12N28-333_D1,0,0,1,0,0,1
CTAGACATATATGTAG-1_V12N28-333_D1,0,2,1,0,0,3
TCGCCCAACTGACTCC-1_V12N28-333_D1,0,0,2,0,0,2
AAACTAACGTGGCGAC-1_V12N28-333_D1,1,1,10,0,0,12
AACTGAGGTCAGCGTC-1_V12N28-333_D1,0,0,9,0,0,9
ACAATGATTCTTCTAC-1_V12N28-333_D1,2,0,7,0,0,9
ATAAGTACCCGATTGT-1_V12N28-333_D1,0,0,5,0,0,5
ATTGGGAGTTCTGTAA-1_V12N28-333_D1,0,0,5,0,0,5
CGAACATAGTCAGAAA-1_V12N28-333_D1,0,0,3,0,0,3
TAGCTCAGATCCTAGT-1_V12N28-333_D1,2,0,0,0,0,2
GTGTCGTATTCACCTT-1_V12N28-333_D1,4,0,4,0,0,8
CTCACCGATCCAAACT-1_V12N28-333_D1,6,0,1,0,0,7
ATATGTGCACAAACCA-1_V12N28-333_D1,2,0,1,0,0,3
CAGTCCAACGCCTTCT-1_V12N28-333_D1,4,0,0,0,0,4
TCGTCCGGGTACACTC-1_V12N28-333_D1,3,0,0,0,0,3
GCAGAAACGTAATCCA-1_V12N28-333_D1,6,0,1,0,0,7
TTCGAGCCGGCGCTAC-1_V12N28-333_D1,0,1,0,0,0,1
GGAAGATAAGACTGTA-1_V12N28-333_D1,4,0,1,0,0,5
ATAAGCAAACACCGAG-1_V12N28-333_D1,1,0,3,0,0,4
GCATAAATTGAACGCC-1_V12N28-333_D1,6,0,0,0,0,6
CGCCGGTGTCGCAGTA-1_V12N28-333_D1,3,0,1,0,0,4
GACCTGGTCTGGGCGT-1_V12N28-333_D1,3,0,1,1,0,5
AGCCGCTTGATTAGCG-1_V12N28-333_D1,1,1,1,0,0,3
CCCGGCTAGGTGAGAA-1_V12N28-333_D1,2,0,0,0,0,2
CGAGCCGAGCACTCGA-1_V12N28-333_D1,0,1,2,0,0,3
TAGTGCTTGAATCCTT-1_V12N28-333_D1,3,0,1,0,0,4
CAACCGCACCTAGACA-1_V12N28-333_D1,2,0,0,2,0,4
ACCACTGTTCAAGAAG-1_V12N28-333_D1,2,1,2,0,0,5
AGATGCTATAACGAGC-1_V12N28-333_D1,4,2,1,1,0,8
AATTACTCGTACGCTC-1_V12N28-333_D1,5,0,0,0,0,5
CGTCAATCTTTAACAT-1_V12N28-333_D1,4,2,0,1,0,7
CCAAAGCAGTTGGTTG-1_V12N28-333_D1,2,1,0,1,0,4
CCATATTGGATCATGA-1_V12N28-333_D1,2,3,0,1,0,6
CGTACCGAAAGTCTAG-1_V12N28-333_D1,6,2,1,0,0,9
CTCGAGATCCAAAGCA-1_V12N28-333_D1,1,1,1,1,0,4
TGGATAGAGTAACAGA-1_V12N28-333_D1,1,3,3,0,0,7
TCACAGATCCTCAAAC-1_V12N28-333_D1,1,1,0,0,0,2
AGAGCTACGAAAGCAT-1_V12N28-333_D1,1,1,3,0,0,5
TGCGTGATTGGGTGTC-1_V12N28-333_D1,0,2,2,0,0,4
CACATGTTTGGACATG-1_V12N28-333_D1,1,1,6,0,0,8
TTCGCATCCGGAAGCA-1_V12N28-333_D1,0,0,3,0,0,3
CCCTAGTGTCAGGTGT-1_V12N28-333_D1,0,2,2,1,0,5
TTACCGCCTTAGGGAA-1_V12N28-333_D1,0,2,2,0,1,5
CCAGTCCATTATTCGA-1_V12N28-333_D1,0,0,3,0,0,3
CGTAAACGCTTGAGTG-1_V12N28-333_D1,2,2,1,0,1,6
ATTCCTTCCAGGCGGT-1_V12N28-333_D1,1,2,1,0,0,4
TTCCTTTCTGTGTTGC-1_V12N28-333_D1,2,2,1,0,0,5
AGTTGACATCGGCTGG-1_V12N28-333_D1,0,0,2,0,0,2
AACTCGATGGCGCAGT-1_V12N28-333_D1,0,0,1,0,0,1
GATAAGGCAGATGCAA-1_V12N28-333_D1,0,1,1,0,0,2
GGCTGGCTAGCTTAAA-1_V12N28-333_D1,1,1,0,0,0,2
CCTCATGCAGCTACGA-1_V12N28-333_D1,2,2,1,0,0,5
GACGCCTGTTGCAGGG-1_V12N28-333_D1,1,1,0,0,0,2
TAATTAGATGGATATG-1_V12N28-333_D1,2,0,1,0,0,3
GAGGGCATCGCGTATC-1_V12N28-333_D1,1,0,1,0,0,2
CTTGTGAGTCTTTGAC-1_V12N28-333_D1,1,0,0,0,0,1
TCAACACATTGGGTAA-1_V12N28-333_D1,2,0,1,0,0,3
ACTGTATACGCGAGCA-1_V12N28-333_D1,0,0,0,0,0,0
GTGAAACGTGCTCCAC-1_V12N28-333_D1,0,0,0,0,2,2
CGAGTGCTATAGTTCG-1_V12N28-333_D1,3,2,0,0,2,7
GTACTGCATGAAGCGT-1_V12N28-333_D1,2,0,0,0,0,2
GTAACTTGCGGCAGTC-1_V12N28-333_D1,1,0,1,0,1,3
GAATCGCCGGACACGG-1_V12N28-333_D1,2,0,0,0,1,3
GGGAGTAATGGCTGGC-1_V12N28-333_D1,0,0,0,0,0,0
CATGAACCGACATTTG-1_V12N28-333_D1,0,0,1,0,1,2
TCTGTCATACAAGAGC-1_V12N28-333_D1,0,0,6,0,0,6
GTCGTCAATTATAAGG-1_V12N28-333_D1,0,1,3,0,0,4
TAAAGAGCCCGAAACC-1_V12N28-333_D1,0,0,7,0,1,8
GTACTGAGGTCGTAAC-1_V12N28-333_D1,0,0,0,0,0,0
TGTCTACAGTTTCTGT-1_V12N28-333_D1,5,0,14,0,0,19
TTAACGTCGCAAGACC-1_V12N28-333_D1,0,0,2,0,0,2
CTATGTCTATTGAAAC-1_V12N28-333_D1,1,0,2,0,0,3
TCGGGTGAAACTGCTA-1_V12N28-333_D1,0,0,5,0,2,7
TGTCCCGACATAGCAC-1_V12N28-333_D1,0,0,1,0,0,1
ACAGCATAGAGCCAGT-1_V12N28-333_D1,0,0,3,0,3,6
ATATTCCCACAGGTCA-1_V12N28-333_D1,0,0,0,0,0,0
TTGGATCGACTTCTGG-1_V12N28-333_D1,0,0,1,0,0,1
CACCATCGGAGGAGAC-1_V12N28-333_D1,0,0,1,0,0,1
TCGTTCGTTATTATGT-1_V12N28-333_D1,0,0,1,0,0,1
CTTAACTTCGAAGTAC-1_V12N28-333_D1,0,0,0,0,0,0
GCACAAGTGTCGGAAG-1_V12N28-333_D1,0,0,2,0,0,2
TACCAGCTAGGTTTAA-1_V12N28-333_D1,0,0,2,0,0,2
ACGTACAGATTTCTCT-1_V12N28-333_D1,0,0,0,0,0,0
AATTTGGTTCCAAAGA-1_V12N28-333_D1,0,0,4,0,0,4
GTAAGGATTTGTCGGA-1_V12N28-333_D1,0,0,2,0,0,2
CATCATCTACCCGGAC-1_V12N28-333_D1,0,0,3,0,0,3
ACGATGGATCCGATGC-1_V12N28-333_D1,0,1,6,0,0,7
CACTCAGCTCTTGAGG-1_V12N28-333_D1,0,0,1,0,0,1
TAGATCCGAAGTCGCA-1_V12N28-333_D1,0,0,3,0,0,3
TGAAACTTATGCAAGC-1_V12N28-333_D1,0,0,6,0,0,6
GCGATTCTGGAAGCAG-1_V12N28-333_D1,0,0,0,0,1,1
CAAACTATTGAGCTTC-1_V12N28-333_D1,0,0,1,0,0,1
TAGAATTAAGGGCAAC-1_V12N28-333_D1,0,0,3,0,0,3
CGAAACATAGATGGCA-1_V12N28-333_D1,0,0,2,0,0,2
GATGGTGCCCTAGGCA-1_V12N28-333_D1,0,0,0,0,0,0
CCCGCAGGGCCCAAAG-1_V12N28-333_D1,0,0,0,0,0,0
ACAGCGCACCCGCAGC-1_V12N28-333_D1,0,0,1,0,0,1
GGTAAATGTGCGTTAC-1_V12N28-333_D1,0,0,1,0,0,1
GTCCTTCTAGTGGGTT-1_V12N28-333_D1,0,0,1,0,0,1
GGAAGCTCGCTTACAG-1_V12N28-333_D1,0,0,0,0,0,0
CACCGATACACCGAGC-1_V12N28-333_D1,0,1,2,0,0,3
CAGCCGGGCCCTCTAT-1_V12N28-333_D1,0,0,0,0,0,0
CGGAGCTTATAACACC-1_V12N28-333_D1,0,0,4,0,1,5
ATTACAACTACCGGCC-1_V12N28-333_D1,0,0,2,0,0,2
TCCTCTGGCCCATTAG-1_V12N28-333_D1,0,0,0,0,0,0
CGGCACCGTTAGCGCC-1_V12N28-333_D1,0,0,4,0,0,4
TCGGTCCCTGACTCCA-1_V12N28-333_D1,0,0,4,0,0,4
TGGTTGGAGGATCCTG-1_V12N28-333_D1,0,0,1,0,1,2
CTGCGGTAGTCACGTG-1_V12N28-333_D1,0,0,1,0,0,1
GTGCCTCAGTGTACGG-1_V12N28-333_D1,0,0,2,0,0,2
ATCGTTCACTTTCGCC-1_V12N28-333_D1,0,1,1,0,1,3
ACTTACCGGGCGCGCA-1_V12N28-333_D1,0,0,1,0,1,2
CTAGACTGCATTTCGT-1_V12N28-333_D1,0,0,1,0,0,1
TTGCCGGTGATCCCTC-1_V12N28-333_D1,0,1,2,0,1,4
CTGTCACGCCAGGCGC-1_V12N28-333_D1,0,1,1,0,0,2
CGGTATAGGTATTAGC-1_V12N28-333_D1,0,0,1,0,0,1
CCAACGCTTGCCAGGG-1_V12N28-333_D1,0,0,0,0,0,0
CGTTGAGTAATTGCGT-1_V12N28-333_D1,0,0,2,0,0,2
TGTATTTACCTAATGC-1_V12N28-333_D1,0,0,1,0,0,1
TAAATGCCGTCTCATG-1_V12N28-333_D1,0,0,0,0,0,0
CGGTTTATGAAGGAAC-1_V12N28-333_D1,0,0,2,0,0,2
GCAAGATGTGTTCGCG-1_V12N28-333_D1,0,0,2,0,0,2
AAAGGTAAGCTGTACC-1_V12N28-333_D1,0,0,1,0,0,1
GTACGTCACGTATTAA-1_V12N28-333_D1,0,1,1,0,0,2
AGTACCTTCGAGTGCT-1_V12N28-333_D1,0,0,11,0,0,11
ATTGTGACTTCGCTGC-1_V12N28-333_D1,0,0,2,0,0,2
TGTATCAGACTGAAGC-1_V12N28-333_D1,0,0,5,0,0,5
GAGACCCTGCAACGCC-1_V12N28-333_D1,0,0,0,0,0,0
TGGGTGGGATGTCATT-1_V12N28-333_D1,0,0,3,0,0,3
GGCTAATGATTGAAAT-1_V12N28-333_D1,0,0,6,0,0,6
ATAACGTTACCTCCAC-1_V12N28-333_D1,0,0,8,0,0,8
TGCGAGATGGCGGCCA-1_V12N28-333_D1,0,0,5,0,0,5
CACACTTGTATTGCGA-1_V12N28-333_D1,0,0,4,0,0,4
GCTGGTGACTCGTAGT-1_V12N28-333_D1,0,0,7,0,0,7
CGACACCGCTTAAGGA-1_V12N28-333_D1,1,0,4,0,0,5
GTAACAACTGACCTTG-1_V12N28-333_D1,0,0,7,0,0,7
CAACTGAGGGTATGAC-1_V12N28-333_D1,0,0,4,0,0,4
CTAATTATGAAGCGTA-1_V12N28-333_D1,0,0,2,0,0,2
CCGATCTTAAGAGGCT-1_V12N28-333_D1,0,0,3,0,0,3
CGACTCGGTACACGGT-1_V12N28-333_D1,1,0,4,0,0,5
TGCTGCGTCAGAGTTA-1_V12N28-333_D1,1,0,4,0,0,5
AGAGTTGCAGGCCTCC-1_V12N28-333_D1,0,0,6,0,0,6
ACTGGCGAACCTGCGT-1_V12N28-333_D1,2,0,3,0,0,5
ACTAAGGACGCACACC-1_V12N28-333_D1,1,1,5,0,0,7
CGTCCAGATGGCTCCA-1_V12N28-333_D1,2,0,0,0,0,2
ACTATCGCCGGCTAAA-1_V12N28-333_D1,2,2,0,0,0,4
GATAGCGTACCACGCG-1_V12N28-333_D1,3,2,0,0,0,5
AGGACTTATAGGAGAA-1_V12N28-333_D1,0,0,0,1,0,1
TAGTCGGGATTCTTCG-1_V12N28-333_D1,1,0,0,2,0,3
ACCATTAAGGGTGTCA-1_V12N28-333_D1,2,1,1,0,0,4
TTAATGTGTTTGCAGG-1_V12N28-333_D1,3,0,1,0,0,4
TCCGCAGCCACCTAGC-1_V12N28-333_D1,2,0,0,0,0,2
GAGGAGATCCTCATGC-1_V12N28-333_D1,6,0,0,0,0,6
GGTCCTTCATACGACT-1_V12N28-333_D1,0,2,0,1,0,3
CCCTGTTGGCAAAGAC-1_V12N28-333_D1,2,3,1,0,0,6
GTGCCTAGCTATGCTT-1_V12N28-333_D1,0,0,5,0,0,5
GTCATCTCCTACAGCT-1_V12N28-333_D1,0,2,1,1,0,4
GCGAGAAACGGGAGTT-1_V12N28-333_D1,0,3,1,0,0,4
CGTCGCGGCGGGATTT-1_V12N28-333_D1,1,0,0,0,0,1
CATTGTGTGCTAGATC-1_V12N28-333_D1,0,1,2,0,0,3
CGCGGCAGTATTACGG-1_V12N28-333_D1,0,1,2,0,0,3
GAAATGGGATGTAAAC-1_V12N28-333_D1,2,3,0,0,2,7
CATTCCCTAAGTACAA-1_V12N28-333_D1,0,1,1,0,0,2
AGTTCTGCGTTGTATC-1_V12N28-333_D1,1,2,0,0,0,3
ACCCTATAGGACTGAG-1_V12N28-333_D1,2,2,1,0,1,6
TTAGATAGGTCGATAC-1_V12N28-333_D1,4,2,2,0,1,9
ATTGATAGCAACGAGA-1_V12N28-333_D1,1,1,0,0,0,2
TCTCGGCTCCAGGACT-1_V12N28-333_D1,2,1,0,0,2,5
CTTGAGGTTATCCCGA-1_V12N28-333_D1,1,1,0,0,0,2
AAGAAGGATCAGTTAG-1_V12N28-333_D1,1,0,3,0,0,4
GTACGACGGCGCTGCG-1_V12N28-333_D1,1,0,0,0,0,1
CTTATGTTGACTACCA-1_V12N28-333_D1,1,0,0,0,0,1
CGGCACTCAAGAAAGT-1_V12N28-333_D1,0,1,0,0,1,2
GTCAAAGTTTACATAG-1_V12N28-333_D1,0,0,0,0,0,0
CTCCTAAGTTATGTCT-1_V12N28-333_D1,1,0,0,0,2,3
ACTGTGCTAGTAGATC-1_V12N28-333_D1,0,0,0,0,0,0
GTTTGGCCGCTCAGCG-1_V12N28-333_D1,1,0,0,0,1,2
TTATCCAATCGAACTC-1_V12N28-333_D1,0,1,0,0,0,1
CCGTACCCAAGCGCCA-1_V12N28-333_D1,3,0,0,0,1,4
CATACAAAGCCGAACC-1_V12N28-333_D1,2,0,0,0,0,2
GGTCGGTAATTAGACA-1_V12N28-333_D1,0,0,0,0,0,0
AGCGGGAAGGGTCCAT-1_V12N28-333_D1,0,0,0,0,1,1
GCCCACCAAGGCTGTC-1_V12N28-333_D1,5,1,1,0,0,7
GTAGACGTCGTTACAT-1_V12N28-333_D1,0,1,0,0,3,4
GAGCATCATCCCTGGG-1_V12N28-333_D1,1,0,0,0,3,4
AGGTAACCTCCTATTC-1_V12N28-333_D1,0,0,1,0,0,1
GGTTTGAGTGCTGGAA-1_V12N28-333_D1,0,0,1,0,0,1
GCACTAGTCGCGCTAT-1_V12N28-333_D1,0,0,1,0,0,1
GGTAACTATGTATCTG-1_V12N28-333_D1,0,0,6,0,0,6
GCGGTCCCTAGACGCA-1_V12N28-333_D1,0,1,4,0,0,5
CGAGCGTTGATCAGCC-1_V12N28-333_D1,0,0,2,0,2,4
AATCCAAGGGCCTGAG-1_V12N28-333_D1,0,0,0,0,0,0
GAAATTCACATCGCTG-1_V12N28-333_D1,0,0,2,0,0,2
CTCTGCGAAGCAAGCA-1_V12N28-333_D1,0,0,1,0,0,1
AGTAGGTAACATACAT-1_V12N28-333_D1,2,1,8,0,0,11
ATTGGGAATATCTTGG-1_V12N28-333_D1,0,0,3,0,0,3
TAGAGCTACGAAGAAC-1_V12N28-333_D1,0,0,4,0,0,4
TGCGGCATAGTTCAAC-1_V12N28-333_D1,0,1,2,0,0,3
CCGCCGGTCAACACAC-1_V12N28-333_D1,0,0,0,0,0,0
TCGTATAGTGCAATTA-1_V12N28-333_D1,0,0,0,0,0,0
TAGTTTATTCTTGCTT-1_V12N28-333_D1,1,0,5,0,0,6
GATATCTCATGCAATA-1_V12N28-333_D1,0,0,2,0,0,2
CGTTTAAGCGGAGCAC-1_V12N28-333_D1,0,0,1,0,0,1
CATGCTGGCTCCAATT-1_V12N28-333_D1,0,0,1,0,0,1
GAAACAGCCATGCAGT-1_V12N28-333_D1,0,2,1,0,0,3
AGTTTCGCAGGTCGGA-1_V12N28-333_D1,0,0,3,0,0,3
CTCATGGCTCACAATC-1_V12N28-333_D1,0,0,1,0,0,1
AACCGTTGTGTTTGCT-1_V12N28-333_D1,0,0,3,0,1,4
ACCCTTCATCTGCGAA-1_V12N28-333_D1,0,0,2,0,0,2
TGCGGTGAAATTTCAT-1_V12N28-333_D1,0,0,2,0,0,2
CAAATTGTCAGCAAGC-1_V12N28-333_D1,1,0,0,0,1,2
GAGGTACATCCATCTT-1_V12N28-333_D1,0,0,1,0,0,1
AAATGGCATGTCTTGT-1_V12N28-333_D1,1,0,0,0,1,2
TCATCCCAGAGGGTGG-1_V12N28-333_D1,1,0,1,0,0,2
CGTAGCGAATTGTCAG-1_V12N28-333_D1,1,0,1,0,1,3
CCTAGTTAGTCGCATG-1_V12N28-333_D1,0,0,1,0,0,1
GAAACTCTAATGAAGG-1_V12N28-333_D1,0,0,0,0,0,0
TTGTATCACACAGAAT-1_V12N28-333_D1,0,0,1,0,1,2
TTCAAGCCGAGCTGAG-1_V12N28-333_D1,3,0,0,0,0,3
AGGTACGATATTGCCA-1_V12N28-333_D1,0,0,1,0,0,1
TTAAGCCGACAACTTC-1_V12N28-333_D1,0,0,0,0,0,0
GTCTTAGTACAGCCGG-1_V12N28-333_D1,1,0,0,0,0,1
TGGGTAAGGTTCCCGC-1_V12N28-333_D1,1,2,0,0,1,4
CTACGCCATTTCCGAT-1_V12N28-333_D1,0,0,1,0,0,1
GACCGTCAGGTCGTGA-1_V12N28-333_D1,0,0,0,0,1,1
TAGTTAAGATAGGATA-1_V12N28-333_D1,1,2,1,0,0,4
GAATATTCGGAGTCCC-1_V12N28-333_D1,1,1,2,0,0,4
CAAACTACGATAGAGA-1_V12N28-333_D1,0,0,2,0,0,2
CAGGAAGACTTTATAT-1_V12N28-333_D1,1,0,0,0,1,2
TTCGTAATCCCAGCGG-1_V12N28-333_D1,1,0,0,0,0,1
GTGAGGAGCGGTTGAG-1_V12N28-333_D1,2,0,0,0,1,3
CAATCCCTATACCAGC-1_V12N28-333_D1,0,0,2,0,0,2
AGGGAAACGAGGTACT-1_V12N28-333_D1,1,0,0,0,0,1
TCCTGCCAACTGGAGA-1_V12N28-333_D1,1,1,1,0,1,4
AATTTGGGACATAGTA-1_V12N28-333_D1,0,1,0,0,0,1
AACTCCTAATCCCATG-1_V12N28-333_D1,0,0,1,0,0,1
GCTCATTACTGCATGT-1_V12N28-333_D1,2,0,1,0,0,3
TCTCGAACGAGGTCAC-1_V12N28-333_D1,0,0,0,0,0,0
TCACTACGACCAATGC-1_V12N28-333_D1,1,0,0,0,0,1
GTGATGCACAACATCT-1_V12N28-333_D1,0,1,0,0,0,1
CCGACGTAAACACAAC-1_V12N28-333_D1,0,1,1,0,0,2
TGGGATGCACTCATTC-1_V12N28-333_D1,0,1,1,0,0,2
TTCCATCATGCGGTGA-1_V12N28-333_D1,0,0,3,0,0,3
TGCACAGTGAAGTTAT-1_V12N28-333_D1,1,1,7,0,0,9
CTATTGTGTTTGGTCA-1_V12N28-333_D1,0,0,0,0,1,1
TGCGAGCCCTTCCGCG-1_V12N28-333_D1,0,0,1,0,0,1
TTGAAAGGTGTAAAGG-1_V12N28-333_D1,0,1,3,0,0,4
GGTGCAGAGCCTATCG-1_V12N28-333_D1,0,1,3,0,0,4
ACTATATGCTGTGTTC-1_V12N28-333_D1,0,0,2,0,0,2
TCCTGGCGCTGCCTGG-1_V12N28-333_D1,1,0,0,0,0,1
GAGCCGAGCGTTTATT-1_V12N28-333_D1,0,0,2,0,0,2
AGAATGCGGGTTCGGA-1_V12N28-333_D1,0,0,2,0,0,2
ATGCGACAATTGGTCC-1_V12N28-333_D1,0,0,0,0,1,1
TTCCGGCTCGACTTCT-1_V12N28-333_D1,0,0,0,0,0,0
TGATTATGGCACGCAG-1_V12N28-333_D1,0,0,5,0,0,5
GGTTTGACAAGAAGCT-1_V12N28-333_D1,0,0,2,0,0,2
GCAGCTATGGACAGGT-1_V12N28-333_D1,0,0,2,0,0,2
CACCATGATCGCAAAG-1_V12N28-333_D1,0,0,1,0,0,1
GTCGGAAGGATACCAG-1_V12N28-333_D1,0,0,1,0,0,1
GGCCCAGTTATCAGCA-1_V12N28-333_D1,0,0,2,0,0,2
GGGCCTATTTAAGTAT-1_V12N28-333_D1,0,0,5,0,0,5
GTTGTTACATTGCGCT-1_V12N28-333_D1,0,0,0,0,0,0
CAACTCCGTAACTTGC-1_V12N28-333_D1,0,0,2,0,0,2
GATCTTTGCTCAAAGA-1_V12N28-333_D1,0,0,6,0,0,6
TCGCTTAATTACGAAG-1_V12N28-333_D1,0,0,1,0,0,1
CGATCATTAGAGGCAC-1_V12N28-333_D1,0,0,3,0,0,3
TGTTCTCTACTCCCTA-1_V12N28-333_D1,0,0,4,0,0,4
GCTTAGGGAAGCGGTA-1_V12N28-333_D1,1,0,0,0,0,1
CAGGTTTAGTACTACA-1_V12N28-333_D1,0,0,4,0,0,4
AAGCGGAGTGCGCGCA-1_V12N28-333_D1,1,0,3,0,0,4
TCAGATGGAGACGTAG-1_V12N28-333_D1,0,0,0,0,0,0
TCGCACTAACGTTTGT-1_V12N28-333_D1,3,1,1,1,0,6
CACGTCGGGTTCTAGA-1_V12N28-333_D1,1,0,0,3,0,4
GGAGTACACATGAGCT-1_V12N28-333_D1,2,2,1,0,0,5
GTGTGTCGACGTCGCT-1_V12N28-333_D1,0,0,0,1,0,1
GAAGCTCTTTGCTTAG-1_V12N28-333_D1,1,0,0,1,0,2
ACACCGAGCGCTCTTT-1_V12N28-333_D1,1,0,2,0,0,3
CGTAATAATTACGAGT-1_V12N28-333_D1,0,0,2,0,0,2
CATCAACACCTACTAA-1_V12N28-333_D1,2,2,2,0,0,6
CCAAGTTTCTACAGAT-1_V12N28-333_D1,1,0,3,0,0,4
ACGGGTCATGTGACTT-1_V12N28-333_D1,0,0,4,0,0,4
AGTGTGCTAAGATCGC-1_V12N28-333_D1,1,0,3,1,0,5
GGCGGTTTGCCGGTGC-1_V12N28-333_D1,1,0,1,0,0,2
GTATAATCTCCCGGAT-1_V12N28-333_D1,2,1,3,0,0,6
TAGTCCGTATGCATAA-1_V12N28-333_D1,0,0,0,0,1,1
CACTTCGTCTTATCTC-1_V12N28-333_D1,0,2,2,0,0,4
CATCCGCAGGCCCGAA-1_V12N28-333_D1,1,1,2,0,0,4
CCCTGATGTAACTCGT-1_V12N28-333_D1,2,2,0,0,0,4
CCATAGTCAGTAACCC-1_V12N28-333_D1,1,0,2,0,0,3
CGGGCCATAGCCGCAC-1_V12N28-333_D1,1,1,1,0,0,3
CTCCGGCTTGTAGACA-1_V12N28-333_D1,2,0,0,0,0,2
AACTTGCGTTCTCGCG-1_V12N28-333_D1,1,2,0,0,1,4
AATGAGTTCGCATATG-1_V12N28-333_D1,1,1,1,0,0,3
CGAGGCCAGGCATTGG-1_V12N28-333_D1,0,1,1,0,1,3
TCTGCGTCCGGTTTCT-1_V12N28-333_D1,1,1,2,0,2,6
CAATCCTGCCGTGGAG-1_V12N28-333_D1,3,1,0,0,0,4
CTGAGCAAGTAACAAG-1_V12N28-333_D1,2,0,3,0,0,5
GGGTACCCACGGTCCT-1_V12N28-333_D1,1,0,0,0,1,2
ACGGAATTTAGCAAAT-1_V12N28-333_D1,0,0,0,0,1,1
GGGCGGTCCTATTGTC-1_V12N28-333_D1,1,0,1,0,0,2
ATGTTACGAGCAATAC-1_V12N28-333_D1,0,1,1,0,0,2
AACCATGGGATCGCTA-1_V12N28-333_D1,0,0,0,0,0,0
TCGCATCCCTAAGTGT-1_V12N28-333_D1,0,1,0,0,1,2
ACTTAGTACGACAAGA-1_V12N28-333_D1,0,0,0,0,1,1
GAGCTCTCGGACCTAA-1_V12N28-333_D1,1,1,0,0,0,2
TCTATTACGCTGGCGA-1_V12N28-333_D1,2,0,0,0,2,4
AGATACGACTTCATAT-1_V12N28-333_D1,1,0,0,0,0,1
CGCTATACCGCCCACT-1_V12N28-333_D1,1,0,0,0,0,1
CAGTGTCCGCAGAATG-1_V12N28-333_D1,4,1,1,0,0,6
CCATCCATACCAAGTC-1_V12N28-333_D1,2,0,1,0,0,3
AACCCAGAGACGGAGA-1_V12N28-333_D1,6,0,0,0,0,6
GAAGAACGGTGCAGGT-1_V12N28-333_D1,0,0,0,0,0,0
GATAAATCGGTGGATG-1_V12N28-333_D1,0,0,3,0,0,3
CAGCTCGTGCTTGTGT-1_V12N28-333_D1,1,1,1,0,0,3
GAGTACGGGTATACAA-1_V12N28-333_D1,0,0,1,0,0,1
CATCGCCCGCGGCCAA-1_V12N28-333_D1,0,1,2,0,0,3
TCTTACAGAGGTACCG-1_V12N28-333_D1,0,0,0,0,0,0
TGGAAGACGAACACCA-1_V12N28-333_D1,0,0,0,0,0,0
GTTGTCGTGTTAGTTG-1_V12N28-333_D1,0,0,0,0,0,0
CCAAGGAACAGAGAGG-1_V12N28-333_D1,0,0,2,0,0,2
CTGCACCTGGAACCGC-1_V12N28-333_D1,0,0,2,0,0,2
CGCTTTCATACCGGTG-1_V12N28-333_D1,0,0,3,0,0,3
GTTCTTCCCTCGATGT-1_V12N28-333_D1,0,0,0,0,0,0
ATTTAACTCGTATTAC-1_V12N28-333_D1,0,0,0,0,0,0
AACGATAGAAGGGCCG-1_V12N28-333_D1,0,0,1,0,0,1
TATCCTGCATGGGAAT-1_V12N28-333_D1,0,1,2,0,0,3
AGGCCCATTGTACAGG-1_V12N28-333_D1,1,0,0,0,1,2
CCGGCGCATATTGGAT-1_V12N28-333_D1,1,0,1,0,0,2
ATCTGTAATTGTACCC-1_V12N28-333_D1,1,1,0,0,0,2
GAGCGAGGGAGTACCG-1_V12N28-333_D1,1,0,2,0,1,4
TTATTAGGGAAGCATC-1_V12N28-333_D1,3,1,0,0,1,5
CTTCTTACGTCGTATA-1_V12N28-333_D1,0,0,1,0,0,1
GAAGTGCTGGATAGCT-1_V12N28-333_D1,3,0,0,0,0,3
GTGCAACAAATGTGGC-1_V12N28-333_D1,1,0,0,0,0,1
CATGCGTTAGACAGAA-1_V12N28-333_D1,3,0,0,0,0,3
ACACACTTTCTACACG-1_V12N28-333_D1,0,0,1,0,1,2
AGCCCTAAGCGAAGTT-1_V12N28-333_D1,1,0,0,0,1,2
ATTAATTCGGTCACTC-1_V12N28-333_D1,1,0,0,0,2,3
AACAGGAAATCGAATA-1_V12N28-333_D1,0,1,0,0,1,2
ACGTTTAGTTGTGATC-1_V12N28-333_D1,0,0,0,0,1,1
TCCTTCAGTGGTCGAA-1_V12N28-333_D1,2,1,1,0,1,5
CGAACGCCCAGTGCCG-1_V12N28-333_D1,1,1,0,0,1,3
CCTCGAAGTGGACGGG-1_V12N28-333_D1,2,0,0,0,1,3
CTCTGTTTGAGGATTC-1_V12N28-333_D1,1,0,1,0,1,3
TGGGCACGTTCTATGG-1_V12N28-333_D1,2,0,0,0,2,4
ACTATTCGTCCGTGGT-1_V12N28-333_D1,3,0,0,0,0,3
CCTCTGGCCTAGACGG-1_V12N28-333_D1,1,0,0,0,2,3
CCATAAACAACCCGAC-1_V12N28-333_D1,0,0,0,0,1,1
CATAGTACATTGAGAG-1_V12N28-333_D1,1,1,0,0,0,2
ATTTCATTATTTCGCG-1_V12N28-333_D1,0,0,0,0,0,0
CAACTATATCGAATGC-1_V12N28-333_D1,0,0,0,0,2,2
CTAGTATTCGGAATTA-1_V12N28-333_D1,1,0,0,0,1,2
GTGGAACCTACATGCG-1_V12N28-333_D1,1,0,0,0,2,3
CCTAAAGGCTGACGCT-1_V12N28-333_D1,3,0,0,0,2,5
CGTGACATTGGGTCGT-1_V12N28-333_D1,2,0,0,0,0,2
CCAATCGGTAGATCGA-1_V12N28-333_D1,1,0,0,0,1,2
ATTGTCGCAATACCTT-1_V12N28-333_D1,0,0,0,0,0,0
AAATTACACGACTCTG-1_V12N28-333_D1,1,1,0,0,2,4
CACTCCTCTCGGTCGG-1_V12N28-333_D1,0,0,0,0,1,1
AAATAACCATACGGGA-1_V12N28-333_D1,0,0,0,0,1,1
AGTTACTCTATCGTGG-1_V12N28-333_D1,4,0,0,0,1,5
CGTTAGCTCACAACTG-1_V12N28-333_D1,0,2,0,0,1,3
GAATGTATGGCAGGTC-1_V12N28-333_D1,2,2,1,0,1,6
GCAACCACCAGACCGG-1_V12N28-333_D1,0,1,0,0,1,2
TCACTCGTGCAACGGC-1_V12N28-333_D1,1,0,0,0,3,4
AAACAGAGCGACTCCT-1_V12N28-333_D1,3,0,0,0,0,3
CAGCCTCTCCTCAAGA-1_V12N28-333_D1,1,0,0,0,2,3
TTGCGTGAACGCTTAG-1_V12N28-333_D1,2,0,1,0,0,3
CCGCCTGCGAATTGGT-1_V12N28-333_D1,0,1,0,0,3,4
AGATGAGGGTTGCGAT-1_V12N28-333_D1,1,0,0,0,0,1
CGGTGGGCTCCAGCCT-1_V12N28-333_D1,2,0,1,0,1,4
GGCAGCGGTAATCCTA-1_V12N28-333_D1,3,0,0,0,0,3
GCTAGCAGGGAGTGGG-1_V12N28-333_D1,1,0,0,0,1,2
CTCAAGACATTAGCGC-1_V12N28-333_D1,0,0,0,0,0,0
CACGGCGCGCCAAAGG-1_V12N28-333_D1,0,0,0,0,0,0
TGCAATTTGGGCACGG-1_V12N28-333_D1,0,0,0,0,0,0
ATGCCAATCGCTCTGC-1_V12N28-333_D1,3,0,0,0,1,4
GCTGGACCCAAAGTGG-1_V12N28-333_D1,0,0,1,0,0,1
ATTCCTAAGACGTGGA-1_V12N28-333_D1,0,1,1,0,0,2
TCCGGAGGAAGGGCTG-1_V12N28-333_D1,0,0,0,0,0,0
TCGGTGACCGCTCCGG-1_V12N28-333_D1,2,0,1,0,0,3
TCCGAAGTAGTCACCA-1_V12N28-333_D1,0,0,2,0,0,2
CATGTAGGAGCGCCAA-1_V12N28-333_D1,0,0,0,0,0,0
CACAAGAAAGATATTA-1_V12N28-333_D1,0,1,1,0,0,2
AGGGTCAGTAACCCTA-1_V12N28-333_D1,0,0,2,0,0,2
TAAGCCCTTACGACCA-1_V12N28-333_D1,0,0,0,0,0,0
ATACCGTCATCCATAA-1_V12N28-333_D1,0,1,1,0,0,2
GGACGTCCATAGTTGG-1_V12N28-333_D1,0,0,1,0,0,1
CATCAAACTGGCGCCC-1_V12N28-333_D1,0,0,2,0,0,2
AAACGTGTTCGCCCTA-1_V12N28-333_D1,0,0,0,0,1,1
AAATTGGTGAGAAGCA-1_V12N28-333_D1,0,0,3,0,1,4
GGTCATTGTAGTCATA-1_V12N28-333_D1,0,0,2,0,0,2
TGCAGTGAGGCTCGGG-1_V12N28-333_D1,0,0,1,0,0,1
GAACATTAGTATGTTA-1_V12N28-333_D1,0,0,0,0,0,0
GGTTTGCGAACACGTA-1_V12N28-333_D1,0,0,0,0,0,0
ACACAAATATTCCTAG-1_V12N28-333_D1,0,0,0,0,0,0
TTGGGTTTATTCAGCG-1_V12N28-333_D1,0,0,2,0,0,2
ATTCGCAGAGGACACT-1_V12N28-333_D1,0,0,2,0,0,2
GATTTAGTGCGTACTG-1_V12N28-333_D1,0,0,3,0,0,3
TAGAAACACAATAGTG-1_V12N28-333_D1,2,0,0,2,0,4
CAGTAGATGATGTCCG-1_V12N28-333_D1,1,0,0,0,0,1
TCTTAACTCGGATGTA-1_V12N28-333_D1,1,0,1,2,0,4
TACATCTTGTTTCTTG-1_V12N28-333_D1,2,0,0,2,0,4
TTCATAGGGTGTCCAT-1_V12N28-333_D1,1,0,1,0,0,2
TGAAGTAGCTTACGGA-1_V12N28-333_D1,2,3,0,0,0,5
GCACAAGTGGATCATA-1_V12N28-333_D1,0,1,0,0,0,1
GGGCGAATTTCTCCAC-1_V12N28-333_D1,1,0,3,0,0,4
ATGTTCCTGCCCACCT-1_V12N28-333_D1,0,3,2,3,0,8
GCTCAACCTCTTAGAG-1_V12N28-333_D1,0,0,2,3,0,5
ATAGCTGCTCTTGTTA-1_V12N28-333_D1,1,1,3,0,0,5
CGTCAGCTATTTACTC-1_V12N28-333_D1,0,2,1,0,0,3
ATCTGATAGTGTCTTA-1_V12N28-333_D1,0,2,2,0,0,4
TGCACTATGTGAGTGC-1_V12N28-333_D1,1,2,0,0,0,3
CCGACAAACACATGAG-1_V12N28-333_D1,3,1,0,0,0,4
GCCTTGTATATGCAGT-1_V12N28-333_D1,1,1,2,0,0,4
ATAATACCGTTAGCCG-1_V12N28-333_D1,1,0,2,0,1,4
ACACTCCAATGTCACT-1_V12N28-333_D1,2,0,0,0,1,3
AGTTGCTGACTGATAT-1_V12N28-333_D1,2,1,0,0,0,3
GGCGCTCCTCATCAAT-1_V12N28-333_D1,0,0,0,0,0,0
TGCCTGACATCGGTCA-1_V12N28-333_D1,0,0,0,0,1,1
TTGGCCATCTTGCGCT-1_V12N28-333_D1,0,0,0,0,0,0
CAGTGGTTGCACATGA-1_V12N28-333_D1,5,0,1,0,0,6
AGAATTGTTTGACATA-1_V12N28-333_D1,1,2,1,0,0,4
AAATGCTCGTTACGTT-1_V12N28-333_D1,0,1,1,0,1,3
CACCTAATAGAGTCGT-1_V12N28-333_D1,1,0,1,0,2,4
CATTTCTAGCAGACTA-1_V12N28-333_D1,1,0,0,0,0,1
CCGAAAGTGGTGAGCA-1_V12N28-333_D1,0,0,1,0,0,1
AGTCAGCCACCGCCTG-1_V12N28-333_D1,4,0,4,0,0,8
TCATCACTCGAGCTCG-1_V12N28-333_D1,2,0,0,0,1,3
CTCAGGACTCACCTGT-1_V12N28-333_D1,3,1,1,0,0,5
CGGTGTACTTGATCCC-1_V12N28-333_D1,1,1,0,0,0,2
CCTACGGCTCAGTCGA-1_V12N28-333_D1,2,1,0,0,0,3
GTACTTGGGCACTTCT-1_V12N28-333_D1,1,0,0,0,1,2
TGATTTCCTCCTGACG-1_V12N28-333_D1,1,0,0,0,1,2
CCTCACCAATCTTGAC-1_V12N28-333_D1,2,2,0,0,1,5
GGTGAGATGCAGATAA-1_V12N28-333_D1,2,0,0,0,1,3
GCTAGTTTCATTGAGG-1_V12N28-333_D1,1,1,0,0,1,3
AGGACATCGCACGTCG-1_V12N28-333_D1,1,0,1,0,1,3
GTGGACGTGCTGAGAC-1_V12N28-333_D1,0,0,1,0,0,1
TAAGGAACTTGTGGGA-1_V12N28-333_D1,1,1,1,0,1,4
TCGCTGTGCGTAAATC-1_V12N28-333_D1,1,0,3,0,0,4
GCATCCCTAACTTTGA-1_V12N28-333_D1,0,0,3,0,0,3
CACCCACACGTCACCC-1_V12N28-333_D1,0,0,4,0,1,5
CCCTCATTCTGGAATT-1_V12N28-333_D1,0,0,1,0,0,1
AGGGCGTGATCGGCTA-1_V12N28-333_D1,0,0,0,0,1,1
GGTGCGGATAAGTGGC-1_V12N28-333_D1,0,0,1,0,0,1
TAATATTGAAATTCGC-1_V12N28-333_D1,0,0,2,0,0,2
CTTACACTGGGAAATA-1_V12N28-333_D1,0,0,0,1,1,2
ACCAAGAACGCGTGTC-1_V12N28-333_D1,0,1,2,0,0,3
GCCTTCAGCCCTACCG-1_V12N28-333_D1,0,2,3,0,0,5
GATGCTACAAGCGCCT-1_V12N28-333_D1,1,2,2,0,1,6
CCGGGACCCGCAGAGA-1_V12N28-333_D1,0,0,2,0,1,3
GTTCCAGTCTGACCAT-1_V12N28-333_D1,0,0,0,0,0,0
ATGATCGGGAATAGAC-1_V12N28-333_D1,3,0,0,0,1,4
TTGGATTGGGTACCAC-1_V12N28-333_D1,3,0,0,0,0,3
TACCTCACGCTTGTAC-1_V12N28-333_D1,1,0,2,0,1,4
CATGGCAGGAAGATCG-1_V12N28-333_D1,3,0,0,0,1,4
ATGACGCCGGCTCTAA-1_V12N28-333_D1,3,0,0,0,1,4
AGCGACATCCCATTCA-1_V12N28-333_D1,1,1,0,0,1,3
AGTAATGTCTTGCCGC-1_V12N28-333_D1,1,0,0,0,1,2
TTCTTAGTGGCTCAGA-1_V12N28-333_D1,2,0,0,0,0,2
CGTCTGGAAGGGCCCG-1_V12N28-333_D1,0,0,0,0,0,0
ACGTGCGCCTCGTGCA-1_V12N28-333_D1,2,1,0,0,1,4
AGAGCGGGCTAATCAT-1_V12N28-333_D1,2,0,0,0,1,3
GCGTCGAAATGTCGGT-1_V12N28-333_D1,2,0,0,0,0,2
AACTGATATTAGGCCT-1_V12N28-333_D1,1,0,0,0,0,1
CGAGCTGGGCTTTAGG-1_V12N28-333_D1,0,0,0,0,0,0
GGGTGTTTCAGCTATG-1_V12N28-333_D1,3,1,0,0,1,5
TTAATTTCAGACGCGG-1_V12N28-333_D1,1,0,0,0,1,2
ACTGCCGTCGTAACTC-1_V12N28-333_D1,2,1,0,0,1,4
GTGCACGAAAGTGACT-1_V12N28-333_D1,2,0,0,0,0,2
ATCTCCCTGCAATCTA-1_V12N28-333_D1,1,0,0,0,1,2
ACGCCAGATGATTTCT-1_V12N28-333_D1,0,0,0,0,0,0
AGCTATTTAATCCAAC-1_V12N28-333_D1,4,0,0,0,0,4
CCACGAGAAGAGAATC-1_V12N28-333_D1,0,0,0,0,0,0
GATTCCGCGTTTCCGT-1_V12N28-333_D1,0,0,0,0,1,1
GTCGGATGTAGCGCGC-1_V12N28-333_D1,3,1,0,0,0,4
TATTTATACCGAGTAG-1_V12N28-333_D1,0,0,0,0,1,1
GTAGGTGATCCGTGTA-1_V12N28-333_D1,0,0,0,0,0,0
AGTTAAGCGGTCCCGG-1_V12N28-333_D1,4,0,1,0,1,6
CTGGCGACATAAGTCC-1_V12N28-333_D1,1,0,0,0,0,1
TTGGCCTAGAATTTCG-1_V12N28-333_D1,0,0,0,0,0,0
GGCATATCGGTTCTGC-1_V12N28-333_D1,0,0,0,0,0,0
GGGCGTCCACTGGCTC-1_V12N28-333_D1,2,1,0,0,2,5
TTACCCATTGCCGGGT-1_V12N28-333_D1,3,0,0,0,0,3
TTAGACACGATCGTTG-1_V12N28-333_D1,5,0,0,0,0,5
GCGCTGATCCAGACTC-1_V12N28-333_D1,1,0,0,0,0,1
TTCGGCAACCCGCTGA-1_V12N28-333_D1,0,1,0,0,1,2
GATATTTCCTACATGG-1_V12N28-333_D1,2,0,0,0,1,3
CTGCGTTACGATATAA-1_V12N28-333_D1,1,0,0,0,2,3
TAATAAACAAGGAGAT-1_V12N28-333_D1,3,0,0,0,0,3
AACCTTTACGACGTCT-1_V12N28-333_D1,2,0,0,0,0,2
AGTCCCGCCTTTAATT-1_V12N28-333_D1,1,0,0,0,0,1
TGAGATTAGGCCCTAA-1_V12N28-333_D1,2,0,1,0,2,5
AGTGTATTGCGCATTG-1_V12N28-333_D1,1,1,0,0,1,3
GTTGGATTCAGTGGCT-1_V12N28-333_D1,1,0,0,0,1,2
TAAAGCTGCAATAGGG-1_V12N28-333_D1,1,0,0,0,2,3
AGTAGGAAGGAAGTTG-1_V12N28-333_D1,0,0,0,0,2,2
TATCACTTCGAGTAAC-1_V12N28-333_D1,1,0,0,0,0,1
TGATCTACGCTGATCT-1_V12N28-333_D1,1,1,0,0,0,2
GGATCATCCCGTACGC-1_V12N28-333_D1,1,0,0,0,2,3
TGACACTTCTCTTTGC-1_V12N28-333_D1,1,0,0,0,1,2
AGCCCTTCTAATCCGA-1_V12N28-333_D1,1,0,0,0,2,3
CACCGCGTCCACTCTA-1_V12N28-333_D1,0,0,0,0,1,1
TAATTGGAATCGGGAA-1_V12N28-333_D1,2,0,0,0,0,2
TCGTAAGCTCCGAGGA-1_V12N28-333_D1,3,0,0,0,0,3
TATATTACAAATGTCG-1_V12N28-333_D1,1,0,0,0,2,3
CGCGAGAGGGACTTGT-1_V12N28-333_D1,1,0,0,0,0,1
GGACCTACGGTAACGT-1_V12N28-333_D1,3,0,0,0,1,4
GAAATATGCTTGAATG-1_V12N28-333_D1,1,0,1,0,1,3
CCGTATTAGCGCAGTT-1_V12N28-333_D1,1,0,0,0,1,2
AGGCGTCTATGGACGG-1_V12N28-333_D1,0,0,4,0,0,4
AACATCGATACGTCTA-1_V12N28-333_D1,0,0,1,0,0,1
TGAATATGCTATAAAC-1_V12N28-333_D1,0,0,1,0,0,1
ACCAAACACCCAGCGA-1_V12N28-333_D1,0,2,1,0,0,3
TGGCTTGTACAAGCTT-1_V12N28-333_D1,0,1,1,0,0,2
GAATGAAGGTCTTCAG-1_V12N28-333_D1,0,0,1,0,0,1
AGATACCAGCACTTCA-1_V12N28-333_D1,0,0,0,0,0,0
GCGGTCCCGGTGAAGG-1_V12N28-333_D1,0,1,2,0,0,3
GAGGCATTTGCAGCAG-1_V12N28-333_D1,0,0,1,0,0,1
GGCAAGCCAGGGATAG-1_V12N28-333_D1,0,0,1,0,1,2
TCTACGGGCTCAGTTG-1_V12N28-333_D1,0,0,0,0,1,1
TCTGCGAATCGTTCGC-1_V12N28-333_D1,0,0,3,0,0,3
AGCTCGTTGATGGAAA-1_V12N28-333_D1,0,0,2,0,0,2
TGAATGAGATACAGCA-1_V12N28-333_D1,0,0,0,0,0,0
ACCCTTGCCTGGGTCG-1_V12N28-333_D1,0,0,1,0,0,1
GGCGAACCGTTCTGAT-1_V12N28-333_D1,0,0,6,0,1,7
GCGATGTCTGTGCTTG-1_V12N28-333_D1,0,1,2,0,0,3
ATTAACACCTGAGATA-1_V12N28-333_D1,5,0,0,0,0,5
GAAATCTGACCAAGTT-1_V12N28-333_D1,3,2,0,0,0,5
CCTGACAAACTCGCGC-1_V12N28-333_D1,0,0,1,1,0,2
ATGTCATTTCCCATTG-1_V12N28-333_D1,1,1,0,0,0,2
GCGGTGCGGAGCATCG-1_V12N28-333_D1,3,0,1,0,0,4
CGGAAAGCAAATGTGC-1_V12N28-333_D1,1,1,3,0,0,5
GCTGAGCAACGGTTCT-1_V12N28-333_D1,0,0,3,0,0,3
TCACTCTTCGTCTGTC-1_V12N28-333_D1,1,1,5,0,0,7
GATCTTCATTGTCCTC-1_V12N28-333_D1,0,0,3,0,1,4
ACTCGATGTATTTCAT-1_V12N28-333_D1,0,1,3,0,0,4
TGAAGAGCGGTCCTAG-1_V12N28-333_D1,0,2,2,0,0,4
TAAACGTCGTCAATGA-1_V12N28-333_D1,0,0,0,0,1,1
ACGTTATTGGTCACTC-1_V12N28-333_D1,5,1,1,0,1,8
ATAGCCTCAGTACCCA-1_V12N28-333_D1,0,0,3,0,0,3
CGGGAGTATACCGCCG-1_V12N28-333_D1,1,2,2,0,0,5
GTCCTACAGGCGGCTC-1_V12N28-333_D1,0,0,0,0,0,0
CGGATAAGCGGACATG-1_V12N28-333_D1,1,0,0,0,0,1
AACTTCTGCGTCTATC-1_V12N28-333_D1,1,0,1,1,1,4
GGGTTCAGACGAACAA-1_V12N28-333_D1,0,0,0,1,0,1
AGTCTGGACATCCTTG-1_V12N28-333_D1,1,1,1,0,0,3
TTGAACGAATCCTTTG-1_V12N28-333_D1,3,0,0,0,1,4
GAAATACTAAACGTTT-1_V12N28-333_D1,1,0,0,0,0,1
CCCGCGCAATGCACCC-1_V12N28-333_D1,1,0,1,0,0,2
TTCGGCTAGAGATGGT-1_V12N28-333_D1,1,0,0,0,0,1
GACACGAGTTAGAGGA-1_V12N28-333_D1,1,0,2,0,0,3
GAGGTCCCAAAGATCT-1_V12N28-333_D1,0,0,0,0,0,0
TAACTCCATGGAGGCT-1_V12N28-333_D1,2,0,0,0,1,3
CTTGTTTATGTAGCCA-1_V12N28-333_D1,2,0,0,0,0,2
GATGGCGCACACATTA-1_V12N28-333_D1,1,0,0,1,0,2
ATAATAGTGTAGGGAC-1_V12N28-333_D1,1,1,0,0,1,3
CGCTATTCAATGTATG-1_V12N28-333_D1,0,1,0,0,0,1
ATATTGCTGTCAAAGT-1_V12N28-333_D1,0,1,0,0,2,3
GGATTCAGTACGGTGG-1_V12N28-333_D1,2,0,0,0,0,2
TTCTTAGTGAACGGTG-1_V12N28-333_D1,1,0,0,0,2,3
AATGGTTCTCACAAGC-1_V12N28-333_D1,2,0,0,0,0,2
TATACACGCAAAGTAT-1_V12N28-333_D1,3,1,0,0,0,4
CTTCATAGCTCAAGAA-1_V12N28-333_D1,0,0,2,0,0,2
CAACGGTTCTTGATAC-1_V12N28-333_D1,0,2,0,0,0,2
ACACCCGAGAAATCCG-1_V12N28-333_D1,0,0,0,0,0,0
TCTATCATGCAGTTAC-1_V12N28-333_D1,0,0,6,0,0,6
CCCGCCATGCTCCCGT-1_V12N28-333_D1,0,0,2,0,0,2
CGCTTCCACTGAAATC-1_V12N28-333_D1,0,0,1,0,0,1
CACTGTCCAAGTGAGA-1_V12N28-333_D1,0,0,0,0,0,0
ATTACTAGCCTCTTGC-1_V12N28-333_D1,0,0,2,0,0,2
CATAGTAGCATAGTAG-1_V12N28-333_D1,0,0,2,0,0,2
CAACTCCTTGATCCCG-1_V12N28-333_D1,0,0,1,0,0,1
AAGTAGAAGACCGGGT-1_V12N28-333_D1,0,0,0,0,1,1
GCGGGAACCAGGCCCT-1_V12N28-333_D1,0,1,2,0,1,4
ATTAGATTGATAGCGG-1_V12N28-333_D1,0,0,1,0,1,2
CTCGGTCCGTAGCCTG-1_V12N28-333_D1,0,0,0,0,1,1
TGGCTTTGGGTAGACA-1_V12N28-333_D1,1,1,0,0,1,3
TATCCATATCATGCGA-1_V12N28-333_D1,1,0,0,0,1,2
GGAGTGCCGCCCTGGA-1_V12N28-333_D1,1,0,0,1,0,2
TGAGAATGCTTTACCG-1_V12N28-333_D1,4,0,1,0,0,5
TTAACCAACCCTCCCT-1_V12N28-333_D1,1,0,0,0,3,4
TGTTTCGGTACTTCTC-1_V12N28-333_D1,2,0,0,0,1,3
TTGCTGAAGGAACCAC-1_V12N28-333_D1,2,0,0,0,1,3
TATTTAGTCTAGATCG-1_V12N28-333_D1,1,1,0,0,1,3
CTCCGGCCTAATATGC-1_V12N28-333_D1,3,0,0,0,0,3
TTGTGGCCCTGACAGT-1_V12N28-333_D1,2,0,0,0,0,2
TCGCCGGTCGATCCGT-1_V12N28-333_D1,0,0,0,0,1,1
CCATAGGTTGGCGTGG-1_V12N28-333_D1,0,0,0,0,3,3
GAACGACCGAATGATA-1_V12N28-333_D1,0,1,0,0,1,2
TCCGATAATTGCCATA-1_V12N28-333_D1,2,0,0,0,0,2
CATTACGTCGGCCCGT-1_V12N28-333_D1,2,0,0,0,0,2
CAAGCACCAAATGCCT-1_V12N28-333_D1,1,0,0,0,1,2
TGCATGGATCGGATCT-1_V12N28-333_D1,1,1,0,0,0,2
GAAATCGCGCGCAACT-1_V12N28-333_D1,1,0,0,0,0,1
CTGAAAGAGATCCGAC-1_V12N28-333_D1,1,0,0,0,1,2
CACCTCGATGGTGGAC-1_V12N28-333_D1,0,2,0,0,1,3
ATTTGTTCCAGGGCTC-1_V12N28-333_D1,0,0,0,0,2,2
TGGGCCACAAGAGCGC-1_V12N28-333_D1,4,0,0,0,2,6
CCTTCTTGATCCAGTG-1_V12N28-333_D1,1,0,0,0,0,1
CCTCGCCAGCAAATTA-1_V12N28-333_D1,1,0,0,0,0,1
TTCATGGCGCAACAGG-1_V12N28-333_D1,0,0,0,0,0,0
TTAATCAGTACGTCAG-1_V12N28-333_D1,1,2,0,0,0,3
CCTATCTATATCGGAA-1_V12N28-333_D1,4,0,0,0,0,4
ATTATACTTTGCTCGT-1_V12N28-333_D1,0,0,0,0,0,0
ATGGATCCGGCGTCCG-1_V12N28-333_D1,1,0,0,0,0,1
CGCCCGCTTCCGTACA-1_V12N28-333_D1,1,2,0,0,1,4
GGATTCCGCTATACCC-1_V12N28-333_D1,0,0,0,0,1,1
CGGTCTATCAACCCGT-1_V12N28-333_D1,1,0,0,0,0,1
ATGCCGGTTGATGGGA-1_V12N28-333_D1,0,1,0,0,0,1
TCATGCAGGTTCTCAT-1_V12N28-333_D1,1,0,0,0,1,2
TGAGCTTTAATGACGC-1_V12N28-333_D1,3,0,0,0,2,5
TCCCTTAGATTACTCG-1_V12N28-333_D1,1,2,0,0,2,5
ATATCTCCCTCGTTAA-1_V12N28-333_D1,0,0,0,0,1,1
AGCTCTTCCCAGTGCA-1_V12N28-333_D1,1,1,0,0,0,2
TCGCTAAACCGCTATC-1_V12N28-333_D1,2,0,0,0,0,2
CACATTCTTTCGATGG-1_V12N28-333_D1,1,0,0,0,0,1
GATATGCGGTAGCCAA-1_V12N28-333_D1,4,0,1,0,0,5
CGTTTCACTTCGGGCG-1_V12N28-333_D1,2,0,0,0,0,2
CCAATTACGGGTCGAG-1_V12N28-333_D1,2,1,0,0,0,3
GCAGGTAGAGTATGGT-1_V12N28-333_D1,1,1,0,0,0,2
GTCGTATTGGCGTACA-1_V12N28-333_D1,2,0,0,0,0,2
GAAATTAGCACGGATA-1_V12N28-333_D1,0,1,0,0,2,3
AATGCACCAAGCAATG-1_V12N28-333_D1,1,0,0,0,0,1
AGGACGCTCGATGTTG-1_V12N28-333_D1,2,0,0,0,0,2
GGCTAAAGGGCGGGTC-1_V12N28-333_D1,4,0,0,0,1,5
CATCTATCCCGTGTCT-1_V12N28-333_D1,2,0,0,0,0,2
CAGTAACTATTTATTG-1_V12N28-333_D1,1,0,0,0,0,1
CATATACTACTGATAA-1_V12N28-333_D1,1,1,0,0,1,3
GCGTTCGGAGACCGGG-1_V12N28-333_D1,1,0,0,0,0,1
AAGTTCAGTCTGCGTA-1_V12N28-333_D1,0,1,1,0,1,3
CGAAGCTATAAATTCA-1_V12N28-333_D1,3,0,0,0,0,3
CGCGGTCACAAACCAA-1_V12N28-333_D1,2,0,0,0,1,3
GGGAATGAGCCCTCAC-1_V12N28-333_D1,1,0,0,0,1,2
ACGGAGCGCAAATTAC-1_V12N28-333_D1,2,0,0,0,1,3
CGTTCTTCGCACACCT-1_V12N28-333_D1,3,0,0,0,1,4
GAATAGCCCTGCGGTC-1_V12N28-333_D1,1,0,0,0,0,1
AATAGCTACCGCGTGC-1_V12N28-333_D1,4,0,0,0,1,5
CCGAGCTGTGCTTGTC-1_V12N28-333_D1,2,0,0,0,3,5
GATGACGATGATCGCG-1_V12N28-333_D1,1,1,0,0,0,2
GCCTATGCTGGGCCTT-1_V12N28-333_D1,2,0,0,0,0,2
TTACTGTCTAGAGCTC-1_V12N28-333_D1,1,0,0,0,0,1
AGCGGTTGCCGCTCTG-1_V12N28-333_D1,2,0,0,0,0,2
GCTTGCAGCACAATTG-1_V12N28-333_D1,1,0,0,0,0,1
CCGGAGGTCTTATGGT-1_V12N28-333_D1,1,0,1,0,0,2
ACAGTATACCGTGGGA-1_V12N28-333_D1,1,0,0,0,0,1
GGGATCCCAATACAAA-1_V12N28-333_D1,0,0,2,0,0,2
ATTACGACTCCACAGT-1_V12N28-333_D1,0,0,2,0,2,4
CTCACACGCAAGCCTA-1_V12N28-333_D1,0,0,1,0,0,1
CCAGATGTAAATGGGT-1_V12N28-333_D1,1,0,0,0,1,2
GAACTTGTGCACGGGA-1_V12N28-333_D1,0,0,2,0,0,2
AAGCCGCTTTACCTTG-1_V12N28-333_D1,0,0,2,0,0,2
TCCATTCCCACTAGAG-1_V12N28-333_D1,0,0,0,0,0,0
AGAGCGCTTGTAACGG-1_V12N28-333_D1,0,0,2,0,0,2
TGGGTTCCCGGACGGA-1_V12N28-333_D1,1,2,2,0,0,5
GCTGCGCCTCCCACGT-1_V12N28-333_D1,1,3,0,0,0,4
CTGTTGGCTCTTCTGA-1_V12N28-333_D1,2,1,1,0,0,4
TTGTTCTAGATACGCT-1_V12N28-333_D1,3,0,1,0,0,4
CCCTCAAGCTCTTAGT-1_V12N28-333_D1,0,0,0,2,0,2
TGGTCTAGCTTACATG-1_V12N28-333_D1,1,0,1,0,0,2
ATGCACCTTCCTTAAT-1_V12N28-333_D1,1,0,0,0,0,1
GGGATACGGTAATAAT-1_V12N28-333_D1,1,0,2,1,0,4
AGTTCACCGGTTGGAC-1_V12N28-333_D1,1,0,2,0,0,3
GACATACTGTCGCAGA-1_V12N28-333_D1,0,2,3,0,0,5
TGGACACCGTTGCTTG-1_V12N28-333_D1,0,0,2,0,0,2
TGCGATGCTAATGGCT-1_V12N28-333_D1,0,0,2,0,1,3
TTCTGTTTCCTGTCGC-1_V12N28-333_D1,0,0,1,0,0,1
CGTTGTAAACGTCAGG-1_V12N28-333_D1,0,0,0,0,1,1
GATCGGCGATAAGTCG-1_V12N28-333_D1,0,1,1,0,0,2
AGCCTTAAAGCGGAAG-1_V12N28-333_D1,1,1,0,0,0,2
TCCGTAACCACAATCC-1_V12N28-333_D1,1,0,2,0,2,5
GAATGCCGAAATGACC-1_V12N28-333_D1,0,0,1,0,1,2
TATACTCATGCGGCAA-1_V12N28-333_D1,2,0,0,0,0,2
TAGTGTCAGAAACGGC-1_V12N28-333_D1,1,0,1,0,0,2
CGTCATACCATATCCA-1_V12N28-333_D1,0,0,0,0,0,0
TAGTACCTTAGTGGTC-1_V12N28-333_D1,2,0,0,0,0,2
CTGGCGGGAATAAGTA-1_V12N28-333_D1,0,2,0,0,0,2
AGTGTGGTCTATTGTG-1_V12N28-333_D1,1,2,0,1,0,4
GCTATCGCGGCGCAAC-1_V12N28-333_D1,5,0,0,0,1,6
CAGTAATCCCTCCCAG-1_V12N28-333_D1,3,0,0,0,1,4
GTATTAAGGCGTCTAA-1_V12N28-333_D1,1,0,0,0,0,1
CTAATTTCAACAACAC-1_V12N28-333_D1,0,0,0,0,1,1
TTAGCAACATGGATGT-1_V12N28-333_D1,0,1,0,0,0,1
ATGCTCAGTGTTGCAT-1_V12N28-333_D1,2,1,0,0,0,3
GATGTTTGTGCGAGAT-1_V12N28-333_D1,1,0,0,0,0,1
CACTTCGCCACAGGCT-1_V12N28-333_D1,1,0,0,0,0,1
CTGTATGGTGTAGAAA-1_V12N28-333_D1,3,1,0,0,1,5
TACGTGCACTATGCTG-1_V12N28-333_D1,3,0,0,0,0,3
GTATCAGCTTGGGTTC-1_V12N28-333_D1,2,0,0,0,1,3
TAACAAAGGGAGAAGC-1_V12N28-333_D1,1,0,0,0,0,1
TTACATCGTGGCCTGG-1_V12N28-333_D1,0,0,1,0,0,1
TCTGAACCGGTCGGCT-1_V12N28-333_D1,0,2,3,0,0,5
GGCTCGTGCCACCAGC-1_V12N28-333_D1,0,0,1,0,0,1
TATAAGTGAGGATAGC-1_V12N28-333_D1,0,0,1,0,2,3
GCCCGCGCGTTTGACA-1_V12N28-333_D1,0,2,1,0,0,3
TGCTGGTTGGACAATT-1_V12N28-333_D1,2,0,3,0,1,6
GCCTAGCGATCTGACC-1_V12N28-333_D1,0,0,2,0,0,2
CCATGCTCTGCAGGAA-1_V12N28-333_D1,0,1,2,0,0,3
TATAAATCCACAAGCT-1_V12N28-333_D1,4,2,2,0,0,8
CGCTCGACATAATGAT-1_V12N28-333_D1,1,0,2,0,0,3
CCAATTGAATGTTAAT-1_V12N28-333_D1,1,2,2,0,2,7
GCTAATACCGAATGCC-1_V12N28-333_D1,0,0,0,0,0,0
TTCAACGACCCGACCG-1_V12N28-333_D1,1,2,2,0,1,6
TTCCTCGAGGGTGTCT-1_V12N28-333_D1,0,0,0,0,1,1
CAACGACCCGTTTACA-1_V12N28-333_D1,2,0,0,0,2,4
CTTGTACTTGTTGACT-1_V12N28-333_D1,1,0,0,0,0,1
TCTCTAATAGCTGGTA-1_V12N28-333_D1,0,0,0,0,1,1
ATTATGCCATAGGGAG-1_V12N28-333_D1,1,1,0,0,2,4
GACAACGCAGCTTACG-1_V12N28-333_D1,2,0,0,0,1,3
AGATGACTCGCCCACG-1_V12N28-333_D1,0,0,0,0,0,0
GTGCGGGTCTCCAAAT-1_V12N28-333_D1,3,0,0,0,0,3
GTACGAGATTGCGACA-1_V12N28-333_D1,0,0,0,0,2,2
GTATAGGACTCAGTAG-1_V12N28-333_D1,1,0,0,0,1,2
TTGCACGGAGCAGCAC-1_V12N28-333_D1,2,0,1,0,1,4
CACAGCTAGGGAGTGA-1_V12N28-333_D1,0,0,0,0,1,1
ATACTAGCATGACCCT-1_V12N28-333_D1,0,0,1,0,1,2
CCAAGACTTCTGCGAA-1_V12N28-333_D1,1,0,1,0,0,2
ACATAATAAGGCGGTG-1_V12N28-333_D1,3,0,0,0,0,3
TAATACACAGTAGTAT-1_V12N28-333_D1,3,0,0,0,1,4
TCTTGGTAACACCAAA-1_V12N28-333_D1,0,0,0,0,0,0
AACTGGGTCCCGACGT-1_V12N28-333_D1,1,0,0,0,0,1
ATCACTTCATCCTCGC-1_V12N28-333_D1,0,0,0,0,1,1
TGGAAGGATAAAGATG-1_V12N28-333_D1,1,0,0,0,0,1
CATGATGCACAATTCT-1_V12N28-333_D1,4,0,0,0,0,4
TGCCTGATCAAACGAT-1_V12N28-333_D1,4,0,0,0,0,4
ATAGGGATATCCTTGA-1_V12N28-333_D1,0,0,0,0,2,2
CACCTAATCAGTTTAC-1_V12N28-333_D1,2,0,0,0,1,3
TGTGACTACGCCAGTC-1_V12N28-333_D1,3,0,0,0,1,4
CCCGACCATAGTCCGC-1_V12N28-333_D1,1,0,0,0,1,2
CGCGCCCGACTTAATA-1_V12N28-333_D1,2,1,0,0,0,3
TGCCACCTGGCGAAAC-1_V12N28-333_D1,0,0,0,0,1,1
CTGCCAAGGTTGGAAG-1_V12N28-333_D1,3,1,0,0,0,4
TCTCCAACGTAGGTTA-1_V12N28-333_D1,0,0,0,0,1,1
TTCTTGGAGTAATGAG-1_V12N28-333_D1,3,0,0,0,1,4
GTCTCGATCTGCTTTC-1_V12N28-333_D1,0,0,0,0,0,0
TACTCTCCGAACAAAT-1_V12N28-333_D1,3,0,0,0,1,4
ATCACATTAGAATATC-1_V12N28-333_D1,0,0,0,0,0,0
TACGGGATGCTAGCAG-1_V12N28-333_D1,1,0,0,0,0,1
AGCTGAAGTAAACCAA-1_V12N28-333_D1,2,1,0,0,2,5
CATGGGTCGGGTGTGG-1_V12N28-333_D1,1,1,0,0,0,2
CACCCACGAGGCAATT-1_V12N28-333_D1,1,0,0,0,0,1
TGCCATTACTAAAGAA-1_V12N28-333_D1,1,1,0,0,0,2
CCGTTACGTTAGAACA-1_V12N28-333_D1,3,0,0,0,1,4
GCCAGGAGTAACCGAT-1_V12N28-333_D1,1,0,0,0,0,1
GGAAAGTGCCCATGCC-1_V12N28-333_D1,0,1,0,0,0,1
TCTTACCGGAACTCGT-1_V12N28-333_D1,3,1,0,0,0,4
TATGTCAAGACCGACT-1_V12N28-333_D1,1,0,0,0,0,1
CCTAACTAAGGCTCTA-1_V12N28-333_D1,1,1,0,0,0,2
GCGGTGAACTGCGCTC-1_V12N28-333_D1,3,0,0,0,0,3
CCTCGCGCGATATAGG-1_V12N28-333_D1,2,1,0,0,0,3
ATCGGCAAGCAGTCCA-1_V12N28-333_D1,0,0,0,0,0,0
AGATCGTGCATAAGAT-1_V12N28-333_D1,3,0,0,0,1,4
ATTCAGGACCTATTTC-1_V12N28-333_D1,3,0,0,0,0,3
AGCTAGAAGCAGAAGT-1_V12N28-333_D1,0,0,0,0,1,1
TTCGCTATCTGACGTG-1_V12N28-333_D1,2,1,0,0,0,3
TTCCGCAGAGAAATAT-1_V12N28-333_D1,1,0,0,0,0,1
CAGTACATTCTCTAAA-1_V12N28-333_D1,1,0,0,0,0,1
GTGAAGATTTCAAGTG-1_V12N28-333_D1,1,1,0,0,1,3
AACGCATGATCTGGGT-1_V12N28-333_D1,2,0,0,0,1,3
CCCAGAGGAGGGCGTA-1_V12N28-333_D1,2,1,0,0,2,5
GGAAACCTTGTTGAAT-1_V12N28-333_D1,2,1,0,0,2,5
GTGAAGCCGTATAGTC-1_V12N28-333_D1,0,0,0,0,2,2
GAGCTGTCGTCTCGGA-1_V12N28-333_D1,0,0,1,0,0,1
TGTCATTTGTTGGGAA-1_V12N28-333_D1,1,0,0,0,0,1
ACCAACACCACACACT-1_V12N28-333_D1,0,0,0,0,1,1
AAATGATTCGATCAGC-1_V12N28-333_D1,3,0,0,0,0,3
CTGCTTTATGTCCGCG-1_V12N28-333_D1,1,0,0,0,1,2
GCGAGAGGCCATGTAA-1_V12N28-333_D1,2,0,0,0,0,2
ATTGACCGGCGATGAC-1_V12N28-333_D1,3,0,0,0,1,4
ACCCTGGTAACGCCCT-1_V12N28-333_D1,0,0,0,0,1,1
GTTGGACCGCATCAGG-1_V12N28-333_D1,1,0,0,0,0,1
CGTTTACAAGGCAGCT-1_V12N28-333_D1,1,0,1,0,1,3
CGGTCCATGAGACTCC-1_V12N28-333_D1,3,0,0,0,0,3
GTTCGTCTGGGTCCCT-1_V12N28-333_D1,1,1,0,0,0,2
TGTACTACTCTCACGG-1_V12N28-333_D1,0,0,2,0,0,2
AGTGAAGATGGTGTCC-1_V12N28-333_D1,0,0,0,0,0,0
GAGGGCCATAATATTA-1_V12N28-333_D1,2,0,0,0,0,2
ACTCCCGTAGACTAGG-1_V12N28-333_D1,1,0,0,0,0,1
CGTCAAATGGTCGCAG-1_V12N28-333_D1,1,0,0,0,0,1
AAGTCTAGTAGCTGCC-1_V12N28-333_D1,0,0,2,0,0,2
AAGAAATCACCAGATT-1_V12N28-333_D1,0,0,2,0,0,2
GAGTGCACGGACAACA-1_V12N28-333_D1,0,0,1,0,0,1
GTTCAAATCAGATGTC-1_V12N28-333_D1,5,0,0,0,0,5
CATGGCTCCCTATGTC-1_V12N28-333_D1,4,0,1,0,0,5
GGCCACACGAAAGCCT-1_V12N28-333_D1,2,0,0,0,0,2
GAAGCCGGGTAAGCTC-1_V12N28-333_D1,1,2,1,1,0,5
TTGCGCTCTCTCGCTT-1_V12N28-333_D1,1,0,3,0,0,4
TACATGACCTTATCCG-1_V12N28-333_D1,1,0,1,0,0,2
GTCCTTCTACAACCCA-1_V12N28-333_D1,1,0,0,0,0,1
TATATGCTGGGTTGCC-1_V12N28-333_D1,1,0,0,0,0,1
GTTTATGGGATTTAGA-1_V12N28-333_D1,1,0,1,1,0,3
GGAACCCGAACAAGAA-1_V12N28-333_D1,0,2,0,0,0,2
AACGTTATCAGCACCT-1_V12N28-333_D1,1,0,1,0,0,2
CATCGTCCGGTTACTA-1_V12N28-333_D1,1,1,2,0,1,5
AGACAGCTCAGAATCC-1_V12N28-333_D1,1,0,0,0,0,1
GCAGATCCTCGCAAAT-1_V12N28-333_D1,0,0,0,0,1,1
GGGTCATGCGTACCAT-1_V12N28-333_D1,1,0,0,0,1,2
CTGGTCATTCCAATCC-1_V12N28-333_D1,1,0,1,0,1,3
TCAGGGCGCAAACTCG-1_V12N28-333_D1,2,0,0,0,2,4
GATGCCAGCAGAAGGC-1_V12N28-333_D1,2,1,0,0,0,3
GTTATTAACGTGGGAG-1_V12N28-333_D1,1,0,0,0,1,2
AATACAATGTTTCAGG-1_V12N28-333_D1,0,0,0,0,1,1
TTGCTGCACCTATCCA-1_V12N28-333_D1,3,0,0,1,0,4
CCAGAGACAAAGCCGG-1_V12N28-333_D1,1,1,3,0,0,5
CCGAAGTATATTGTTC-1_V12N28-333_D1,2,1,0,0,0,3
GCTAAACCTGAGGTGA-1_V12N28-333_D1,1,0,0,1,0,2
TCATACTTACAGATCC-1_V12N28-333_D1,1,0,2,0,0,3
CGAGCACTTCAAGTTT-1_V12N28-333_D1,1,1,0,0,0,2
TAGCAACCTGTCACAA-1_V12N28-333_D1,1,1,0,0,0,2
TGGGAAATGCCTTTCC-1_V12N28-333_D1,0,0,0,0,0,0
AGACCATGGGATACAA-1_V12N28-333_D1,0,1,0,0,2,3
TAAATGAATCCGTTTC-1_V12N28-333_D1,1,0,0,0,0,1
ACAACGGTCCCTGCGA-1_V12N28-333_D1,0,0,0,0,2,2
GTCACTCTCCAAATCT-1_V12N28-333_D1,0,0,0,0,0,0
TTCTACTTGCGAGGGC-1_V12N28-333_D1,0,0,0,0,3,3
CGCAATTACTTTCGGT-1_V12N28-333_D1,5,0,0,0,2,7
CTGTTCATCTCACGGG-1_V12N28-333_D1,2,0,1,0,2,5
TTCTTGTAACCTAATG-1_V12N28-333_D1,1,1,0,0,0,2
GCTTGATGATAATCAG-1_V12N28-333_D1,0,4,3,0,1,8
TTGGCTCGCATGAGAC-1_V12N28-333_D1,1,0,1,0,0,2
GCCCAGTTGGTATGCC-1_V12N28-333_D1,0,0,4,0,0,4
ATTCCTCCGCCAGTGC-1_V12N28-333_D1,1,0,0,0,0,1
TCGTCCGCTGGCGTCT-1_V12N28-333_D1,0,2,2,0,0,4
GGAGAAGTCATTGGCA-1_V12N28-333_D1,0,0,0,0,0,0
TTGTTAGCAAATTCGA-1_V12N28-333_D1,0,0,0,0,0,0
TCTAGCATCTTCGATG-1_V12N28-333_D1,0,0,0,0,0,0
TTCTAGGCCAATTGTG-1_V12N28-333_D1,1,0,0,0,2,3
TCACGGTCATCGCACA-1_V12N28-333_D1,1,0,0,0,1,2
ATGAAGCCAAGGAGCC-1_V12N28-333_D1,1,0,0,0,1,2
AATGACTGTCAGCCGG-1_V12N28-333_D1,1,0,0,0,2,3
CCAAACAGAACCCTCG-1_V12N28-333_D1,4,0,0,0,2,6
TATCGATGATTAAACG-1_V12N28-333_D1,2,0,0,0,0,2
GAACACACATCAACCA-1_V12N28-333_D1,0,3,0,1,0,4
CCCGTCAGCGTCTGAC-1_V12N28-333_D1,4,0,0,0,1,5
AGCATCGTCGATAATT-1_V12N28-333_D1,2,0,1,0,2,5
GACTAAGATCATGCAC-1_V12N28-333_D1,2,0,0,0,0,2
TAGGGTGTTTCAAGAG-1_V12N28-333_D1,2,1,0,0,0,3
TGGTTCGTAGCAAAGG-1_V12N28-333_D1,4,0,0,0,3,7
CTGTTCACTGCCTGTG-1_V12N28-333_D1,1,0,0,0,0,1
ATGTGCATCCGACGCA-1_V12N28-333_D1,3,0,0,0,2,5
TTGTCGTTCAGTTACC-1_V12N28-333_D1,0,0,0,0,2,2
CGGGATCAATGTAAGA-1_V12N28-333_D1,0,1,0,0,0,1
TTATCTGTATCATAAC-1_V12N28-333_D1,1,1,0,1,0,3
ATCGACTCTTTCCGTT-1_V12N28-333_D1,0,1,0,0,0,1
CTCATTTGATGGGCGG-1_V12N28-333_D1,1,0,0,0,0,1
GTAAGCGGGCAGTCAG-1_V12N28-333_D1,2,0,0,0,1,3
TCTATCGGTCGCAACA-1_V12N28-333_D1,0,0,0,0,1,1
AACGCGGTCTCCAGCC-1_V12N28-333_D1,5,0,0,0,0,5
ATTAATACTACGCGGG-1_V12N28-333_D1,2,0,1,0,0,3
CTTTAACTTTCAAAGG-1_V12N28-333_D1,1,0,0,0,0,1
CGTACCTGATAGGCCT-1_V12N28-333_D1,1,0,0,0,1,2
GAATGTTGGGTAATCT-1_V12N28-333_D1,1,0,0,0,3,4
TGCGGAGTAAAGGTGC-1_V12N28-333_D1,4,2,0,0,0,6
CCTGAATATTTACATA-1_V12N28-333_D1,0,0,0,0,0,0
TTGCTCCCATACCGGA-1_V12N28-333_D1,1,3,0,0,1,5
CCTCTAATCTGCCAAG-1_V12N28-333_D1,3,0,0,0,0,3
AGGTTGAGGCACGCTT-1_V12N28-333_D1,0,1,0,0,1,2
TCCCGTCAGTCCCGCA-1_V12N28-333_D1,3,0,0,0,0,3
TCCGATGACTGAGCTC-1_V12N28-333_D1,1,0,0,0,0,1
CAGCCTCCTGCAGAGG-1_V12N28-333_D1,0,0,0,0,0,0
CTTAGCCTTCCACATG-1_V12N28-333_D1,1,0,0,0,0,1
ATTAATGAACCAGTCG-1_V12N28-333_D1,1,0,2,0,0,3
ACGATACATAGAACTA-1_V12N28-333_D1,0,0,0,0,0,0
AGCCACTCCCGTGCTT-1_V12N28-333_D1,0,0,0,0,0,0
ATACGGGTTTCGATTG-1_V12N28-333_D1,0,0,0,0,0,0
CTGTCAAATGGCTCGG-1_V12N28-333_D1,3,0,0,0,0,3
GCTCGGAATTTAAAGC-1_V12N28-333_D1,0,0,0,0,1,1
TAGGCATGTTACGCCA-1_V12N28-333_D1,1,1,0,0,0,2
TGGCAACTCGCGCGCC-1_V12N28-333_D1,2,1,0,0,1,4
ATCAGTAGGCAGGGAT-1_V12N28-333_D1,1,0,0,0,0,1
TATCGATCTATGCATA-1_V12N28-333_D1,1,0,0,0,0,1
CGACTCAGGATGTTAT-1_V12N28-333_D1,6,0,0,0,0,6
GCCATATTGCACACAG-1_V12N28-333_D1,0,0,0,0,0,0
AATTCATAAGGGATCT-1_V12N28-333_D1,1,0,0,0,0,1
CGGTAGAGGTGCAGGT-1_V12N28-333_D1,2,0,0,0,0,2
AATGATGATACGCTAT-1_V12N28-333_D1,2,0,0,0,0,2
CTTGTGCTCACCGATT-1_V12N28-333_D1,3,0,0,0,1,4
TTCCAATCAGAGCTAG-1_V12N28-333_D1,2,1,1,0,1,5
CGATGGACCCTACGCC-1_V12N28-333_D1,1,0,0,0,1,2
GGTCGGATAAACGGCG-1_V12N28-333_D1,0,0,0,0,0,0
TTAGCTAATACGATCT-1_V12N28-333_D1,0,0,0,0,0,0
CTCGATATTTGCGAGC-1_V12N28-333_D1,1,0,0,0,1,2
ATTACTTACTGGGCAT-1_V12N28-333_D1,2,0,0,0,1,3
CTAGCCGATGTTATGA-1_V12N28-333_D1,1,0,0,0,0,1
TACTGCAATCAATTAC-1_V12N28-333_D1,1,1,0,0,0,2
TAGTCTGTGACGTTGC-1_V12N28-333_D1,2,0,0,0,0,2
CTCGTTTCTAATGTTT-1_V12N28-333_D1,0,0,0,0,2,2
TTCGTTCAACGAAGTT-1_V12N28-333_D1,1,1,0,0,1,3
CTGAATTTATTGCCAG-1_V12N28-333_D1,1,0,0,0,1,2
TGGAATATCCTTGACC-1_V12N28-333_D1,0,0,0,0,0,0
CAGATCATTTAAAGTC-1_V12N28-333_D1,0,1,0,0,2,3
CTCCTTTACGCAAGTC-1_V12N28-333_D1,3,0,0,0,2,5
TCCCAAACAGACAACG-1_V12N28-333_D1,1,0,0,0,1,2
ATCGCTGCGTGCAGCA-1_V12N28-333_D1,0,1,0,0,1,2
TTAGTTCAAGTGTTCG-1_V12N28-333_D1,1,0,0,0,1,2
AAACTCGTGATATAAG-1_V12N28-333_D1,0,0,0,0,0,0
TTAACGAACAAGCAGT-1_V12N28-333_D1,0,0,0,0,1,1
GTTATATCAGGAGCCA-1_V12N28-333_D1,0,0,0,0,1,1
CAAATTGGATTATGCC-1_V12N28-333_D1,2,0,0,0,0,2
CGAGGAGCTTCCATAT-1_V12N28-333_D1,1,0,0,0,0,1
GGAGACCAATGTGCTT-1_V12N28-333_D1,0,0,0,0,1,1
CATTGATGAACACGCC-1_V12N28-333_D1,1,0,0,0,2,3
GTCAATGCTATAATTT-1_V12N28-333_D1,0,0,1,0,2,3
ACCACCCTCTCTTCTA-1_V12N28-333_D1,1,0,2,0,1,4
TGGAGGGAAACACCTC-1_V12N28-333_D1,3,0,0,0,0,3
CACGGACGTGGATGGC-1_V12N28-333_D1,2,0,1,0,0,3
AACTTTCTCGATCATG-1_V12N28-333_D1,1,0,1,0,0,2
CGTATTGTTTCCTAAT-1_V12N28-333_D1,1,0,0,0,0,1
CCTACTGCGGCGGCCA-1_V12N28-333_D1,0,0,1,0,1,2
CTTAGGTCCCAATCGT-1_V12N28-333_D1,3,0,0,0,1,4
CGCAATCGATCATTAG-1_V12N28-333_D1,1,1,0,0,0,2
TGGTTATGCTTGCGGT-1_V12N28-333_D1,1,2,0,0,0,3
GGCTTGGCTCTCACCT-1_V12N28-333_D1,3,1,0,1,0,5
ATTGGTAGGATCCGCT-1_V12N28-333_D1,2,1,1,0,0,4
TCAGGGCGACTTCCTT-1_V12N28-333_D1,2,0,0,1,0,3
TCTGCAGATTCGAGTC-1_V12N28-333_D1,1,2,0,0,0,3
CTCTCGCTGTACTATG-1_V12N28-333_D1,0,1,2,0,0,3
AATAGTCGCGAGTCGG-1_V12N28-333_D1,1,1,1,1,0,4
AGTTACCCTTAAGACT-1_V12N28-333_D1,2,0,1,0,0,3
CTTAAATAAGACCCAT-1_V12N28-333_D1,0,0,2,0,0,2
GGTTGTGCTCTTGTCC-1_V12N28-333_D1,1,1,0,0,2,4
GTGAGTCTAAGACGGA-1_V12N28-333_D1,0,0,1,0,0,1
CGCGACACTGCGCAGC-1_V12N28-333_D1,0,2,0,0,0,2
GCTCGCGGTTCCGCTC-1_V12N28-333_D1,1,1,1,0,0,3
TTAACTCACGCGTGGA-1_V12N28-333_D1,0,0,1,0,1,2
GGAACGGCCTGCAGCC-1_V12N28-333_D1,1,0,1,0,0,2
GTAGAAACGGGTGGAG-1_V12N28-333_D1,2,0,0,0,2,4
TAATGAAAGACCCTTG-1_V12N28-333_D1,1,1,0,1,0,3
AGGCTTGCTAGACACC-1_V12N28-333_D1,0,0,0,0,0,0
TTGCGTAGTTTGAGGA-1_V12N28-333_D1,0,0,0,0,0,0
CGCCCTTGAAGGCTGA-1_V12N28-333_D1,2,0,1,0,2,5
CCCGGTGGAAGAACCT-1_V12N28-333_D1,4,0,0,0,1,5
TTAACACCTCGAACAT-1_V12N28-333_D1,0,1,1,0,0,2
GATTCCTATACGGCGC-1_V12N28-333_D1,5,1,0,0,0,6
TTACCCTAACAGTCCT-1_V12N28-333_D1,0,2,1,0,0,3
ACCCACCTACATGCTC-1_V12N28-333_D1,0,1,0,0,1,2
AAAGGGCAGCTTGAAT-1_V12N28-333_D1,3,0,0,0,0,3
CACACAGGGATAGATT-1_V12N28-333_D1,1,2,0,0,4,7
AGAGCGTACAAGCTCG-1_V12N28-333_D1,0,0,0,0,0,0
TCTTACGGCATCCGAC-1_V12N28-333_D1,3,1,0,0,0,4
GCCTATTCCGATATAG-1_V12N28-333_D1,2,0,0,0,1,3
GAAAGTGACTAACTGC-1_V12N28-333_D1,4,0,2,0,1,7
CCGGAATGGTTTCAGT-1_V12N28-333_D1,0,0,0,0,1,1
AGTATAATACTAGGCA-1_V12N28-333_D1,0,0,0,0,1,1
TAACTATCGAAGGTCC-1_V12N28-333_D1,0,0,0,0,1,1
ATGAGGAGTGTTAATC-1_V12N28-333_D1,1,1,0,0,2,4
TGTGTCGCGAGTTGCA-1_V12N28-333_D1,0,0,0,0,0,0
ATCCAACGCAGTCATA-1_V12N28-333_D1,0,0,0,0,3,3
AAGGCGCGTAAAGCTT-1_V12N28-333_D1,4,0,1,0,2,7
AGTCGGCCCAAACGAC-1_V12N28-333_D1,2,0,0,0,3,5
AACGTCAGACTAGTGG-1_V12N28-333_D1,2,0,0,0,1,3
ACTACCAGCTCTCTGG-1_V12N28-333_D1,0,0,1,0,0,1
GCAAGTGCACAGAGAA-1_V12N28-333_D1,2,1,0,0,0,3
ACACCTTAAGTAGGGC-1_V12N28-333_D1,1,2,1,0,3,7
TTCGACGGGAAGGGCG-1_V12N28-333_D1,0,0,0,0,1,1
TTCGCACTCGCGTGCT-1_V12N28-333_D1,1,0,0,0,0,1
TATTTGTTACCCTTTA-1_V12N28-333_D1,0,0,0,0,2,2
CGCTGTGACGCCGCAC-1_V12N28-333_D1,0,0,0,0,1,1
GTTGCACGGAGTTTCG-1_V12N28-333_D1,2,1,0,0,2,5
GTTTCCTGGAGGGTGA-1_V12N28-333_D1,0,1,0,0,0,1
ACACCCAGCATGCAGC-1_V12N28-333_D1,1,0,0,0,1,2
TCAACCATGTTCGGGC-1_V12N28-333_D1,0,1,0,0,2,3
TTACAACTACGCATCC-1_V12N28-333_D1,1,0,0,0,0,1
TCCGATGGTGCGACAT-1_V12N28-333_D1,1,0,0,0,0,1
GGGCGTACATTTATAT-1_V12N28-333_D1,1,0,0,0,0,1
AGCGACCAACGATATT-1_V12N28-333_D1,1,0,0,0,0,1
ACACAAAGACGGGTGG-1_V12N28-333_D1,2,0,2,0,1,5
ATCGCACGCCGGGAGA-1_V12N28-333_D1,2,0,0,0,1,3
GCTCTAAACCCTGACG-1_V12N28-333_D1,1,0,0,0,0,1
AATGCAACCGGGTACC-1_V12N28-333_D1,4,0,0,0,0,4
TCAAACAACCGCGTCG-1_V12N28-333_D1,1,0,0,0,0,1
TATGCTCCCTACTTAC-1_V12N28-333_D1,1,0,1,0,0,2
AAAGGGATGTAGCAAG-1_V12N28-333_D1,1,0,0,0,0,1
ACGATCATACATAGAG-1_V12N28-333_D1,0,1,0,0,0,1
TTGTTCAGTGTGCTAC-1_V12N28-333_D1,1,0,0,0,0,1
ATGCATGATCCAGGAT-1_V12N28-333_D1,5,1,0,0,0,6
AGTCTTCTCCTCAAAT-1_V12N28-333_D1,0,0,0,0,0,0
GATTCCCTTGTCGCAG-1_V12N28-333_D1,1,0,0,0,0,1
CTCGCACCTATATAGT-1_V12N28-333_D1,1,0,0,0,1,2
ACTCAATAAAGGCACG-1_V12N28-333_D1,1,0,0,0,0,1
AACCGAGCTTGGTCAT-1_V12N28-333_D1,1,0,0,0,0,1
TAAGGCAACATAAGAT-1_V12N28-333_D1,2,2,0,0,0,4
CACGCACAGCGCAGCT-1_V12N28-333_D1,1,0,0,0,1,2
GGTTTACAATCTCAAT-1_V12N28-333_D1,2,0,0,0,2,4
TGCAGGATCGGCAAAG-1_V12N28-333_D1,0,0,0,0,1,1
ATAACGGAGTCCAACG-1_V12N28-333_D1,2,0,0,0,0,2
AACGATATGTCAACTG-1_V12N28-333_D1,2,0,0,0,0,2
GACAACGACCATTGAA-1_V12N28-333_D1,3,2,0,0,0,5
TTGACCATGTTCTCCG-1_V12N28-333_D1,2,0,0,0,0,2
AGTACGGGCACCTGGC-1_V12N28-333_D1,4,0,1,0,0,5
CGCCATCCGATTATGA-1_V12N28-333_D1,7,0,0,0,0,7
AAGGTATCCTAATATA-1_V12N28-333_D1,0,0,0,0,0,0
TGTTGTCAAGAAGTCT-1_V12N28-333_D1,1,1,0,0,0,2
CAGTGAATAAATGACT-1_V12N28-333_D1,2,0,0,0,0,2
CACCTTGCGAAACTCG-1_V12N28-333_D1,3,0,0,0,0,3
CATTTAGCGGACCATG-1_V12N28-333_D1,4,1,2,0,0,7
CCAGTCTAGACGGCGC-1_V12N28-333_D1,0,0,0,0,1,1
TCGCTTTAAACGTTTG-1_V12N28-333_D1,2,0,0,0,0,2
GTGAAACGGCGCCACC-1_V12N28-333_D1,0,0,0,0,0,0
GGGCTCATCGAACCCA-1_V12N28-333_D1,1,0,0,0,0,1
TTGATGTGTAGTCCCG-1_V12N28-333_D1,2,0,0,0,0,2
CAGTAGCCCACGCGGT-1_V12N28-333_D1,0,0,0,0,0,0
AGCGCGGGTGCCAATG-1_V12N28-333_D1,2,1,0,0,0,3
TAATCGATCCGTACGT-1_V12N28-333_D1,1,1,0,0,0,2
AGTGGCGGCAATTTGA-1_V12N28-333_D1,2,2,0,0,0,4
CCTTTCAATGAAGAAA-1_V12N28-333_D1,1,0,0,0,1,2
CTCAGTCACGACAAAT-1_V12N28-333_D1,1,1,1,0,0,3
ATAGGCTAGCTTCGCA-1_V12N28-333_D1,2,0,0,0,0,2
CGGTTCAAGTAGGTGT-1_V12N28-333_D1,1,0,0,0,0,1
CAGTCGAGGATGCAAT-1_V12N28-333_D1,2,1,0,0,1,4
TATCACCCAACCGACC-1_V12N28-333_D1,2,3,0,0,1,6
AATGATGCGACTCCTG-1_V12N28-333_D1,3,0,0,0,1,4
TGGAACCACTGACACA-1_V12N28-333_D1,2,0,0,0,1,3
GCCAATAGGGCATCTC-1_V12N28-333_D1,3,0,0,0,0,3
TTCTTTGGTCGCGACG-1_V12N28-333_D1,0,0,0,0,0,0
ATTAGATTCCTCAGCA-1_V12N28-333_D1,3,0,0,0,2,5
CCGTGGAACGATCCAA-1_V12N28-333_D1,5,2,0,0,2,9
GGGTCGTGGCAAGTGT-1_V12N28-333_D1,0,0,0,0,0,0
TCGCTCGGCACCAGCG-1_V12N28-333_D1,4,0,0,0,2,6
ACGCAATCACTACAGC-1_V12N28-333_D1,0,0,0,0,1,1
CTCTAATGCATTGATC-1_V12N28-333_D1,0,1,0,0,0,1
GTCTCGACTAAGTTTG-1_V12N28-333_D1,3,0,0,0,0,3
TGGTTTAAACGTGGGT-1_V12N28-333_D1,0,3,0,0,0,3
CGCAGATCTTCACCCG-1_V12N28-333_D1,2,0,0,0,0,2
TCCAGATGTACGCCAA-1_V12N28-333_D1,1,0,0,0,2,3
CATTGCGGGTCAATTC-1_V12N28-333_D1,0,0,0,0,0,0
GACGTTCGTAAATACA-1_V12N28-333_D1,1,0,0,0,0,1
TACACCGTCGTTAGTC-1_V12N28-333_D1,4,0,0,0,0,4
ACGGGCGTATGCGACA-1_V12N28-333_D1,0,0,0,0,1,1
GAAGGCTACCATTGTT-1_V12N28-333_D1,1,1,0,0,0,2
TAAATCTTTACACCTC-1_V12N28-333_D1,1,0,0,0,1,2
AGTTTATGTAAAGACA-1_V12N28-333_D1,1,0,0,0,2,3
AGGAGACATCCACAGT-1_V12N28-333_D1,0,0,0,0,1,1
CAACCTGAACCTGCCA-1_V12N28-333_D1,2,1,0,0,0,3
AGTCCCTCGCAGAAAG-1_V12N28-333_D1,1,0,0,0,1,2
TGTATACGGATGATGA-1_V12N28-333_D1,1,0,0,0,0,1
TTGTGGTATAGGTATG-1_V12N28-333_D1,0,0,0,0,2,2
TCTGCACCATTAGTAA-1_V12N28-333_D1,2,0,0,0,0,2
AAATGTATCTTATCCC-1_V12N28-333_D1,5,1,0,0,0,6
ACTCTAAACCTGGGAT-1_V12N28-333_D1,0,3,0,0,0,3
GCTGGCAGGTGCCGTG-1_V12N28-333_D1,0,1,0,0,0,1
CTCATTCGTGAACATC-1_V12N28-333_D1,2,1,0,0,0,3
TCGCCGGATGGGCAAG-1_V12N28-333_D1,1,2,0,0,0,3
GGACTAAGTCAGGAGT-1_V12N28-333_D1,0,0,4,0,0,4
TATCAAAGGTCTGTAA-1_V12N28-333_D1,2,3,1,0,0,6
TTCAGTTTGTGGCAGC-1_V12N28-333_D1,2,4,1,1,0,8
TGTTCATAAATGTGCT-1_V12N28-333_D1,0,0,2,0,0,2
CTTAGCCCGGATAGTG-1_V12N28-333_D1,1,0,1,0,0,2
GATGCGAATGGTATTA-1_V12N28-333_D1,1,0,1,0,0,2
TCTAACTGTATGTAAA-1_V12N28-333_D1,3,0,0,0,1,4
TTAAACCTGGTTCCTT-1_V12N28-333_D1,1,1,0,0,1,3
GCTAAGTAAAGGCGAT-1_V12N28-333_D1,1,1,1,0,0,3
AGTTACCGCACATGGT-1_V12N28-333_D1,1,1,1,0,0,3
GACTGCGGCACGTGTA-1_V12N28-333_D1,2,1,0,0,0,3
TGGTGATCGTATTTGT-1_V12N28-333_D1,2,1,2,0,2,7
TTATCGCCTGCGAAGC-1_V12N28-333_D1,2,0,0,0,0,2
TGGAATTAGACGCTTT-1_V12N28-333_D1,0,0,2,0,0,2
TCGTCACACTGTTAGC-1_V12N28-333_D1,1,2,2,0,0,5
TTATGTTTGCGATAGA-1_V12N28-333_D1,3,2,0,0,1,6
GGTGCTGATCACAAAG-1_V12N28-333_D1,3,0,0,0,2,5
CATAGCCGCCCGGGAT-1_V12N28-333_D1,2,0,1,0,1,4
GGTTAGTTACGGCGCC-1_V12N28-333_D1,1,0,0,1,0,2
ATTCCCACATAAACAA-1_V12N28-333_D1,1,0,1,0,0,2
ATTCAGTAGCAGGGTC-1_V12N28-333_D1,3,1,0,0,0,4
CAGTTCCGCGGGTCGA-1_V12N28-333_D1,1,1,0,0,0,2
AAGAGATGAATCGGTA-1_V12N28-333_D1,1,0,0,0,0,1
CGCAATTCTACAATAA-1_V12N28-333_D1,1,0,0,0,1,2
TAACGCTTTGAGAGCG-1_V12N28-333_D1,0,0,0,0,1,1
AGGCTATGGTTAGCTT-1_V12N28-333_D1,1,0,0,0,0,1
GAGGAATGGAGAGGTT-1_V12N28-333_D1,2,0,0,0,1,3
TCCTCTACGAGATGGC-1_V12N28-333_D1,0,1,0,2,0,3
TTGATTATGCAGATGA-1_V12N28-333_D1,2,1,0,0,1,4
TCAGTACTGACCCGCG-1_V12N28-333_D1,2,0,0,0,3,5
TTATGACAAACTGGAT-1_V12N28-333_D1,0,1,0,0,1,2
GTAAGTAGGGTATACC-1_V12N28-333_D1,1,1,0,0,1,3
CGCAAACACGAGTTAC-1_V12N28-333_D1,0,0,0,1,3,4
TGGCCGTATATTGACC-1_V12N28-333_D1,1,0,0,0,0,1
ACTGTAGCACTTTGGA-1_V12N28-333_D1,3,1,0,0,1,5
GCTCTATGTTACGTGC-1_V12N28-333_D1,1,0,0,0,0,1
TGCGCGATTAACGGAG-1_V12N28-333_D1,0,0,0,0,3,3
GAATCGACATGGTCAC-1_V12N28-333_D1,1,1,0,0,1,3
GACTAAGTAGGCTCAC-1_V12N28-333_D1,1,0,0,0,1,2
ATCTTGACCTGCAACG-1_V12N28-333_D1,1,0,0,0,0,1
ATGCACTACCGCATTG-1_V12N28-333_D1,2,0,0,0,0,2
CAGATACTAACATAGT-1_V12N28-333_D1,2,0,0,0,1,3
GATCGACACTATCTGA-1_V12N28-333_D1,0,1,0,0,0,1
ATAGAGTACTGGGACA-1_V12N28-333_D1,0,1,0,0,0,1
CCTACTGCTTACACTT-1_V12N28-333_D1,1,0,0,0,2,3
CCTGCTATTTGAGAAG-1_V12N28-333_D1,3,0,0,0,0,3
CGCGTTCATGAAATAC-1_V12N28-333_D1,2,0,0,0,0,2
CATTATGCTTGTTGTG-1_V12N28-333_D1,1,0,0,0,2,3
CCAGGGACGTGGCCTC-1_V12N28-333_D1,2,0,0,0,1,3
TATGGATGTGCTACGC-1_V12N28-333_D1,0,0,0,0,0,0
GTACTAAGATTTGGAG-1_V12N28-333_D1,1,1,0,0,1,3
AGACCCGCCCTCCTCG-1_V12N28-333_D1,3,0,0,0,0,3
CGCATTAGCTAATAGG-1_V12N28-333_D1,2,1,0,0,0,3
GCTCTCGGGTACCGAA-1_V12N28-333_D1,0,1,0,0,0,1
CACCGCCAGAAGGTTT-1_V12N28-333_D1,1,0,2,0,0,3
TCCCAAAGACGAAGGA-1_V12N28-333_D1,1,0,0,0,0,1
ATGGATTGACCAAACG-1_V12N28-333_D1,0,0,0,0,1,1
GTCATGGACATGACTA-1_V12N28-333_D1,0,0,0,0,0,0
CTACTGCCACCTGACC-1_V12N28-333_D1,2,0,0,0,0,2
TTATATTTGGCAATCC-1_V12N28-333_D1,2,0,0,0,1,3
AGCACCAGTACTCACG-1_V12N28-333_D1,3,1,0,0,1,5
CATGGTCTAGATACCG-1_V12N28-333_D1,1,0,0,0,0,1
TCTACCGTCCACAAGC-1_V12N28-333_D1,3,0,0,0,0,3
CTAGTTGGGCCCGGTA-1_V12N28-333_D1,2,1,0,0,0,3
TCCCGCGTACTCCTGG-1_V12N28-333_D1,1,0,0,0,2,3
CAGAGCATGAGCTTGC-1_V12N28-333_D1,0,0,0,0,2,2
ACACGGGAACTTAGGG-1_V12N28-333_D1,2,0,0,0,1,3
GGCTCTGCTCCAACGC-1_V12N28-333_D1,0,0,0,0,0,0
AGAACGTGGTACATTC-1_V12N28-333_D1,0,0,4,0,0,4
CAATAAACCTTGGCCC-1_V12N28-333_D1,1,1,0,0,1,3
ACTTCGCCATACGCAC-1_V12N28-333_D1,0,1,0,0,1,2
ATCTGGTTAAGACTGT-1_V12N28-333_D1,1,0,0,0,0,1
TCGTAAGACGACATTG-1_V12N28-333_D1,0,0,0,0,1,1
GTGTACCTTGGCTACG-1_V12N28-333_D1,3,0,0,0,1,4
GCCCGTAATACCTTCT-1_V12N28-333_D1,1,0,0,0,0,1
CGGTCAAGTGGGAACC-1_V12N28-333_D1,0,0,0,0,0,0
TTGTAAGGCCAGTTGG-1_V12N28-333_D1,2,0,0,0,1,3
GGAGCACCAAGAACTA-1_V12N28-333_D1,0,0,1,0,0,1
TAATAGTGACGACCAG-1_V12N28-333_D1,0,2,2,0,0,4
CTAAATCCTATTCCGG-1_V12N28-333_D1,1,1,0,0,0,2
CGAGTTCTGTCCCACC-1_V12N28-333_D1,2,0,0,0,0,2
AGGCAGATGCGTAAAC-1_V12N28-333_D1,2,0,0,0,2,4
AAGGATGAGGGACCTC-1_V12N28-333_D1,5,0,0,0,0,5
AGAGAACCGTCTAGGA-1_V12N28-333_D1,1,0,0,0,1,2
GAGGGCGCAGCTCTGC-1_V12N28-333_D1,1,0,0,0,3,4
AAGATTGGCGGAACGT-1_V12N28-333_D1,1,0,0,0,0,1
CCAGTAGTCTGATCCA-1_V12N28-333_D1,1,0,0,0,0,1
AAGGGACAGATTCTGT-1_V12N28-333_D1,2,0,0,0,2,4
ATAGAGTTATCAACTT-1_V12N28-333_D1,6,1,0,0,0,7
AAATTACCTATCGATG-1_V12N28-333_D1,1,0,0,0,0,1
GATCCTAAATCGGGAC-1_V12N28-333_D1,1,1,0,0,1,3
TTACAGACCTAAATGA-1_V12N28-333_D1,0,1,0,0,1,2
CCTCACCTTAGCATCG-1_V12N28-333_D1,0,0,0,0,1,1
CATGCGACCAGTTTAA-1_V12N28-333_D1,0,1,0,0,1,2
AACATATCAACTGGTG-1_V12N28-333_D1,1,1,0,0,0,2
CTATAAGAGCCAATCG-1_V12N28-333_D1,3,0,0,0,0,3
AATATCGAGGGTTCTC-1_V12N28-333_D1,2,0,0,0,0,2
GTACTCCTGGGTATGC-1_V12N28-333_D1,0,0,0,0,0,0
ATAAGTAGGATTCAGA-1_V12N28-333_D1,0,0,0,0,2,2
AGGTCGCGGAGTTACT-1_V12N28-333_D1,0,0,0,0,0,0
CTAATTCTCAGATATT-1_V12N28-333_D1,5,0,0,0,0,5
GCCAACCATTTCCGGA-1_V12N28-333_D1,0,0,0,0,0,0
TGATCCCAGCATTAGT-1_V12N28-333_D1,2,0,0,0,1,3
CGTTGTAAGATTGATT-1_V12N28-333_D1,1,1,0,0,1,3
GAAACCATGGTGCGCT-1_V12N28-333_D1,1,0,0,0,0,1
AATCTATGCCGGAGCC-1_V12N28-333_D1,0,0,0,0,0,0
GACTCCCAGAATAAGG-1_V12N28-333_D1,1,0,0,0,0,1
TATGATCCGGCACGCC-1_V12N28-333_D1,1,0,0,0,0,1
CCGCTTGCTGACATGG-1_V12N28-333_D1,1,0,0,0,0,1
TGGTTAAGGGCGCTGG-1_V12N28-333_D1,0,0,0,0,0,0
TTGATAGTCAATACAT-1_V12N28-333_D1,2,0,0,0,1,3
GGTTTAATTGAGCAGG-1_V12N28-333_D1,1,0,0,0,0,1
CATTACATAGATTGTG-1_V12N28-333_D1,2,1,0,0,1,4
GGTACACCAGATTTAT-1_V12N28-333_D1,2,0,1,0,1,4
GGCCCGTATACCATGC-1_V12N28-333_D1,1,0,0,0,1,2
ATCTTTCGTATAACCA-1_V12N28-333_D1,2,0,0,0,0,2
GAGATGACAATCCTTA-1_V12N28-333_D1,2,0,0,0,1,3
AAAGCTTGCCTACATA-1_V12N28-333_D1,1,0,0,0,1,2
GAACGATAAGTTAAAG-1_V12N28-333_D1,2,0,0,0,1,3
TAATAGCTAAATGATG-1_V12N28-333_D1,0,0,0,0,2,2
TATGGCTAGGCTAATT-1_V12N28-333_D1,3,0,0,0,0,3
AGGAGAGTCTGGCTAC-1_V12N28-333_D1,2,0,0,0,0,2
TGCTCTGCCGGTTCAC-1_V12N28-333_D1,1,0,1,0,0,2
CCAATAGATTTCATCT-1_V12N28-333_D1,3,3,0,0,0,6
GGGCACGAATTGGCCG-1_V12N28-333_D1,4,0,0,1,0,5
TCGTTGACAGGGTCCC-1_V12N28-333_D1,0,0,1,3,0,4
ATCGTATTCCGAGAAC-1_V12N28-333_D1,5,0,0,0,0,5
GGGAATTCTGTCCAGT-1_V12N28-333_D1,3,0,0,0,0,3
ACGCGTTTCTTAAGAG-1_V12N28-333_D1,4,0,0,1,0,5
GAGAGCGCAGTCCCTG-1_V12N28-333_D1,1,1,1,0,0,3
GTCCTATTGTTGTGGT-1_V12N28-333_D1,3,0,0,0,0,3
CATCTGCAGGATCATT-1_V12N28-333_D1,0,1,2,0,0,3
GAGTCGACAGACCCTC-1_V12N28-333_D1,2,0,2,0,1,5
AAGTGCAAAGGTAGAC-1_V12N28-333_D1,0,2,1,1,0,4
AGGGTGGATAGTGCAT-1_V12N28-333_D1,1,1,3,0,0,5
TGATAGCGGGATTCTA-1_V12N28-333_D1,0,0,0,0,1,1
GTCAGTTTGGTAGTCG-1_V12N28-333_D1,0,0,1,0,0,1
GCATTCGAAATGAACA-1_V12N28-333_D1,1,0,2,0,0,3
AAAGACTGGGCGCTTT-1_V12N28-333_D1,1,0,1,0,2,4
TAACAATATTTGTTGC-1_V12N28-333_D1,0,1,0,0,1,2
CCAGCTTCCGCCCGCA-1_V12N28-333_D1,0,0,0,0,0,0
GATATGGATTACGCGG-1_V12N28-333_D1,2,0,0,0,0,2
AGAGCAGTTATGAGAC-1_V12N28-333_D1,0,0,0,0,1,1
TCACATCTTATCTGAT-1_V12N28-333_D1,2,0,0,0,0,2
TATGAAGACAGGTGCG-1_V12N28-333_D1,0,0,4,0,0,4
TACCTGCTGCACTGTG-1_V12N28-333_D1,3,1,0,0,1,5
TAGGTCCAAGTAAGGA-1_V12N28-333_D1,1,1,0,0,1,3
GAAACTCGTGCGATGC-1_V12N28-333_D1,0,1,0,0,1,2
AACAATTACTCTACGC-1_V12N28-333_D1,0,0,0,0,1,1
CCGCACGTGACCTCGG-1_V12N28-333_D1,0,1,0,0,2,3
AACTTGCCCGTATGCA-1_V12N28-333_D1,1,0,0,0,0,1
GGGTATGTATGCACTT-1_V12N28-333_D1,1,0,0,0,0,1
TTCGTACTCCAGAACG-1_V12N28-333_D1,2,0,0,1,1,4
GAATTTCTCGCTGCAG-1_V12N28-333_D1,2,0,0,0,0,2
AACAGGATGGGCCGCG-1_V12N28-333_D1,1,0,0,0,0,1
GACGTGTAGGGATTAT-1_V12N28-333_D1,3,2,0,0,0,5
TAGGTGAGCCCTACTC-1_V12N28-333_D1,4,0,0,0,0,4
CTAATTCGCACGCGCT-1_V12N28-333_D1,1,0,0,0,0,1
GAAGCTTGCTGACCGC-1_V12N28-333_D1,2,0,0,0,0,2
GGTTAGGCTTGGAGAA-1_V12N28-333_D1,1,0,0,0,0,1
ACAAGGACAAGAGGTT-1_V12N28-333_D1,0,0,0,0,0,0
AGGCCACCCGTTATGA-1_V12N28-333_D1,0,0,0,0,0,0
GTGGGCTTAGACACAC-1_V12N28-333_D1,1,1,0,0,1,3
CGTGTCCCATTCGCGA-1_V12N28-333_D1,1,0,0,0,0,1
TGGAGTGATGCGATGA-1_V12N28-333_D1,0,1,0,0,2,3
AACAACTGGTAGTTGC-1_V12N28-333_D1,0,1,0,0,2,3
CCTGGCTAGACCCGCC-1_V12N28-333_D1,0,0,0,0,1,1
CGCAATTAGGGTAATA-1_V12N28-333_D1,0,0,0,0,0,0
TCGAAATTTAGGACCA-1_V12N28-333_D1,1,0,0,0,0,1
AGACTAGCCTTCCAGA-1_V12N28-333_D1,1,1,0,0,1,3
TTGATCTAACTTTGTC-1_V12N28-333_D1,2,0,0,1,1,4
AAGGAGCGGTTGGTGC-1_V12N28-333_D1,3,0,0,0,0,3
ACTTGGGACCCGGTGG-1_V12N28-333_D1,0,4,0,0,2,6
TGATCTCCGGCGCCAG-1_V12N28-333_D1,0,0,0,0,1,1
CAGTTCAAATTGACAC-1_V12N28-333_D1,1,1,0,0,1,3
GTCCGGCTGAATTGCG-1_V12N28-333_D1,1,0,0,0,0,1
CTGGAAATGGATGCTT-1_V12N28-333_D1,1,1,0,0,0,2
TGATCGGTTTGACCCT-1_V12N28-333_D1,0,0,0,0,0,0
TAGAGTCTAAGCGAAC-1_V12N28-333_D1,1,0,2,0,2,5
GAGACTGATGGGTAGA-1_V12N28-333_D1,4,0,0,0,1,5
TAGCTAAGTCCGGGAG-1_V12N28-333_D1,2,0,0,0,1,3
GGGCGATATGTGTGAA-1_V12N28-333_D1,3,0,0,0,0,3
CTCGAGGTCGAACAGT-1_V12N28-333_D1,1,0,0,0,1,2
GATCCCTTTATACTGC-1_V12N28-333_D1,2,0,0,0,1,3
GTCATGCACCTCCGTT-1_V12N28-333_D1,0,0,0,0,0,0
ACTTTCCTATAGCTTC-1_V12N28-333_D1,2,0,0,0,0,2
TCGCTCGATATATTCC-1_V12N28-333_D1,2,0,0,0,0,2
ATAGGTTGGGCAGATG-1_V12N28-333_D1,2,0,0,0,0,2
CAATTAAGGGTGATGA-1_V12N28-333_D1,0,0,0,0,0,0
ACCGACTGAGTCCCAC-1_V12N28-333_D1,1,1,0,0,2,4
CCTGTCACCCGGGCTC-1_V12N28-333_D1,0,0,0,0,0,0
GATCGGTGGCCATAAC-1_V12N28-333_D1,0,2,0,0,0,2
CCTATGGGTTACCGTC-1_V12N28-333_D1,0,0,0,0,0,0
TTGGGACACTGCCCGC-1_V12N28-333_D1,1,0,0,0,0,1
CGAGGCTAAATATGGC-1_V12N28-333_D1,1,0,0,0,1,2
TCAGGGTGTAACGTAA-1_V12N28-333_D1,1,0,0,0,0,1
CGAGAGATGTGAACCT-1_V12N28-333_D1,0,0,0,0,0,0
TCGCTGGGCGGATTGT-1_V12N28-333_D1,3,2,0,0,0,5
AGATCTCAGGTGTGAT-1_V12N28-333_D1,2,1,0,0,1,4
TGGCCAAACTGAAGTA-1_V12N28-333_D1,0,0,0,0,1,1
GCTTCCGTCCCTAGAC-1_V12N28-333_D1,1,0,0,0,0,1
CAGCAGCCCGTTCCTT-1_V12N28-333_D1,1,2,0,0,1,4
TGTATAACAGATCCTG-1_V12N28-333_D1,3,0,0,0,2,5
CGCGGGAATTAGGCAG-1_V12N28-333_D1,1,0,0,0,0,1
TGCATGTGGTAATCTA-1_V12N28-333_D1,0,1,0,0,0,1
ACAATTTGAGCAGTGG-1_V12N28-333_D1,0,0,0,0,1,1
GAGCTAAGGGCATATC-1_V12N28-333_D1,0,0,0,0,0,0
CCAGATAGTTGAGTGA-1_V12N28-333_D1,3,1,0,0,0,4
CCACAATGTACGTCTT-1_V12N28-333_D1,2,1,0,0,1,4
CAATGGATCTCTACCA-1_V12N28-333_D1,4,0,0,0,0,4
TGTGGCAAAGCGTATG-1_V12N28-333_D1,0,1,0,0,1,2
TAAAGCGTTAGGAGAA-1_V12N28-333_D1,1,0,0,0,0,1
TCCGTTTAGCCTTGAA-1_V12N28-333_D1,2,0,0,0,1,3
CAGCTCGACAAGTTAA-1_V12N28-333_D1,0,0,0,0,0,0
GCCTATAGTGTCAGGG-1_V12N28-333_D1,0,1,0,0,0,1
ATAGACAACGGGACCT-1_V12N28-333_D1,2,0,0,0,2,4
CTACTATCTTTCAGAG-1_V12N28-333_D1,1,0,0,0,1,2
GCGCTGCTTTGCATTT-1_V12N28-333_D1,1,0,0,0,1,2
GCGCATCCAGTCAGCA-1_V12N28-333_D1,2,0,0,0,0,2
GACTCGCGGGAATGAC-1_V12N28-333_D1,3,0,0,0,0,3
CTGGTAACGAGCTCTT-1_V12N28-333_D1,0,0,0,0,0,0
TCCGGCCTAGCGTACA-1_V12N28-333_D1,2,0,0,0,1,3
TCTAGGTGGCGACGCT-1_V12N28-333_D1,1,0,0,0,0,1
ACGCTAGTGATACACT-1_V12N28-333_D1,0,1,0,0,0,1
ATCTGCACCTCTGCGA-1_V12N28-333_D1,0,0,0,0,0,0
CCTCACCTGAGGGAGC-1_V12N28-333_D1,4,0,0,0,0,4
AGTGAGCCTCGCCGCC-1_V12N28-333_D1,1,2,0,0,1,4
ACGAGTACGGATGCCC-1_V12N28-333_D1,2,1,0,0,0,3
GGTACCATTAAGACGG-1_V12N28-333_D1,1,2,0,0,0,3
TTCTGCTAGACTCCAA-1_V12N28-333_D1,3,0,0,0,0,3
TAACTATTACGCCAAA-1_V12N28-333_D1,1,1,0,0,0,2
GCATTCAAGGCAACGC-1_V12N28-333_D1,1,0,0,0,1,2
AGTACATCATTTATCA-1_V12N28-333_D1,0,0,0,0,0,0
GTCGTGTCTGGTCATC-1_V12N28-333_D1,4,0,0,0,0,4
AGTCTAAAGTATACTC-1_V12N28-333_D1,1,0,0,0,0,1
CGGCCCAACCTGTAGT-1_V12N28-333_D1,1,0,0,0,0,1
AGGGAGACATACTTCG-1_V12N28-333_D1,1,0,0,0,0,1
TCCCTAGATCAATAGG-1_V12N28-333_D1,1,1,0,0,1,3
TCCCGTCGCGTCATAG-1_V12N28-333_D1,1,1,0,0,0,2
CGCATCCATCAGCCAG-1_V12N28-333_D1,2,0,0,0,1,3
CTGCACCTAGTCCACA-1_V12N28-333_D1,0,0,0,0,1,1
CGAGGATCGGGAACGA-1_V12N28-333_D1,1,0,0,0,1,2
CAATGAGGTTCGACTA-1_V12N28-333_D1,2,0,0,0,0,2
TCTGACGGGCTAACCC-1_V12N28-333_D1,1,0,0,0,0,1
TTCTATGCCTTTCGCA-1_V12N28-333_D1,1,0,0,0,1,2
AGAGTATAGTGTTACG-1_V12N28-333_D1,2,0,0,0,0,2
CCATTGTTTCCTCCAT-1_V12N28-333_D1,0,0,0,0,0,0
CTCATCACTTAGTGAT-1_V12N28-333_D1,1,0,0,0,1,2
CCGAAGGGCGTACCGC-1_V12N28-333_D1,0,0,0,0,1,1
TCAAGCTGCCTTGAAA-1_V12N28-333_D1,2,0,0,0,0,2
CTCATTAACGTTGCCC-1_V12N28-333_D1,1,0,0,0,2,3
GTCTTCCTCACCTAAG-1_V12N28-333_D1,0,1,0,2,0,3
GGTGATGAAGGAAGTG-1_V12N28-333_D1,1,0,0,1,0,2
TCAATACAATTGCTGC-1_V12N28-333_D1,3,1,1,0,0,5
GCAACCCAAGTTGTTT-1_V12N28-333_D1,4,2,0,0,0,6
ATGAAGTGGACCCAGC-1_V12N28-333_D1,1,0,0,2,0,3
GAGAATCTCACGATCA-1_V12N28-333_D1,3,0,0,1,0,4
TATATCATTGATCAGT-1_V12N28-333_D1,4,0,0,1,0,5
AACTTTACGGGAGCTT-1_V12N28-333_D1,1,0,1,1,0,3
TTCTTGTGTCCATCAG-1_V12N28-333_D1,0,0,1,0,1,2
ACAATTTAGGAGGCTC-1_V12N28-333_D1,2,1,0,0,0,3
ATACTTGTTCTCGAGC-1_V12N28-333_D1,0,2,2,0,2,6
CACGGGATTGAGGGTT-1_V12N28-333_D1,0,1,3,0,0,4
GTTAATGTCTATCTTA-1_V12N28-333_D1,0,0,1,1,0,2
GCGTTATATTTGGAAC-1_V12N28-333_D1,0,3,1,0,2,6
CGTCAAGGCTATAAAT-1_V12N28-333_D1,0,1,1,0,0,2
TTAGCTCTGTAATCCG-1_V12N28-333_D1,1,0,1,0,0,2
AATGGTCCACCGTTCA-1_V12N28-333_D1,3,1,0,1,1,6
GTCATTGCATTGACCC-1_V12N28-333_D1,1,0,0,0,0,1
TGTCCGTGGCGCCTTT-1_V12N28-333_D1,0,0,2,0,0,2
TCAACTAACGTATAAC-1_V12N28-333_D1,0,0,0,0,1,1
TCCTCTCCAGTTGTCC-1_V12N28-333_D1,1,1,1,0,1,4
TGTGTTCGTATCCAAG-1_V12N28-333_D1,3,1,0,0,0,4
CCGCGTAGGTAAGGGC-1_V12N28-333_D1,1,0,1,0,1,3
CTGCGGGTGAAATGTT-1_V12N28-333_D1,0,0,0,0,0,0
TATCTACAGAGGTAAT-1_V12N28-333_D1,1,0,0,0,2,3
CTACTCTAGGCCCGGC-1_V12N28-333_D1,2,1,0,0,0,3
ACAAGCAGTGCCTAGC-1_V12N28-333_D1,1,0,0,0,0,1
TACAAGTCTCGTGCAT-1_V12N28-333_D1,2,0,1,0,0,3
TCGGAATGCGCTCTGA-1_V12N28-333_D1,4,0,0,0,1,5
TCGCGTCCAGAAGGTC-1_V12N28-333_D1,1,0,0,0,0,1
TATGGCCCGGCCTCGC-1_V12N28-333_D1,0,1,0,0,1,2
GCTGGCATATTCACCT-1_V12N28-333_D1,3,0,0,0,1,4
GTCAGAATAGTCTATG-1_V12N28-333_D1,0,0,0,0,0,0
GGCGTCCTATCCGCTG-1_V12N28-333_D1,2,0,0,0,0,2
CGGAGTTTGAGAGACA-1_V12N28-333_D1,0,0,0,0,0,0
AGCACTTAAGGACGCC-1_V12N28-333_D1,1,0,0,0,0,1
TCCACAATGGTTTACG-1_V12N28-333_D1,3,0,0,0,0,3
CCAACGATGCACTGAT-1_V12N28-333_D1,2,1,0,0,2,5
ATTTACAGTTTACTGG-1_V12N28-333_D1,0,0,0,0,2,2
CCCTGAAATGAGTTGA-1_V12N28-333_D1,0,0,0,0,0,0
CAAACGGTCGCACTTT-1_V12N28-333_D1,2,0,0,0,1,3
TGATTCGTCTATCACT-1_V12N28-333_D1,2,0,0,0,1,3
TCAGGTTCTTTGAGAA-1_V12N28-333_D1,3,0,0,0,1,4
CACGCAGCGAGGCTTT-1_V12N28-333_D1,2,0,0,0,0,2
TTAAGCGCCTGACCCA-1_V12N28-333_D1,0,0,0,0,0,0
CTTACACGGTATTCCA-1_V12N28-333_D1,1,0,0,0,1,2
AAGGCTGTGCTCATCG-1_V12N28-333_D1,2,1,0,0,0,3
GACCAGAGCCCTGTAG-1_V12N28-333_D1,2,1,0,0,1,4
TCCCAGGCTTAGCTAA-1_V12N28-333_D1,0,0,0,0,0,0
ATTGAAGATCTTAGTG-1_V12N28-333_D1,0,2,0,0,0,2
AGTTCCTACAGAATTA-1_V12N28-333_D1,1,0,1,0,1,3
GGGCTGGTTAGTCGCG-1_V12N28-333_D1,1,0,0,0,1,2
GAAATGGCGGTGTTAG-1_V12N28-333_D1,2,0,1,0,1,4
TACGAACACGACTTCA-1_V12N28-333_D1,0,1,0,0,0,1
ACCACAAGTTTCTATC-1_V12N28-333_D1,3,0,0,0,3,6
ATATTTAACCCTCAAG-1_V12N28-333_D1,1,1,0,0,1,3
GATCATTCCAAACATT-1_V12N28-333_D1,2,0,0,0,0,2
TCCAGGCGAGTACGGT-1_V12N28-333_D1,2,0,0,0,0,2
GTTTGACCAAATCCTA-1_V12N28-333_D1,0,0,0,0,1,1
CACAGCACCCACGGCA-1_V12N28-333_D1,5,0,0,0,0,5
TGCAAGAATGACGTAA-1_V12N28-333_D1,1,0,0,0,1,2
GCGAAGCCATACCCGT-1_V12N28-333_D1,1,0,0,0,0,1
TCCTTTCTTACGCTTA-1_V12N28-333_D1,2,1,0,0,2,5
GCTGCTCTCCGGACAC-1_V12N28-333_D1,1,0,0,0,1,2
ACTGTCTTCTTTAGAA-1_V12N28-333_D1,0,1,0,0,1,2
TCAAACTTAGATTGTT-1_V12N28-333_D1,3,1,0,0,1,5
CTATGTCACTAGCCCA-1_V12N28-333_D1,0,0,0,0,1,1
TGCGCAAAGCATTTGG-1_V12N28-333_D1,4,0,0,0,0,4
TTAATGTAGACCAGGT-1_V12N28-333_D1,3,0,0,0,1,4
GGCGGTAGGATCATTG-1_V12N28-333_D1,3,0,0,0,0,3
GGCAATAGTCAATGAG-1_V12N28-333_D1,5,0,0,0,0,5
ACACGAGACTCCTTCT-1_V12N28-333_D1,2,0,0,0,0,2
GACACAAGGGAAGAAA-1_V12N28-333_D1,2,0,0,0,0,2
TCAGCAAATGCATCTC-1_V12N28-333_D1,1,0,0,0,0,1
GAGATCTGTCACTCCG-1_V12N28-333_D1,1,1,0,0,0,2
ATGCCGGTCTTGCATA-1_V12N28-333_D1,0,0,0,0,1,1
TTGGGCGGCGGTTGCC-1_V12N28-333_D1,1,0,1,0,1,3
TTGTTGTGTGTCAAGA-1_V12N28-333_D1,3,0,0,0,0,3
ACTGTACGATACACAT-1_V12N28-333_D1,1,0,0,0,0,1
TCCACTTTATCTAGGT-1_V12N28-333_D1,2,0,0,0,0,2
GGTCTGAGAATCTGGA-1_V12N28-333_D1,1,1,0,0,0,2
TAGAAAGGTGGCGCTA-1_V12N28-333_D1,0,0,0,0,0,0
TATGTCTCATTGTGCC-1_V12N28-333_D1,2,0,0,0,0,2
GGATTTCACTTCTATA-1_V12N28-333_D1,1,0,0,0,0,1
TGAGTGGTCCGTGACG-1_V12N28-333_D1,1,1,0,0,1,3
CGCTTTCTTGCATTCG-1_V12N28-333_D1,1,1,0,0,1,3
ACCCAACGCCCGTGGC-1_V12N28-333_D1,2,1,0,0,1,4
GAACGTCTCATGGTCG-1_V12N28-333_D1,2,1,0,0,0,3
AGGGTTCCCTTTGGTT-1_V12N28-333_D1,1,0,0,0,0,1
GTAGCTTCCTCTTGTT-1_V12N28-333_D1,0,0,0,0,2,2
GCATGAGGGACGCGGC-1_V12N28-333_D1,0,1,0,0,0,1
CTACCCTAAGGTCATA-1_V12N28-333_D1,0,0,0,0,0,0
TCACCGCTCGGCACTC-1_V12N28-333_D1,0,0,0,0,1,1
GGCTCGCGTTGAGGTA-1_V12N28-333_D1,3,0,0,0,1,4
CTAACGAAACTTGCTG-1_V12N28-333_D1,2,0,0,0,1,3
TTAAACTCGAATTCAT-1_V12N28-333_D1,2,0,0,0,1,3
TACTTTACTGAGCCGG-1_V12N28-333_D1,0,1,0,0,2,3
GCTTGGATCGATTAGG-1_V12N28-333_D1,1,0,0,0,0,1
CGGTTATCCAACAGTG-1_V12N28-333_D1,1,1,0,0,0,2
CAGACCTGTAAGTGTT-1_V12N28-333_D1,2,0,0,0,1,3
GACGGTCAATAGAAGC-1_V12N28-333_D1,0,0,0,0,0,0
CTGACTGCGCAGCTCG-1_V12N28-333_D1,3,0,0,0,0,3
CCATACCTTTACTTGT-1_V12N28-333_D1,3,0,0,0,1,4
GTAATAAAGGGCTCCC-1_V12N28-333_D1,2,1,0,0,0,3
GTGAACTCCCATTCGA-1_V12N28-333_D1,3,1,0,0,1,5
GTGGTTACTTCTTTCG-1_V12N28-333_D1,2,0,1,0,0,3
TCAGAACCTCCACAGG-1_V12N28-333_D1,3,0,0,0,0,3
TCCCACTCTCTTCCGG-1_V12N28-333_D1,0,0,0,0,0,0
ATCTTGACTTGTCCAA-1_V12N28-333_D1,1,1,1,0,1,4
TCGGGAACGTGCCTAG-1_V12N28-333_D1,2,1,0,0,0,3
GTTAGCCGTAAATCAA-1_V12N28-333_D1,0,0,0,0,0,0
ATTTACTAAGTCCATT-1_V12N28-333_D1,3,0,0,0,0,3
GGGTGCATATGAAAGC-1_V12N28-333_D1,3,0,0,0,1,4
TCCGAATGGTCCTGAG-1_V12N28-333_D1,3,0,0,0,0,3
TGATGGCTGTTTCTGA-1_V12N28-333_D1,0,0,0,0,0,0
AAATAAGGTAGTGCCC-1_V12N28-333_D1,1,0,0,0,1,2
CCACTATCCGGGTCAC-1_V12N28-333_D1,2,1,0,0,0,3
ACACCACATAATTAGC-1_V12N28-333_D1,2,0,0,0,0,2
CGCGGTAAGTCTAGCT-1_V12N28-333_D1,0,0,0,0,0,0
GCGGGCATTACGATGC-1_V12N28-333_D1,2,1,0,0,0,3
AGGATTGCTTACGACA-1_V12N28-333_D1,2,2,0,0,0,4
CTCGGGATAACACCTA-1_V12N28-333_D1,3,0,0,0,0,3
GTCGTCTGGTTGGCTA-1_V12N28-333_D1,1,0,0,0,0,1
GCAATTAGTCGCACCG-1_V12N28-333_D1,3,2,0,0,1,6
GTGACCTAAAGAATAA-1_V12N28-333_D1,0,0,0,0,0,0
CTGAGCGAGACTTATT-1_V12N28-333_D1,0,1,0,0,1,2
CAAGACTCAGAAGCGC-1_V12N28-333_D1,1,0,0,0,2,3
ACTTCGCTAGCGAGTG-1_V12N28-333_D1,4,0,0,0,0,4
CCATACTCGCCTCTCC-1_V12N28-333_D1,3,0,0,1,0,4
ACGATACCTATCCTGA-1_V12N28-333_D1,2,1,0,1,0,4
CTCACCAGTACAAGTG-1_V12N28-333_D1,3,1,0,1,0,5
CGAAGACGGTGAGTGC-1_V12N28-333_D1,4,0,0,0,0,4
AAATTAATAAGCGCGA-1_V12N28-333_D1,2,0,5,0,0,7
GGGCCCTTATCTATAC-1_V12N28-333_D1,4,1,1,0,0,6
CTGCCCACGAAGCGTT-1_V12N28-333_D1,5,1,1,0,0,7
GGACAAGTTGCAGTGA-1_V12N28-333_D1,4,1,0,1,0,6
GTCCGAGAGCAATCAT-1_V12N28-333_D1,4,0,0,0,0,4
ATGGCAGCCGAGAAAC-1_V12N28-333_D1,4,0,0,0,0,4
CCTCGGATGCTACCTG-1_V12N28-333_D1,3,1,3,0,0,7
ATACGGTGAAGATGCA-1_V12N28-333_D1,0,0,0,0,0,0
ACATCAGCTGGGACGC-1_V12N28-333_D1,2,1,3,0,0,6
GGTTGTGTAGCCTGGC-1_V12N28-333_D1,2,0,0,0,0,2
CCTGCGTTCTACGCTT-1_V12N28-333_D1,1,0,4,0,2,7
GAACGTTAGGAAGACG-1_V12N28-333_D1,0,1,1,0,0,2
CTGATAGTGTATCTCA-1_V12N28-333_D1,0,0,1,0,0,1
TTCTGCGAGCGCCCTT-1_V12N28-333_D1,0,1,0,0,0,1
CTTTGGCGCTTTATAC-1_V12N28-333_D1,1,0,0,0,2,3
TCCGAACTTGGCTTAC-1_V12N28-333_D1,5,0,0,0,0,5
TAGATTCCTGGTTATT-1_V12N28-333_D1,0,0,0,0,1,1
CCGACAAAGGGAGTGC-1_V12N28-333_D1,2,0,0,0,0,2
CCATGGCCCTTGTACC-1_V12N28-333_D1,0,0,0,0,0,0
GAAATATCACCATCAG-1_V12N28-333_D1,3,0,0,0,2,5
ACGAAATGGGCGGCAC-1_V12N28-333_D1,1,0,0,0,0,1
GTGAGCGTGCTGCACT-1_V12N28-333_D1,2,0,0,0,0,2
CCGCGGGTACGAAGAA-1_V12N28-333_D1,0,0,1,0,1,2
TCCCTGGCTCGCTGGA-1_V12N28-333_D1,0,0,2,0,0,2
CAGCTTAGTAGGTAGC-1_V12N28-333_D1,2,2,0,0,1,5
CACGAAAGTTAGTCCC-1_V12N28-333_D1,2,2,2,0,1,7
ACCTAATCGACTTCCT-1_V12N28-333_D1,2,0,0,0,0,2
AAGTAGTGACGCGAGG-1_V12N28-333_D1,4,1,1,1,0,7
TCCGATTACATTGCCG-1_V12N28-333_D1,2,0,4,1,0,7
CCTCCGACAATTCAAG-1_V12N28-333_D1,2,1,0,0,0,3
GTTCACAGGAGTCTAG-1_V12N28-333_D1,2,0,0,0,0,2
CGAAGTTGCTCTGTGT-1_V12N28-333_D1,2,0,0,0,0,2
GTCGGATATCTCAGAC-1_V12N28-333_D1,0,0,0,0,0,0
CGCTCTCCGTAGATTA-1_V12N28-333_D1,1,1,0,0,1,3
CAAGCAACGTCGGAGT-1_V12N28-333_D1,2,0,0,0,1,3
CCATTCCCTGCCCACA-1_V12N28-333_D1,0,0,1,0,0,1
CTTTGGCTTTAGTAAA-1_V12N28-333_D1,1,0,0,0,0,1
GGCTATTAAGTTGTAT-1_V12N28-333_D1,1,0,0,0,2,3
CCATTAGCGATAATCC-1_V12N28-333_D1,0,0,0,0,0,0
TGTTCTTCCATTGACT-1_V12N28-333_D1,5,0,0,0,1,6
AGATAACTTCAGGGCC-1_V12N28-333_D1,0,0,0,0,1,1
ATAGACGAAGAGAAAG-1_V12N28-333_D1,4,0,0,0,0,4
GGCGGAGTAATATTAG-1_V12N28-333_D1,0,1,0,0,0,1
TGACCCACGTTAGACA-1_V12N28-333_D1,2,0,0,0,1,3
TCACAGGTTATTGGGC-1_V12N28-333_D1,2,0,0,0,0,2
TCACGCATTGTAGATC-1_V12N28-333_D1,3,0,0,0,0,3
TTGAAGAATTCCCAGG-1_V12N28-333_D1,1,0,0,0,0,1
AAATGGTCAATGTGCC-1_V12N28-333_D1,1,1,0,0,0,2
TAGTGCCCTCCAGAGT-1_V12N28-333_D1,1,0,0,0,0,1
GGTATTGCCGAGTTTA-1_V12N28-333_D1,1,0,0,0,0,1
CGTATTAAGAGATCTA-1_V12N28-333_D1,1,0,0,0,1,2
ACTGTCCAGGATTATA-1_V12N28-333_D1,4,1,0,0,1,6
CGGGCAGCTAAACCGC-1_V12N28-333_D1,0,0,1,0,0,1
TTGCTGATCATGTTCG-1_V12N28-333_D1,1,2,0,0,2,5
TATGGGTACGTATCGT-1_V12N28-333_D1,1,0,0,0,1,2
CAGCTCACTGAGACAT-1_V12N28-333_D1,0,0,0,0,0,0
GGGACTGCATAGATAG-1_V12N28-333_D1,2,0,1,0,1,4
ACGCATTCGTGAGTAC-1_V12N28-333_D1,0,1,1,0,1,3
CTCTGGACGCCTGGTG-1_V12N28-333_D1,0,0,0,0,0,0
AGGGTTTAGTTCGGGA-1_V12N28-333_D1,2,1,0,0,0,3
GGGAGAACTCACAGTA-1_V12N28-333_D1,1,0,1,0,0,2
ATCAATCTGGGCTGCA-1_V12N28-333_D1,1,0,0,0,0,1
TCTTCGATACCAATAA-1_V12N28-333_D1,2,0,0,0,1,3
ACGTAGATTGCTGATG-1_V12N28-333_D1,3,1,1,0,0,5
TCTTGATGCGTAGCGA-1_V12N28-333_D1,2,0,0,0,0,2
GGGCTGCCTAGGGCGA-1_V12N28-333_D1,1,0,0,0,0,1
CTCTCACAATCGATGA-1_V12N28-333_D1,2,1,0,0,1,4
CCAAGCGTAACTCGTA-1_V12N28-333_D1,1,1,0,0,0,2
ACAACAGCATGAGCTA-1_V12N28-333_D1,1,2,0,0,0,3
GTCCCAACGTAAAGTA-1_V12N28-333_D1,3,0,0,0,0,3
TCGGAGTACATGAGTA-1_V12N28-333_D1,1,2,0,0,1,4
GGGAGTTAATGAGGCG-1_V12N28-333_D1,0,1,0,0,0,1
CCGGGCGGTCTCGTCA-1_V12N28-333_D1,0,1,0,0,0,1
CCGTAAGTTGGTCCCA-1_V12N28-333_D1,0,0,0,0,0,0
GGAGGGCTTGGTTGGC-1_V12N28-333_D1,1,0,0,0,0,1
TCGGACGCCCAGCCCA-1_V12N28-333_D1,1,0,1,0,0,2
TCTGTGCCATCATAGT-1_V12N28-333_D1,3,0,0,0,1,4
GTACTGGAGTTAGACC-1_V12N28-333_D1,1,0,0,0,0,1
GGAATGCGCTAGCGTG-1_V12N28-333_D1,0,2,1,0,0,3
GTGTGAATAACTTAGG-1_V12N28-333_D1,0,0,0,0,0,0
GGTCGGCCAGGAGCTT-1_V12N28-333_D1,0,1,0,0,0,1
TAGCCGGCGGTCAGCG-1_V12N28-333_D1,0,0,2,0,1,3
CGGGTGTACCCATTTA-1_V12N28-333_D1,0,0,1,0,0,1
AGTGATTCAAGCAGGA-1_V12N28-333_D1,5,0,1,0,0,6
GTTGGATTGAGAACAC-1_V12N28-333_D1,0,0,0,0,1,1
CACACGCGCTGTCTTA-1_V12N28-333_D1,1,0,0,0,1,2
TAGACGCCCGTACCGG-1_V12N28-333_D1,0,0,0,0,1,1
GGTTTCAATCGGTCAG-1_V12N28-333_D1,1,0,1,0,0,2
AATCTGCGTTGGGACG-1_V12N28-333_D1,0,0,0,0,0,0
TTACGGATGGTTCGAG-1_V12N28-333_D1,0,1,1,0,1,3
CGGCAGGGTCGGGTTG-1_V12N28-333_D1,2,1,0,0,0,3
GCTTTCAGAGGAGGTG-1_V12N28-333_D1,0,0,0,0,0,0
TCTTCCCATGGGCACA-1_V12N28-333_D1,1,0,0,0,0,1
TACCGCGGACTTGCAG-1_V12N28-333_D1,2,0,0,0,0,2
AGAATTATGGATTCGA-1_V12N28-333_D1,2,1,0,0,1,4
ATTGATGAGTCCTAAC-1_V12N28-333_D1,0,0,0,0,0,0
TAGGTCGCCGGAACTG-1_V12N28-333_D1,0,0,0,0,0,0
TAACCTACCGTCCGAG-1_V12N28-333_D1,1,1,0,0,1,3
CTTAGTAGGCCTACAG-1_V12N28-333_D1,0,0,0,0,0,0
CTAGATGTGAGTGTAA-1_V12N28-333_D1,1,0,0,0,0,1
ACTCCCGAATTCGTTT-1_V12N28-333_D1,0,0,0,0,0,0
GTTCATCGTTTGGCTG-1_V12N28-333_D1,2,0,0,0,2,4
ACTTTACCCTCATGAA-1_V12N28-333_D1,0,0,3,0,0,3
GCGAGAGTTGCGTCCA-1_V12N28-333_D1,1,0,0,0,0,1
GTTCGGGCGTACCATT-1_V12N28-333_D1,0,1,0,0,0,1
CGACTTTGTATAGCCT-1_V12N28-333_D1,0,0,0,0,0,0
GCCATCGATGCTGCAT-1_V12N28-333_D1,2,1,0,0,1,4
GCATTTCCAAGGCTCC-1_V12N28-333_D1,0,0,0,0,0,0
ATGTAAGGCTGCTCTT-1_V12N28-333_D1,0,0,0,0,0,0
ACGTTCGCAATCAATT-1_V12N28-333_D1,1,1,0,0,0,2
GTGACGAGGGTGACCC-1_V12N28-333_D1,2,0,0,0,0,2
ATTATAGCTACTTTAC-1_V12N28-333_D1,4,0,0,0,1,5
CGTGTGTTAAACCCTG-1_V12N28-333_D1,0,0,0,0,0,0
TTGGTATGGCTTGTGT-1_V12N28-333_D1,3,1,0,0,2,6
CATTCCCATTCCGTCG-1_V12N28-333_D1,0,0,0,0,0,0
TGCCGAAAGCGTATTC-1_V12N28-333_D1,2,0,0,0,0,2
CAACACATCTCCTGCC-1_V12N28-333_D1,1,0,0,0,1,2
CTGCCTCATATGCAAC-1_V12N28-333_D1,1,0,0,0,0,1
TCCCGCCTATGTGCGT-1_V12N28-333_D1,3,0,0,0,0,3
GGTTACCCGACACTTT-1_V12N28-333_D1,0,0,0,0,0,0
CCAGCGGGATCACCAG-1_V12N28-333_D1,0,0,0,0,1,1
ATGTTTCGGCCCGGAG-1_V12N28-333_D1,3,0,0,0,2,5
GCGTCTAACCTCCTAA-1_V12N28-333_D1,0,0,0,0,1,1
ATCAGGTAGCTGACAG-1_V12N28-333_D1,0,0,0,0,0,0
GGTATGAAAGAACTGA-1_V12N28-333_D1,6,0,0,0,0,6
GTGGCCTAATATCATT-1_V12N28-333_D1,4,0,0,1,0,5
CCTGTGAAACCGTAAC-1_V12N28-333_D1,4,0,0,1,0,5
GGCAGAGAGATCGGGA-1_V12N28-333_D1,3,0,0,1,0,4
TAGCGTCGAATATTGA-1_V12N28-333_D1,2,0,0,1,0,3
CGCCGACTATTCGCTA-1_V12N28-333_D1,3,1,0,2,0,6
TCTGGCGCAAGCCGGG-1_V12N28-333_D1,4,0,0,0,0,4
AGTGGTTGCGTATAGG-1_V12N28-333_D1,3,0,0,1,0,4
ATCGGTTACCTAGTAA-1_V12N28-333_D1,3,0,0,1,0,4
CCTGCCCGTTGTCTAG-1_V12N28-333_D1,0,4,0,0,0,4
GCACACGCCCATGGTC-1_V12N28-333_D1,2,3,0,1,0,6
AGTACGGCCCGTATCG-1_V12N28-333_D1,3,1,0,0,0,4
TATCTAGCCTAAAGGA-1_V12N28-333_D1,4,1,1,0,0,6
CACTCGGTTAGGAGGA-1_V12N28-333_D1,1,1,1,1,0,4
ATGTTCGTCGACCCAC-1_V12N28-333_D1,0,0,1,0,0,1
TTCCTCTGCCCGAATA-1_V12N28-333_D1,0,1,1,0,0,2
TTACTATCGGCTTCTC-1_V12N28-333_D1,0,1,1,0,0,2
GCCGCATTAGTCCGGC-1_V12N28-333_D1,0,1,1,0,0,2
TAAGGGCTGGGAGAGG-1_V12N28-333_D1,1,0,1,0,0,2
TAAGCAGGCGACACGC-1_V12N28-333_D1,0,2,2,0,3,7
AGCACTACCGGCCTGT-1_V12N28-333_D1,0,3,3,0,0,6
GAAAGCCCTTTGGACC-1_V12N28-333_D1,0,0,0,0,1,1
GACCGACTGAAGCGTC-1_V12N28-333_D1,1,1,0,0,0,2
CGGTGAAGACTAAAGT-1_V12N28-333_D1,2,1,0,0,1,4
CCCTGCGCTACGCATA-1_V12N28-333_D1,0,0,0,0,2,2
TACTGGACAGCTCGGC-1_V12N28-333_D1,3,0,0,0,0,3
TTAGTAGGGCGGCGGG-1_V12N28-333_D1,2,0,1,0,0,3
GAGGCTATCAAAGTCG-1_V12N28-333_D1,1,1,1,0,0,3
TTACCATTGATTACCC-1_V12N28-333_D1,1,0,0,0,0,1
ATACCACGGGCAACTT-1_V12N28-333_D1,4,0,0,0,1,5
TGTCCTAAGTCACCGC-1_V12N28-333_D1,2,0,1,0,1,4
AGGTAGGTACAAAGCT-1_V12N28-333_D1,2,0,3,0,0,5
GGCATACAGGTAGCGG-1_V12N28-333_D1,2,1,0,0,0,3
TGTAGTGATCTATAAT-1_V12N28-333_D1,0,0,0,0,0,0
TCCCGGGTGTGCTGCT-1_V12N28-333_D1,3,0,0,0,0,3
TACGATGTTGATCATC-1_V12N28-333_D1,2,0,0,0,0,2
CCTCTCTCCCATCTAG-1_V12N28-333_D1,2,1,0,0,1,4
GCAGGACTATAGAATA-1_V12N28-333_D1,2,0,0,0,0,2
CTAGTGAAGGACAGGA-1_V12N28-333_D1,3,0,0,0,1,4
TACGAGAACTTCACGT-1_V12N28-333_D1,2,0,0,0,1,3
CGTTGTTTCAATTCCC-1_V12N28-333_D1,1,2,0,0,0,3
GCAAATATTACGCTTT-1_V12N28-333_D1,0,0,2,0,0,2
CCAATAGTGCCGTCGA-1_V12N28-333_D1,1,0,0,0,0,1
ATTGCTGCTCCTCCAT-1_V12N28-333_D1,2,0,0,0,1,3
GAGATCTGCTTGGCAT-1_V12N28-333_D1,2,2,0,0,0,4
GCCGAAATTCCTACGT-1_V12N28-333_D1,2,0,0,0,1,3
GGCACTCCACTGGGCA-1_V12N28-333_D1,3,0,1,0,1,5
GGGTCACCGTGACGGT-1_V12N28-333_D1,0,0,0,0,1,1
CACTTAATCAGACGGA-1_V12N28-333_D1,0,0,0,0,1,1
CGTTTCGCTCATTACA-1_V12N28-333_D1,1,1,1,0,1,4
ATAAAGGCTCGGTCGT-1_V12N28-333_D1,3,1,0,0,1,5
CACTAAAGTTGCCTAT-1_V12N28-333_D1,0,1,3,0,0,4
GTGCTCAAGTACTGTC-1_V12N28-333_D1,2,1,0,0,0,3
CCATGCCTGTTTAGTA-1_V12N28-333_D1,0,0,0,0,0,0
TCTAGTTATCAGAAGA-1_V12N28-333_D1,1,1,0,0,1,3
TTGTAATCCGTACTCG-1_V12N28-333_D1,2,1,0,0,0,3
TCCCAGCTTTAGTCTG-1_V12N28-333_D1,0,0,0,0,0,0
CTACGCACGGAGTACC-1_V12N28-333_D1,0,0,0,0,0,0
AAATTAACGGGTAGCT-1_V12N28-333_D1,1,0,0,0,0,1
CGGCCACGCACAAAGT-1_V12N28-333_D1,1,0,0,0,0,1
GAAGCGTGAGGAATTT-1_V12N28-333_D1,0,0,0,0,0,0
ATATCTTAGGGCCTTC-1_V12N28-333_D1,1,0,0,0,0,1
ACGCGGGCCAAGGACA-1_V12N28-333_D1,0,0,1,0,2,3
GCGAGTTCTGCAAAGA-1_V12N28-333_D1,2,0,0,0,0,2
TATTCGTGCCAGAATA-1_V12N28-333_D1,2,0,0,0,1,3
AGGGCTGCAGTTACAG-1_V12N28-333_D1,0,0,0,0,0,0
CTAGCATAGTATAATG-1_V12N28-333_D1,2,0,0,0,1,3
TAGGTTCGAGTTCGTC-1_V12N28-333_D1,2,2,0,0,0,4
GAATTATAGTGAAAGG-1_V12N28-333_D1,1,2,0,0,2,5
CTATCGGGTCTCAACA-1_V12N28-333_D1,2,1,4,0,1,8
GCGCTAATTGAATAGA-1_V12N28-333_D1,0,1,0,0,0,1
ATGCGACAGTCCCATT-1_V12N28-333_D1,1,0,3,0,0,4
GGTAGTGCTCGCACCA-1_V12N28-333_D1,1,1,1,0,2,5
AAGCTCGTGCCAAGTC-1_V12N28-333_D1,2,0,0,1,1,4
TATTCAATTCTAATCC-1_V12N28-333_D1,1,0,0,0,0,1
TTCAAAGTCTCTAGCC-1_V12N28-333_D1,2,0,0,0,0,2
TTGAATATGGACTTTC-1_V12N28-333_D1,1,0,0,0,0,1
AAGAGCTCTTTATCGG-1_V12N28-333_D1,1,0,0,0,2,3
TTACTCCGGCCGGGAA-1_V12N28-333_D1,2,1,0,0,0,3
AAACGAGACGGTTGAT-1_V12N28-333_D1,1,0,0,0,0,1
GCTAAGTAGTTTCTCT-1_V12N28-333_D1,0,0,0,0,0,0
ATAACGCCGGAGGGTC-1_V12N28-333_D1,0,1,2,0,0,3
GGATCCGGAATATACT-1_V12N28-333_D1,0,0,0,0,0,0
TGAAAGGACCTGACTC-1_V12N28-333_D1,0,0,1,0,1,2
TCCGCGGCAGCATCTG-1_V12N28-333_D1,0,0,0,0,0,0
TGCATATGTCTGTCAC-1_V12N28-333_D1,0,0,1,0,1,2
TGTAGGAGAAATTTCC-1_V12N28-333_D1,0,0,2,0,0,2
AGTGAGACTTCCAGTA-1_V12N28-333_D1,0,0,2,0,1,3
CCCAAACATGCTGCTC-1_V12N28-333_D1,1,2,1,0,0,4
GCTTATGAAGCAGGAA-1_V12N28-333_D1,1,0,0,0,0,1
TTCTAACCGAAGCTTA-1_V12N28-333_D1,0,0,0,0,0,0
GGATGTCCTTACCGCA-1_V12N28-333_D1,2,0,0,0,0,2
AGGGTGCTCTCGAGGG-1_V12N28-333_D1,6,0,0,0,0,6
AACTCTCAATAGAGCG-1_V12N28-333_D1,1,0,0,0,0,1
TCTGAATTCCGTACAA-1_V12N28-333_D1,2,1,0,0,1,4
GCGTGGTACTGGGTTA-1_V12N28-333_D1,2,1,0,0,0,3
CGTCGGATAGTGTTGA-1_V12N28-333_D1,2,1,0,0,0,3
ATATGTCTCCCTAGCC-1_V12N28-333_D1,1,0,0,0,0,1
TCTTTAAGACTATGAA-1_V12N28-333_D1,0,0,0,0,0,0
TCATTTAAGTCTCCGA-1_V12N28-333_D1,2,0,0,0,0,2
GATATTGAGATTGGCG-1_V12N28-333_D1,2,0,0,0,0,2
TGACATCGAGCGGACC-1_V12N28-333_D1,2,1,0,0,0,3
GCGTAAATGGCCATAA-1_V12N28-333_D1,2,0,0,0,0,2
ATTGTACAACTCGGCT-1_V12N28-333_D1,2,0,0,0,0,2
TACGCTATAGAAACCT-1_V12N28-333_D1,1,0,0,0,0,1
CACCCAAATCTTATGT-1_V12N28-333_D1,2,1,0,0,2,5
AGATGATGGAGTCTGG-1_V12N28-333_D1,1,1,0,0,0,2
CCACGGTGCCCGGTAG-1_V12N28-333_D1,1,0,0,0,1,2
TCAAGAAATACTAGCT-1_V12N28-333_D1,2,0,0,0,2,4
AGGTATAATTGATAGT-1_V12N28-333_D1,1,0,0,0,0,1
CAAGGTCCTATAGGCT-1_V12N28-333_D1,2,0,0,0,0,2
CCGGCACGACCGTTTC-1_V12N28-333_D1,4,0,0,0,0,4
ACCTCCGTTATTCACC-1_V12N28-333_D1,1,0,0,0,1,2
GCAGCCTATATCACAT-1_V12N28-333_D1,1,1,0,0,0,2
GGTATAGTGACACATA-1_V12N28-333_D1,0,1,0,0,0,1
AAATTCCAGGTCCAAA-1_V12N28-333_D1,3,0,0,0,0,3
TCTTTAGCAGGCGAAC-1_V12N28-333_D1,1,0,0,0,0,1
TATTGACATTTCTGCC-1_V12N28-333_D1,2,1,0,0,1,4
TCTGATCGGGTGCTAG-1_V12N28-333_D1,4,0,0,0,1,5
GGCCCGGAGCATGTCT-1_V12N28-333_D1,0,0,0,0,0,0
GGGCGCAGCGTTACTC-1_V12N28-333_D1,0,1,0,0,0,1
TTGGCGATCCGAATAT-1_V12N28-333_D1,2,0,0,0,0,2
CCACGTAAATTAGACT-1_V12N28-333_D1,0,0,0,0,0,0
TCTGATTGGAAATGGA-1_V12N28-333_D1,11,0,1,0,2,14
ATGGCGGAATAGTCGC-1_V12N28-333_D1,1,0,0,0,0,1
ATCGCTTTACGTCTCA-1_V12N28-333_D1,2,2,0,0,1,5
TACGTGCAAGGTTCCT-1_V12N28-333_D1,0,1,0,0,1,2
CAGGACAGCTGCCCTT-1_V12N28-333_D1,0,0,0,0,0,0
CAAACCAGGTCTGCAT-1_V12N28-333_D1,2,0,0,0,0,2
ACAAGCTATATGGAAG-1_V12N28-333_D1,1,0,0,2,0,3
TCGCCCACTGCGAGAG-1_V12N28-333_D1,3,1,0,0,0,4
AGCCGCAAATTCAAAT-1_V12N28-333_D1,3,0,0,1,0,4
TTAACGTTAAAGCCTG-1_V12N28-333_D1,2,0,0,0,0,2
CAGCGCCAACACGATA-1_V12N28-333_D1,2,1,0,1,0,4
ATCCAATGGTACCGAA-1_V12N28-333_D1,5,1,0,0,0,6
GTGCTGCAGATAAGGA-1_V12N28-333_D1,1,1,0,0,0,2
GGCCTTTGCAACTGGC-1_V12N28-333_D1,4,1,0,0,0,5
GTCGTACCTACGATTG-1_V12N28-333_D1,2,0,0,1,1,4
TAGAAATTCACGTATA-1_V12N28-333_D1,0,1,0,0,1,2
AGAATAAATCTTCAGG-1_V12N28-333_D1,4,2,0,0,0,6
CATTGCGAAATGGGCG-1_V12N28-333_D1,1,2,0,2,0,5
GTCTACTCAATTACAA-1_V12N28-333_D1,3,1,0,1,1,6
TGTAATGACCACAATA-1_V12N28-333_D1,2,1,2,0,0,5
AAAGTCGACCCTCAGT-1_V12N28-333_D1,0,0,2,0,1,3
TACTCGGCACGCCGGG-1_V12N28-333_D1,0,1,2,0,2,5
AGGTGTATCGCCATGA-1_V12N28-333_D1,0,0,0,0,0,0
TGTGCTTTACGTAAGA-1_V12N28-333_D1,0,2,3,0,0,5
AAACCTCATGAAGTTG-1_V12N28-333_D1,4,0,0,0,0,4
TATAGGGTACTCATGA-1_V12N28-333_D1,0,0,0,0,2,2
CCAGCTGATGGTACTT-1_V12N28-333_D1,1,1,1,0,0,3
AATATTGGAGTATTGA-1_V12N28-333_D1,0,0,1,0,0,1
GGCCCTCACCCACTTA-1_V12N28-333_D1,0,0,0,0,0,0
AACCAAGACTTCTCTG-1_V12N28-333_D1,2,0,0,1,1,4
TCGTATTACCCATTGC-1_V12N28-333_D1,1,2,0,0,1,4
ATTCGACGCCGGGCCT-1_V12N28-333_D1,1,1,1,0,1,4
GGCGCAGGACATCTTC-1_V12N28-333_D1,2,1,0,0,1,4
GTACTCCCTTATCGCT-1_V12N28-333_D1,1,0,4,0,2,7
TGGTCTGTTGGGCGTA-1_V12N28-333_D1,1,0,1,0,1,3
AATAACAACGCTCGGC-1_V12N28-333_D1,1,1,0,1,0,3
CATACCCGTACCCAGT-1_V12N28-333_D1,5,0,0,0,0,5
ACAATCCATTTAAACC-1_V12N28-333_D1,5,2,0,0,0,7
GTTACAATTGGTGACG-1_V12N28-333_D1,2,0,0,0,0,2
TTGCCCTGATCACGGG-1_V12N28-333_D1,1,0,0,0,0,1
CTAACCGCGCGCCCGT-1_V12N28-333_D1,1,0,0,0,0,1
CTAAAGAATGCCTACT-1_V12N28-333_D1,4,0,0,0,0,4
ACCCATCTTGAGGGTA-1_V12N28-333_D1,2,0,1,0,0,3
GATCTTTGCAGGGTAT-1_V12N28-333_D1,2,1,0,0,0,3
GGGTACTTCATGAACT-1_V12N28-333_D1,1,0,0,0,2,3
GCCGCTTGTGAGAAAC-1_V12N28-333_D1,2,1,0,0,2,5
CCTGTAAGACATGATA-1_V12N28-333_D1,2,0,0,0,0,2
CGACAGTTCGCGTTAT-1_V12N28-333_D1,2,0,0,0,0,2
ACGATGCATATGTTAT-1_V12N28-333_D1,3,1,0,0,0,4
TGTTCCGCTTCCATGA-1_V12N28-333_D1,0,1,1,1,1,4
GGATGACGCGAGTTTA-1_V12N28-333_D1,1,0,0,0,1,2
GAAGTTTCCACTCAAT-1_V12N28-333_D1,2,1,0,0,0,3
GCGAGGCCCGAGCAGA-1_V12N28-333_D1,1,3,0,0,1,5
CATACTATGTAATTGT-1_V12N28-333_D1,1,0,0,0,1,2
CCAATGTCACAGCAAG-1_V12N28-333_D1,3,0,0,0,1,4
GTTGGATTTGCGTTGG-1_V12N28-333_D1,2,1,0,0,0,3
GGGAGGATGCCCGAAA-1_V12N28-333_D1,3,0,0,0,1,4
GATCGCGGGCTCTCCA-1_V12N28-333_D1,2,0,0,0,1,3
GTTCGCCATAAGTGCC-1_V12N28-333_D1,1,0,0,0,0,1
AGATTATAGGACGTTT-1_V12N28-333_D1,1,2,0,0,0,3
TCGAGACCAACACCGT-1_V12N28-333_D1,2,0,0,0,0,2
TATGGGACCGAGCAGG-1_V12N28-333_D1,0,0,0,0,0,0
GATGCGTCCTGCATTC-1_V12N28-333_D1,0,2,0,0,0,2
TATGGTCTGAGTAACA-1_V12N28-333_D1,2,0,0,0,0,2
GCATAGAGCACTCAGG-1_V12N28-333_D1,0,1,0,0,0,1
CTTCATTGTCAGTGGA-1_V12N28-333_D1,0,0,0,0,0,0
GCAGATTAGGGATATC-1_V12N28-333_D1,2,1,0,0,1,4
CCTGTCGCCCGTAAAT-1_V12N28-333_D1,2,1,0,0,0,3
CAATTTCGTATAAGGG-1_V12N28-333_D1,1,0,0,0,2,3
GTACACTTACCTGAAG-1_V12N28-333_D1,1,1,0,1,2,5
CCAGCCTGGACCAATA-1_V12N28-333_D1,2,0,0,0,2,4
ATGGAGCAGGCCGTGA-1_V12N28-333_D1,0,0,2,0,1,3
GTCATTAGAGCGAACG-1_V12N28-333_D1,0,0,1,0,1,2
AAGACTGCAAGCTACT-1_V12N28-333_D1,1,0,2,0,0,3
CTAGTCACGTCTTAAG-1_V12N28-333_D1,1,0,0,0,0,1
ACTCTTGTATAGTAAC-1_V12N28-333_D1,1,0,1,0,0,2
ATTAGGCGATGCTTTC-1_V12N28-333_D1,1,0,1,0,2,4
TTCGGGACTAATCGCG-1_V12N28-333_D1,3,1,6,0,0,10
TGGACTGTTCGCTCAA-1_V12N28-333_D1,1,0,0,0,0,1
AACGTGCGAAAGTCTC-1_V12N28-333_D1,2,0,0,0,0,2
CCACCCAAGGAAAGTG-1_V12N28-333_D1,2,1,0,0,0,3
CCGCACAAAGACCAAC-1_V12N28-333_D1,1,0,0,0,0,1
GCGATTGTTAACGTTA-1_V12N28-333_D1,2,1,0,0,0,3
ACTCGTCAGTAATCCC-1_V12N28-333_D1,1,0,0,0,0,1
GGTGATAAGGAGCAGT-1_V12N28-333_D1,2,0,0,0,1,3
AAGAGGCATGGATCGC-1_V12N28-333_D1,3,1,0,0,0,4
CACGTTCGTGCTCTAG-1_V12N28-333_D1,0,1,1,0,0,2
CTATTTGGTTACGGAT-1_V12N28-333_D1,1,0,0,0,1,2
GTACAGAGGCAAGGGT-1_V12N28-333_D1,3,0,1,0,1,5
GGGCCGGCCGAAGTAC-1_V12N28-333_D1,2,1,0,0,1,4
CCTGAACGATATATTC-1_V12N28-333_D1,0,0,0,0,2,2
CCGGGCTGCTCCATAC-1_V12N28-333_D1,0,0,0,0,0,0
TACTTGTTAGTAGTCC-1_V12N28-333_D1,2,1,0,0,1,4
CCTAGGCGTAGCGATC-1_V12N28-333_D1,2,0,0,0,2,4
CTGGCGCACAGGTCTG-1_V12N28-333_D1,0,1,1,0,0,2
ACTTATACTTACCCGG-1_V12N28-333_D1,0,2,1,0,0,3
GAAGTCTCCCTAGCGA-1_V12N28-333_D1,2,0,0,0,0,2
ACCGATGGTAGCATCG-1_V12N28-333_D1,2,1,0,0,1,4
CGAGTTTATCGGACTG-1_V12N28-333_D1,1,1,0,0,0,2
CATAACGGACAGTCGT-1_V12N28-333_D1,2,0,1,0,0,3
TGACGATGCACTAGAA-1_V12N28-333_D1,4,0,0,0,0,4
TAGGGAGCTTGGGATG-1_V12N28-333_D1,1,1,0,0,0,2
AGGGTCGATGCGAACT-1_V12N28-333_D1,1,0,0,0,0,1
TATATCCCTGGGAGGA-1_V12N28-333_D1,0,0,1,0,0,1
CATCTTACACCACCTC-1_V12N28-333_D1,0,1,0,0,1,2
GTGCGACAGGGAGTGT-1_V12N28-333_D1,3,0,0,0,0,3
CCGATCTCAACCTTAT-1_V12N28-333_D1,2,0,0,0,0,2
ACGATCATCTTGTAAA-1_V12N28-333_D1,0,0,0,0,0,0
GAAAGAACAGCGTTAT-1_V12N28-333_D1,3,0,0,0,0,3
CTAGGTCTGAAGGAAT-1_V12N28-333_D1,2,1,0,0,0,3
ATATCAACCTACAGAG-1_V12N28-333_D1,1,0,0,0,1,2
AAATAGCTTAGACTTT-1_V12N28-333_D1,2,0,0,0,0,2
GCGACATGTAAACATC-1_V12N28-333_D1,2,1,0,0,1,4
ATAAGTAGGGCGACTC-1_V12N28-333_D1,1,0,0,0,2,3
GCGAGCGCATGCTCCC-1_V12N28-333_D1,0,1,0,0,1,2
AGGGACCGGCTGCGTT-1_V12N28-333_D1,2,0,0,0,0,2
CCTATGAAGTGGTGCC-1_V12N28-333_D1,1,0,0,0,0,1
GCTTACGTAGTTAGTA-1_V12N28-333_D1,0,0,0,0,0,0
CATACTTAGGCAATAC-1_V12N28-333_D1,1,0,1,0,0,2
CCTGTCCCTCACGTTA-1_V12N28-333_D1,0,0,0,0,0,0
CAATGTGCCAACCCTT-1_V12N28-333_D1,0,0,0,0,0,0
GTTAAGTTAGAGTGGG-1_V12N28-333_D1,0,0,0,0,0,0
CTGGGATACGCTACCC-1_V12N28-333_D1,1,0,0,0,1,2
AACCTGTCACGGAATT-1_V12N28-333_D1,1,0,0,0,0,1
ACTGCGGACACACCGT-1_V12N28-333_D1,0,0,0,0,0,0
CCGTGAGGCATTCATG-1_V12N28-333_D1,1,1,0,0,1,3
GCCCAGATGCTGGAGA-1_V12N28-333_D1,1,0,0,0,1,2
TCTGGCCGTTCAAGTT-1_V12N28-333_D1,0,0,0,0,0,0
ATACGAAGGCTTTCCA-1_V12N28-333_D1,1,1,0,0,0,2
GATCCGAATATAAGTG-1_V12N28-333_D1,1,0,0,0,0,1
GTGGAGCATGTCGGCC-1_V12N28-333_D1,4,0,1,0,0,5
ACTCTTCAGCTCCCGC-1_V12N28-333_D1,1,0,0,0,0,1
CCCGATAGCCTCGCCT-1_V12N28-333_D1,0,0,0,0,0,0
ACAGGTGTGTTGTTGC-1_V12N28-333_D1,3,0,0,1,0,4
TGAACTGCTATGACTT-1_V12N28-333_D1,1,0,0,2,0,3
TGACATATATGACGAT-1_V12N28-333_D1,5,0,0,1,0,6
AAGTCTTCTGTGGCCT-1_V12N28-333_D1,5,0,0,0,0,5
ACCAGACCATAACAAC-1_V12N28-333_D1,4,0,0,0,0,4
TGAGACGTACCTCTCA-1_V12N28-333_D1,1,0,0,2,0,3
GACCGTTACATGCGAC-1_V12N28-333_D1,2,1,0,2,0,5
GGTTCGGATTATACTA-1_V12N28-333_D1,3,1,0,0,0,4
CCTCCTGAGCCCACAT-1_V12N28-333_D1,4,1,0,0,0,5
CCGCGATTTGGTAGGT-1_V12N28-333_D1,1,0,0,3,0,4
AATCTCTACTGTGGTT-1_V12N28-333_D1,3,0,0,1,0,4
ACTTTGACTGCATCCT-1_V12N28-333_D1,0,1,0,0,0,1
CCCTGACTAACAAATT-1_V12N28-333_D1,1,0,0,1,0,2
ACGCTGTGAGGCGTAG-1_V12N28-333_D1,3,1,0,0,0,4
GCATACGAGGTCTTTA-1_V12N28-333_D1,2,0,0,1,0,3
TCGGGATTCAAACATA-1_V12N28-333_D1,0,0,0,0,1,1
GGGCCCTACGAAAGGG-1_V12N28-333_D1,3,1,1,0,0,5
CGCCAAGAAGCCGAGT-1_V12N28-333_D1,1,0,0,0,1,2
GGTACATCTGGGACGA-1_V12N28-333_D1,0,0,1,0,0,1
GGATGCTGGCGTTCCT-1_V12N28-333_D1,0,0,2,0,1,3
CCGATTCGAGGGACCC-1_V12N28-333_D1,0,1,1,0,1,3
CCACTGGTGGCTGGTT-1_V12N28-333_D1,0,0,0,0,1,1
GACAGGCACACACTAT-1_V12N28-333_D1,1,1,0,0,1,3
TCAACGCGACCGGCAG-1_V12N28-333_D1,2,0,2,1,1,6
CTACGACTAGCTATAA-1_V12N28-333_D1,0,0,2,0,1,3
CGGTTGACCTGGCATA-1_V12N28-333_D1,1,0,1,0,0,2
ATCCTGAATCGCTGCG-1_V12N28-333_D1,1,0,2,0,1,4
GTTTCATATCGTCGCT-1_V12N28-333_D1,1,1,0,0,1,3
ATAAATATTAGCAGCT-1_V12N28-333_D1,1,2,0,1,0,4
AAGAGGATGTACGCGA-1_V12N28-333_D1,2,0,0,0,0,2
TCCTGCGTTGATACTC-1_V12N28-333_D1,0,3,1,1,1,6
CGTGCATTGTCGACGC-1_V12N28-333_D1,2,0,0,0,0,2
CCGGGTTCGAGGTTAC-1_V12N28-333_D1,2,0,3,0,0,5
CCCAATTTCACAACTT-1_V12N28-333_D1,2,0,1,0,1,4
TGATTTATTAGCTGTG-1_V12N28-333_D1,1,3,0,0,0,4
TGGAAGAAGGGAACGT-1_V12N28-333_D1,3,2,0,0,1,6
GACGCTTGCTTCTAAA-1_V12N28-333_D1,1,0,0,0,0,1
GGGAACGGGAGGTTAG-1_V12N28-333_D1,2,0,0,0,0,2
GCGGCTCTGACGTACC-1_V12N28-333_D1,2,0,0,0,1,3
ACGTTAGATTTGCCCG-1_V12N28-333_D1,2,0,0,0,1,3
GAGAGGGCGCGAGGTT-1_V12N28-333_D1,2,1,0,0,0,3
GCGTCTCTGCATTGGG-1_V12N28-333_D1,1,0,0,0,0,1
GCAGCACACAGCCCAG-1_V12N28-333_D1,0,0,0,0,0,0
CAGGCCGTTTGGGTGT-1_V12N28-333_D1,1,0,2,0,0,3
AACTCAAGTTAATTGC-1_V12N28-333_D1,2,0,0,0,0,2
CTTCGTAGATAGGTGA-1_V12N28-333_D1,0,0,0,0,0,0
TGCAGAGTACCGAGCA-1_V12N28-333_D1,2,0,0,0,1,3
GAAGTGATTTATCGTG-1_V12N28-333_D1,1,1,0,0,1,3
CGCTACGGGACATTTA-1_V12N28-333_D1,3,1,0,0,1,5
CCACACTGAGATATTA-1_V12N28-333_D1,4,1,0,0,0,5
CGATCCGACCCAGTGC-1_V12N28-333_D1,2,1,0,0,0,3
CTGTACTTCTTAGCAT-1_V12N28-333_D1,2,0,0,0,2,4
ACTTATTAGGATCGGT-1_V12N28-333_D1,0,0,0,0,0,0
TAGTCCGCAGAGAATG-1_V12N28-333_D1,2,1,0,0,2,5
TTCACGAAAGGATCAC-1_V12N28-333_D1,1,1,0,0,2,4
TACATTTCTAACGTGC-1_V12N28-333_D1,1,3,0,0,0,4
ACCATATCCGCAATAA-1_V12N28-333_D1,3,3,2,0,0,8
CACTCAAGAGCTATGG-1_V12N28-333_D1,2,0,0,0,1,3
TGTACGAACAAATCCG-1_V12N28-333_D1,0,0,0,0,2,2
ATCATCCAATATTTGT-1_V12N28-333_D1,0,0,1,0,1,2
CGCTATTCTTAGGCTC-1_V12N28-333_D1,0,2,0,0,1,3
TGGCAGCAGTAATAGT-1_V12N28-333_D1,1,0,0,0,1,2
TCACGTGCCCGATTCA-1_V12N28-333_D1,2,1,0,0,0,3
CATACGGCGTCTGGGC-1_V12N28-333_D1,2,0,1,0,3,6
CACATGATTCAGCAAC-1_V12N28-333_D1,0,2,2,0,1,5
GCTAGTAGAGCTTGTA-1_V12N28-333_D1,0,3,0,0,2,5
TGCTGTTGAAGAACTC-1_V12N28-333_D1,1,0,2,0,0,3
CGGAGCATGGCGATCC-1_V12N28-333_D1,3,0,0,0,0,3
TAGCGTTGGGTCTTAC-1_V12N28-333_D1,1,0,1,0,1,3
GTAGCGGCTATACACT-1_V12N28-333_D1,0,0,0,0,1,1
TAACATACAATGTGGG-1_V12N28-333_D1,0,1,0,0,1,2
TCTTCGAATAGACGTT-1_V12N28-333_D1,0,3,1,0,1,5
GATCGTGACTGATATC-1_V12N28-333_D1,1,0,0,0,0,1
GATCCGGGAATTAACA-1_V12N28-333_D1,3,0,2,0,1,6
TTATATACGCTGTCAC-1_V12N28-333_D1,1,0,0,0,0,1
GTCGCGTAACCCGTTG-1_V12N28-333_D1,0,3,0,0,1,4
AGCTCTAGACGTTCCA-1_V12N28-333_D1,0,0,0,0,0,0
GTCAAGCGGACTCGGG-1_V12N28-333_D1,1,1,1,0,1,4
CGAGGGACTGCGGTCG-1_V12N28-333_D1,0,2,1,0,1,4
AATCGCCTCAGCGCCA-1_V12N28-333_D1,0,0,0,0,1,1
CTTGTTGCTGAGTCAA-1_V12N28-333_D1,1,3,1,0,1,6
GATATGAGACACTAAC-1_V12N28-333_D1,2,0,0,0,2,4
TTATGATCTTAACGAA-1_V12N28-333_D1,0,1,1,0,0,2
CGCCGCCCATGCCTGT-1_V12N28-333_D1,0,0,0,0,1,1
CTGGGATAAATAATGG-1_V12N28-333_D1,0,4,1,0,0,5
GTGCCCGTTCGGATTC-1_V12N28-333_D1,0,0,0,0,1,1
TTCAATACTCTGAATC-1_V12N28-333_D1,1,0,0,0,0,1
CGCACATGTCCACTAC-1_V12N28-333_D1,1,0,1,0,1,3
AGAAGAGCGCCGTTCC-1_V12N28-333_D1,1,0,0,0,0,1
GATAACTCGCACTGTG-1_V12N28-333_D1,2,0,0,0,1,3
AGTCGACGGTCTCAAG-1_V12N28-333_D1,1,0,0,0,0,1
GTGACCGCACACTACG-1_V12N28-333_D1,1,0,0,0,0,1
GTATGTGGGTCTAGTT-1_V12N28-333_D1,0,0,0,0,0,0
CTTGAGTTAGGGTAAT-1_V12N28-333_D1,1,1,0,0,0,2
TTAGCTGATTTGCCGT-1_V12N28-333_D1,3,0,0,0,0,3
GCTGTTGCTACCGAAC-1_V12N28-333_D1,6,1,2,0,0,9
TATTACCATCCTGCTT-1_V12N28-333_D1,3,0,0,0,0,3
TTGAATTCACGTGAGG-1_V12N28-333_D1,3,0,0,0,0,3
CCATCTCACCAGTGAA-1_V12N28-333_D1,2,1,0,0,0,3
CGCACGTGCGCTATCA-1_V12N28-333_D1,0,0,0,0,1,1
ACCCGGATGACGCATC-1_V12N28-333_D1,0,0,1,0,0,1
CGCTAGAGACCGCTGC-1_V12N28-333_D1,2,0,0,0,0,2
ATAGTTCCACCCACTC-1_V12N28-333_D1,0,1,4,0,0,5
GCAGACCCAGCACGTA-1_V12N28-333_D1,1,1,0,0,0,2
TAGACTACCTAGCGTT-1_V12N28-333_D1,1,0,0,0,0,1
GGTTCTACTCGTCTGA-1_V12N28-333_D1,1,0,0,0,0,1
GACTCACCCACGTGAG-1_V12N28-333_D1,1,0,0,0,1,2
AGCTCTTCGTAACCTT-1_V12N28-333_D1,0,0,0,0,0,0
ACTATCCAGGGCATGG-1_V12N28-333_D1,0,0,0,0,2,2
AAGGATCGATCGCTTG-1_V12N28-333_D1,1,0,0,0,1,2
ATATCGGTAGGGAGAT-1_V12N28-333_D1,1,0,0,0,0,1
TTCCAGACGAGATTTA-1_V12N28-333_D1,1,0,0,0,1,2
GACCGACGTGAAAGCA-1_V12N28-333_D1,2,1,0,0,0,3
CCTGGAAACGTTCTGC-1_V12N28-333_D1,2,0,0,0,1,3
CCGGTAATGGCTAGTC-1_V12N28-333_D1,3,0,1,0,0,4
GCCGTGGAAGAAATGT-1_V12N28-333_D1,1,0,0,0,1,2
GTCTTGAGGAGCAGTG-1_V12N28-333_D1,2,0,0,0,0,2
TCCCAAAGCCCTAAAT-1_V12N28-333_D1,3,0,0,0,0,3
TTGAGCGCCACGTGAT-1_V12N28-333_D1,2,0,0,0,0,2
TTGAGTCCCGCTGCTG-1_V12N28-333_D1,1,0,0,0,0,1
ATGGAACCTTTGCACA-1_V12N28-333_D1,0,0,0,0,0,0
GCTAGCACCTGGGCCA-1_V12N28-333_D1,1,0,0,0,0,1
CGCCGTCTACCCATCG-1_V12N28-333_D1,1,0,0,0,0,1
GATAGGTGTCCCGGGC-1_V12N28-333_D1,0,0,0,0,1,1
AGGTATGCGGACATTA-1_V12N28-333_D1,1,0,0,0,0,1
TTGGTTCGCTCAAAGG-1_V12N28-333_D1,0,0,0,0,1,1
TCTGGAGCGTAAGAGT-1_V12N28-333_D1,0,0,0,0,0,0
TGCCTAAATTTAATAG-1_V12N28-333_D1,0,0,0,0,1,1
TAATTTCCGTCCAGTA-1_V12N28-333_D1,3,0,0,0,0,3
TCCTTCAATCCCTACG-1_V12N28-333_D1,1,0,0,4,0,5
TACCTATCCCTAGAGG-1_V12N28-333_D1,0,0,0,0,0,0
GCATGGGTACTGACGC-1_V12N28-333_D1,2,0,0,0,0,2
GTCGGGAACATGGTAG-1_V12N28-333_D1,1,0,0,1,0,2
GCAAATGAGGACACTT-1_V12N28-333_D1,4,0,0,0,0,4
GAATGGGCTTATCGAC-1_V12N28-333_D1,4,0,0,4,0,8
TGGTCGTGCAAGGCAA-1_V12N28-333_D1,3,0,0,1,0,4
CACCACGCCACACAGA-1_V12N28-333_D1,2,1,0,0,0,3
GAACCTCGACCTACAC-1_V12N28-333_D1,6,0,0,0,0,6
CAATACGCTCTGAGGC-1_V12N28-333_D1,1,0,0,0,0,1
TGGTAAGCAGGATTGA-1_V12N28-333_D1,1,2,0,1,0,4
AGTGGCTCCGTCGGCC-1_V12N28-333_D1,5,2,0,0,0,7
GATCGGATAGAACCAT-1_V12N28-333_D1,3,4,0,1,0,8
GCTACAGTACGGACCG-1_V12N28-333_D1,1,0,0,0,0,1
TCTATTACTAGAGGAT-1_V12N28-333_D1,3,1,0,1,0,5
TTCAGGCGTCAAAGCC-1_V12N28-333_D1,1,0,1,1,1,4
AGACCGGGAAACCCTG-1_V12N28-333_D1,1,0,0,1,1,3
AGAGATCTCTAAAGCG-1_V12N28-333_D1,2,1,1,0,1,5
CCCTGCCCAATCCGCT-1_V12N28-333_D1,1,1,1,0,0,3
GTGGCGGTCCCAGCGT-1_V12N28-333_D1,0,2,1,0,0,3
GCATTGTAATTCATAT-1_V12N28-333_D1,0,1,0,0,1,2
CCGTTCCGAATCTCGG-1_V12N28-333_D1,0,2,4,0,1,7
AGCTTGATCTTAACTT-1_V12N28-333_D1,1,0,6,0,0,7
CCTGTACTCACGCCCA-1_V12N28-333_D1,1,0,0,0,1,2
AAGTGACGACCGAATT-1_V12N28-333_D1,1,0,0,0,1,2
CTCACTTGGCTGGTAA-1_V12N28-333_D1,0,1,0,0,1,2
CGCCTGGCCTACGTAA-1_V12N28-333_D1,1,0,1,0,2,4
CCCGTAAGTCTAGGCC-1_V12N28-333_D1,2,0,0,0,2,4
TTGGACATGTGGCTTA-1_V12N28-333_D1,1,0,0,0,2,3
ATTACGCGCTGGCAGG-1_V12N28-333_D1,1,1,0,0,1,3
ACGCGCTACACAGGGT-1_V12N28-333_D1,1,3,0,0,1,5
TACGTTTACCGGCAAT-1_V12N28-333_D1,2,0,0,1,3,6
CGAAACGCAATTCATG-1_V12N28-333_D1,2,1,0,0,3,6
TAGTCTAACAACGAGA-1_V12N28-333_D1,1,0,0,0,1,2
TTGCATGCTGATCACG-1_V12N28-333_D1,2,0,0,0,2,4
TCTGGGTAGCGCTCAT-1_V12N28-333_D1,2,1,0,0,1,4
ACATCGGTCAGCCGCG-1_V12N28-333_D1,2,1,0,0,1,4
AGATACCGGTGTTCAC-1_V12N28-333_D1,2,0,0,0,0,2
GATTACTGAATTTGGG-1_V12N28-333_D1,4,0,0,0,0,4
TCCAACTTTAAATTCT-1_V12N28-333_D1,3,0,1,0,0,4
TCCTAGCAAAGAAGCT-1_V12N28-333_D1,1,1,0,0,0,2
GTCTATCTGAGTTTCT-1_V12N28-333_D1,1,0,0,0,1,2
GATGTTCAATCCACGA-1_V12N28-333_D1,0,0,1,0,1,2
AGTTAAACACTTGCGA-1_V12N28-333_D1,3,0,1,0,0,4
AGCTCTTTACTCAGTT-1_V12N28-333_D1,0,1,0,0,0,1
ATCCAGGATTCGTGAA-1_V12N28-333_D1,2,0,0,0,1,3
AGTCAACACCACCATC-1_V12N28-333_D1,1,0,0,0,2,3
CGATACCTCGCGGACA-1_V12N28-333_D1,1,1,0,0,0,2
TACAACGCACAACTCA-1_V12N28-333_D1,3,0,1,0,3,7
AATTAAAGGTCGGCGT-1_V12N28-333_D1,1,1,0,0,0,2
TACGCAGTTCTTTCCT-1_V12N28-333_D1,0,1,1,0,1,3
GACCGTGCTGACGGTG-1_V12N28-333_D1,1,0,1,0,1,3
GGCAAATTACTTTACT-1_V12N28-333_D1,1,0,0,0,1,2
GGTACAAACATGCTAT-1_V12N28-333_D1,2,1,0,0,1,4
CGGGCCTTCTTTGTAA-1_V12N28-333_D1,1,1,0,0,0,2
CGTGAAGTTAATTCAC-1_V12N28-333_D1,1,1,1,0,1,4
ATAGTGAAGCGTTCTC-1_V12N28-333_D1,0,0,0,0,0,0
TACGCCATATTCTAAT-1_V12N28-333_D1,1,1,0,0,1,3
GCCGGGTTAGGGTCGC-1_V12N28-333_D1,1,0,1,0,1,3
TACATAGGCATACACC-1_V12N28-333_D1,1,0,0,0,1,2
GCCGATTGGCCAAGCT-1_V12N28-333_D1,0,0,1,0,0,1
CTGCCATGCATCACAT-1_V12N28-333_D1,0,1,0,0,1,2
TTATGAATGAAAGGGA-1_V12N28-333_D1,1,1,0,0,0,2
GCTGAGGCGTGAGTAT-1_V12N28-333_D1,2,0,0,0,2,4
GCGCCGTTCCACGATA-1_V12N28-333_D1,2,0,0,0,0,2
CGCATGGTGCGATGCT-1_V12N28-333_D1,0,0,0,0,1,1
AGGTTTCACACACCTT-1_V12N28-333_D1,0,1,2,0,0,3
CAAGGATCGCATGTTC-1_V12N28-333_D1,1,0,0,0,1,2
ACGTTAATGTCGAAGA-1_V12N28-333_D1,1,1,0,0,0,2
TCCAGAGCACCGGTTC-1_V12N28-333_D1,2,0,0,0,0,2
GATTCGACGGTTCACG-1_V12N28-333_D1,1,1,2,0,1,5
GTTTCTGCAGTCTCCC-1_V12N28-333_D1,2,0,1,0,1,4
GCTGCACGGTTTCTTA-1_V12N28-333_D1,0,0,1,0,1,2
CGTGCAGACTGGGACA-1_V12N28-333_D1,0,0,2,0,1,3
GTGTTACTATGCGTCC-1_V12N28-333_D1,0,0,1,0,0,1
TCCTCGGGCTGGGCTT-1_V12N28-333_D1,1,1,0,0,0,2
GTGAGGACACTTAAGG-1_V12N28-333_D1,0,0,1,0,0,1
ATACGCCGGCGAAACC-1_V12N28-333_D1,2,0,0,0,0,2
TCTGCCAGAAACTGCA-1_V12N28-333_D1,0,0,0,0,2,2
TTCTGCGGGTTAGCGG-1_V12N28-333_D1,2,0,1,0,0,3
CTCGGTACCACTGCTC-1_V12N28-333_D1,2,0,0,0,0,2
GTAAGTAACAGTCTGG-1_V12N28-333_D1,0,0,1,0,0,1
GTGCGTGTATATGAGC-1_V12N28-333_D1,0,0,0,0,1,1
ATTTGTCTTGGGAGCT-1_V12N28-333_D1,0,0,0,0,0,0
CCTCGGACCGGGATAG-1_V12N28-333_D1,2,2,0,0,1,5
TAGGTGCTCGCCTAGC-1_V12N28-333_D1,1,0,0,0,0,1
CTTTAGGAACACTGTT-1_V12N28-333_D1,0,0,0,0,1,1
TCGGGCCGTCGTGGTA-1_V12N28-333_D1,1,0,0,0,0,1
AGTGCTTGCACGAATA-1_V12N28-333_D1,2,0,0,0,1,3
TGCAGTTTCCTCCCAT-1_V12N28-333_D1,1,0,2,0,1,4
TGAGAGATTTACCACG-1_V12N28-333_D1,1,0,0,0,0,1
GAAACAGATGACCACC-1_V12N28-333_D1,1,1,1,0,0,3
AGCAACATATCTTATT-1_V12N28-333_D1,0,0,1,0,1,2
CAAGTGTGGTTGCAAA-1_V12N28-333_D1,3,0,0,0,0,3
GCCTCATCTGGAAATA-1_V12N28-333_D1,1,1,0,0,1,3
AACCCTACTGTCAATA-1_V12N28-333_D1,0,0,0,0,0,0
ACGTATTACTCCGATC-1_V12N28-333_D1,3,1,0,0,0,4
TCTGGGAACCTTTGAA-1_V12N28-333_D1,2,0,0,0,0,2
GCTCGCTCATGTCCAA-1_V12N28-333_D1,2,0,0,0,0,2
GCGCAAGAGCGCGCTG-1_V12N28-333_D1,1,0,0,0,0,1
TTGACGCTCCATGAGC-1_V12N28-333_D1,2,1,0,0,0,3
TATAGATGGTCGCAGT-1_V12N28-333_D1,2,1,0,0,0,3
TTACATGCCACAACTA-1_V12N28-333_D1,1,0,0,0,0,1
ACATGGCGCCAAAGTA-1_V12N28-333_D1,0,0,0,0,1,1
TATGGTTAGTGGGAGA-1_V12N28-333_D1,0,2,0,0,0,2
CATGACTTCGCTGAAT-1_V12N28-333_D1,1,0,0,0,0,1
ACCACCAATGTAACAA-1_V12N28-333_D1,1,0,0,0,0,1
TCTTAGAGCTCCAATT-1_V12N28-333_D1,1,0,0,0,1,2
CCACGAATTTAACCTC-1_V12N28-333_D1,3,0,0,0,0,3
TTCTTGCTAGCATCTC-1_V12N28-333_D1,2,0,0,0,0,2
ACACCTTACTACTTGC-1_V12N28-333_D1,2,0,0,0,0,2
AGTCGGTTGCGTGAGA-1_V12N28-333_D1,0,0,0,0,0,0
ACCTACAGTATGTGGT-1_V12N28-333_D1,1,0,0,0,1,2
GAGGATAAACAGTGCT-1_V12N28-333_D1,2,1,0,0,0,3
TTCCGGTATCTGTGTC-1_V12N28-333_D1,0,2,0,0,1,3
GGAGGCCGAAGTCGTC-1_V12N28-333_D1,0,0,0,0,0,0
TTCGCTAGGAAGTTGT-1_V12N28-333_D1,2,0,0,0,1,3
TAAAGACAACCCTTTA-1_V12N28-333_D1,1,0,0,0,0,1
GTTGCGCTAACATTAC-1_V12N28-333_D1,1,0,0,0,1,2
GCTGAACTCTCCAGGG-1_V12N28-333_D1,0,0,0,0,0,0
AGCCCTGTCGCACCGT-1_V12N28-333_D1,2,0,0,0,1,3
AGCGCTAGAGCGATGT-1_V12N28-333_D1,0,0,0,0,0,0
TGCGCCGTTAATAACG-1_V12N28-333_D1,0,0,0,0,0,0
TGACAACGCATGTCGC-1_V12N28-333_D1,0,0,0,0,0,0
CGTCTTGAGTGTGACG-1_V12N28-333_D1,0,0,0,0,0,0
GATAGGATTAATTACA-1_V12N28-333_D1,0,0,0,0,0,0
GATACCGTGTCGGAGT-1_V12N28-333_D1,0,1,0,0,0,1
TGTGTCGAAGTCGAGG-1_V12N28-333_D1,1,0,0,1,0,2
GGATCAGAGCCATCAG-1_V12N28-333_D1,0,0,0,3,0,3
GTCCCAATCATCCCGC-1_V12N28-333_D1,2,0,0,3,0,5
TGCCACACTAGAGGAA-1_V12N28-333_D1,1,0,0,1,0,2
TGAATTTCACTTGCCT-1_V12N28-333_D1,4,0,0,2,0,6
CTCAGATTGTGATAAG-1_V12N28-333_D1,2,0,0,1,0,3
CGGACGTTACTTGAAG-1_V12N28-333_D1,2,0,0,1,0,3
CCGCCTTGCGATGTCG-1_V12N28-333_D1,2,0,0,0,0,2
CCAGTCAAATCTCTTA-1_V12N28-333_D1,1,1,0,1,0,3
AAACAGCTTTCAGAAG-1_V12N28-333_D1,3,3,0,2,0,8
TAGCTGATGTGAAGCG-1_V12N28-333_D1,5,1,0,1,0,7
CTTATGCGCTCAGGGC-1_V12N28-333_D1,5,1,0,1,0,7
TGGCTCTTGTCGCGTA-1_V12N28-333_D1,6,2,0,0,0,8
TTGTGAGGCATGACGC-1_V12N28-333_D1,2,1,0,1,0,4
CATAAGCTCTCCGTCT-1_V12N28-333_D1,3,0,2,0,0,5
CCTTCTCAGCGTTCCT-1_V12N28-333_D1,1,2,0,0,0,3
TGCAGCTACGTACTTC-1_V12N28-333_D1,0,0,2,0,0,2
CTCTACACTGGCGATT-1_V12N28-333_D1,2,0,1,1,0,4
TGCAGATCGTCCTAGG-1_V12N28-333_D1,5,0,0,0,1,6
TGCCAAAGTCAGACTT-1_V12N28-333_D1,2,2,1,0,0,5
ACAATAGTCGTACGTT-1_V12N28-333_D1,1,0,6,0,0,7
CATGCCAACTCGCAAA-1_V12N28-333_D1,0,1,0,0,0,1
TGCAGAACTATATCGT-1_V12N28-333_D1,0,1,2,0,0,3
TCGTGTCACGCTGACA-1_V12N28-333_D1,2,0,0,0,0,2
TGATCAGGGAACTGCT-1_V12N28-333_D1,0,0,1,0,0,1
CTTGCAACCGCCTCCT-1_V12N28-333_D1,1,3,1,0,0,5
AGCCCATACATGTAAG-1_V12N28-333_D1,1,2,3,0,0,6
ATCCAATGGAGGGTCC-1_V12N28-333_D1,1,1,0,1,0,3
AAACCGGGTAGGTACC-1_V12N28-333_D1,2,1,4,0,0,7
GCAACCACGGCCGCGT-1_V12N28-333_D1,3,1,0,0,0,4
CGCTTATTCCCGGTCG-1_V12N28-333_D1,0,0,1,0,1,2
TTACTCTGGTACGTAC-1_V12N28-333_D1,1,0,0,0,0,1
GTGGTTTCCGCCTTTC-1_V12N28-333_D1,2,1,0,0,0,3
ATAGGCGGCTATAGAA-1_V12N28-333_D1,0,0,0,0,0,0
GTGCCATCACACGGTG-1_V12N28-333_D1,2,0,0,1,0,3
CCCAACATACGTCGCG-1_V12N28-333_D1,0,0,1,1,2,4
CGGTGCAGATAGAACG-1_V12N28-333_D1,3,2,0,0,1,6
GGGCGGGTTCCCTACG-1_V12N28-333_D1,0,1,0,0,1,2
TGAGCCATACAGTCTC-1_V12N28-333_D1,5,1,0,0,0,6
CTCCGCCCACATGAGG-1_V12N28-333_D1,1,2,1,0,3,7
GTTGAACCGGTTCCAT-1_V12N28-333_D1,4,0,0,0,1,5
TTGACTACCATATGGT-1_V12N28-333_D1,2,0,0,0,1,3
ACCATCGTATATGGTA-1_V12N28-333_D1,1,0,0,0,0,1
TGCGTAAGAACCTGAT-1_V12N28-333_D1,1,0,0,0,1,2
AGAAGGTTGCCGAATT-1_V12N28-333_D1,0,0,1,0,1,2
AGGACGACCCATTAGA-1_V12N28-333_D1,2,1,0,0,2,5
GGTGCTGGTACACATT-1_V12N28-333_D1,0,0,1,0,1,2
GCGCTATGCCGAGGCA-1_V12N28-333_D1,3,1,1,0,0,5
ACCCGGTTACACTTCC-1_V12N28-333_D1,2,2,0,0,1,5
TAACTCATCCGCGCGG-1_V12N28-333_D1,2,0,0,0,0,2
CACAATGAGCTGCTAT-1_V12N28-333_D1,1,0,0,0,2,3
GTTACTTTGGGCCTAG-1_V12N28-333_D1,3,0,0,0,0,3
GGGCCCGTCTTAAACA-1_V12N28-333_D1,1,0,2,0,0,3
GAAATTGTCTCTATAA-1_V12N28-333_D1,0,1,2,0,0,3
GGCGCATGAATTGATG-1_V12N28-333_D1,1,0,0,0,0,1
CATATAGGTACAGTCA-1_V12N28-333_D1,0,0,0,0,1,1
TCAACGAGGAGACAAA-1_V12N28-333_D1,2,0,0,0,0,2
TTGCACAATTCAGAAA-1_V12N28-333_D1,1,2,1,0,0,4
CATCGGACGGGTTAAT-1_V12N28-333_D1,0,0,1,0,0,1
ATTAAACATGCGGACC-1_V12N28-333_D1,3,0,0,0,0,3
TATCTACCACAGCGGG-1_V12N28-333_D1,1,0,0,0,0,1
CGAGACCCTAGAGTGT-1_V12N28-333_D1,0,0,0,0,0,0
ACATCGATCGTTTACC-1_V12N28-333_D1,0,0,2,0,2,4
ATCGACCCAATACAGA-1_V12N28-333_D1,0,4,0,0,1,5
GAATCTGAACATTCTC-1_V12N28-333_D1,1,0,0,0,0,1
AGTTCCTATTTATGTT-1_V12N28-333_D1,0,0,1,0,0,1
CAGTCTGTATACTGGG-1_V12N28-333_D1,2,1,0,0,1,4
GGAGACGACACCTTTG-1_V12N28-333_D1,1,2,0,0,1,4
CCTAAATTAACGGTTC-1_V12N28-333_D1,1,0,1,0,0,2
GCTACGACTTATTGGG-1_V12N28-333_D1,1,0,3,0,0,4
CTGTGCAGGGTAGGTC-1_V12N28-333_D1,1,0,0,0,1,2
ACGCCGCTAGACGACC-1_V12N28-333_D1,1,0,0,0,1,2
ACTTGACTCCCTCTTT-1_V12N28-333_D1,1,1,0,0,0,2
CGCCTCCCTCCTCTAT-1_V12N28-333_D1,1,2,1,0,0,4
CTAGATTTACGACGGC-1_V12N28-333_D1,0,0,1,0,0,1
GATGCTGTATTTCATC-1_V12N28-333_D1,0,0,0,0,1,1
TGCGTTTGTTGACACT-1_V12N28-333_D1,0,1,0,0,0,1
CGTGCCCTCCCGAAGA-1_V12N28-333_D1,2,1,1,0,1,5
ACTCTCTGACTTAGGT-1_V12N28-333_D1,1,1,1,0,0,3
CTGGGTAGGCAGTTAA-1_V12N28-333_D1,2,0,0,0,1,3
GTTTGGCCCAAGTTAT-1_V12N28-333_D1,1,0,0,0,2,3
GAATGTGGTCCGGATT-1_V12N28-333_D1,1,0,0,0,0,1
CCCAGTTAAGGCGCCG-1_V12N28-333_D1,3,2,0,0,2,7
CGGTACTAGAATCAAA-1_V12N28-333_D1,0,0,0,0,1,1
GCTTAATGTAACTAAC-1_V12N28-333_D1,2,0,0,0,0,2
AGGACAGTCGAATCCC-1_V12N28-333_D1,1,0,0,0,0,1
GACAGCCAGACCTGAC-1_V12N28-333_D1,1,0,0,0,0,1
GGCGAAATCTAACTTG-1_V12N28-333_D1,2,0,0,0,1,3
CTGGTAACACATAGAA-1_V12N28-333_D1,0,1,1,0,1,3
TAGCCATTTCAAAGTC-1_V12N28-333_D1,2,1,0,0,0,3
GGGATTTACCGCACCT-1_V12N28-333_D1,3,0,0,0,2,5
ATGCCATTTGCGACCA-1_V12N28-333_D1,1,0,0,0,0,1
GAATAGACGCGACCCA-1_V12N28-333_D1,2,0,0,0,0,2
TGTATGGCGCAGACAG-1_V12N28-333_D1,1,1,0,0,1,3
GGATGAAGATCGCTGA-1_V12N28-333_D1,1,0,0,0,2,3
CGACAATTTGATCTAA-1_V12N28-333_D1,1,0,0,0,0,1
AAAGTTGACTCCCGTA-1_V12N28-333_D1,2,0,0,0,1,3
CGCGGCTCAACTTGAA-1_V12N28-333_D1,0,0,1,0,0,1
CACGCGGAACTGTTGC-1_V12N28-333_D1,2,0,0,0,0,2
TCTTAGAGTGAACTCT-1_V12N28-333_D1,0,0,0,0,0,0
AGTCCATTGGCTGATG-1_V12N28-333_D1,2,1,0,0,0,3
TTAAGATAGGATTGAC-1_V12N28-333_D1,1,1,0,0,0,2
ACATCCTGGTAACTGT-1_V12N28-333_D1,2,2,0,0,0,4
CACCTTGGCGCCTTTG-1_V12N28-333_D1,1,0,0,0,0,1
GCTAGACCGTCTACTG-1_V12N28-333_D1,1,0,0,0,0,1
CGGCCCAGGTATATCC-1_V12N28-333_D1,2,1,0,0,0,3
GTCCATTACTGCTACG-1_V12N28-333_D1,1,0,0,0,0,1
GGGTTTAGGATAGGAT-1_V12N28-333_D1,1,0,0,0,0,1
TAATTAGGACATCCGT-1_V12N28-333_D1,1,0,0,0,0,1
GCTCCCAGTCGGTCCA-1_V12N28-333_D1,1,0,0,0,1,2
ATTCGTGCTATCTCTT-1_V12N28-333_D1,1,0,0,0,0,1
GTTAACTATGTTGTCA-1_V12N28-333_D1,2,0,1,0,0,3
GCTCCGCTCGCTTCAG-1_V12N28-333_D1,2,0,0,0,1,3
GCAACGGCTAGTTATG-1_V12N28-333_D1,1,0,0,0,0,1
AATCGCGCAGAGGACT-1_V12N28-333_D1,0,0,0,0,1,1
AGGTTACACCATGCCG-1_V12N28-333_D1,0,0,0,0,0,0
CGAGATTTCGCTCGGG-1_V12N28-333_D1,2,0,0,0,0,2
CGATAATACTCAGGTT-1_V12N28-333_D1,2,1,0,0,0,3
AAGGCAGGCTGTCTCC-1_V12N28-333_D1,1,0,0,0,0,1
GTAAGTCCACACTCTA-1_V12N28-333_D1,3,0,0,0,0,3
ATGAGGGCAGCGGCTA-1_V12N28-333_D1,1,0,0,0,0,1
GCCGCACTCCGTTTCA-1_V12N28-333_D1,1,0,0,0,0,1
GAGCACGGCGCCTCTT-1_V12N28-333_D1,1,0,0,0,1,2
ACAATTTGGCCATATT-1_V12N28-333_D1,0,0,0,0,1,1
CTGGTTCGCGAGCTAC-1_V12N28-333_D1,1,1,0,0,0,2
GACGGTCCTAGGGTGT-1_V12N28-333_D1,2,1,0,0,1,4
ACTCGCGATCTGACGC-1_V12N28-333_D1,0,0,0,0,0,0
GTGTACGAACCGTTCC-1_V12N28-333_D1,0,0,0,0,1,1
CTTTGACGTCGCTTCT-1_V12N28-333_D1,1,0,1,2,0,4
CGTTATCATACTTCCA-1_V12N28-333_D1,6,0,0,0,0,6
GCTATGCCAGCTTATG-1_V12N28-333_D1,2,2,0,2,0,6
CAGTCGGCCTAGATAT-1_V12N28-333_D1,1,1,0,0,0,2
CCCGTGAGGGCGGTGA-1_V12N28-333_D1,1,2,0,2,0,5
TCTCGTGTTACGAGGA-1_V12N28-333_D1,1,0,0,3,0,4
ACGTCTCGTTCCGGGA-1_V12N28-333_D1,2,0,0,3,0,5
CGAGAGCGCGTAGATA-1_V12N28-333_D1,1,0,0,1,0,2
GACAGATTTCTGGCTC-1_V12N28-333_D1,3,1,0,1,0,5
GGGCCTAAATGGGCTA-1_V12N28-333_D1,4,2,0,2,0,8
ACTTGTAGTCCCTTCA-1_V12N28-333_D1,5,0,0,0,0,5
CCCGAAGTTTCGCGAA-1_V12N28-333_D1,3,0,0,0,0,3
ACCATCCGCCAACTAG-1_V12N28-333_D1,6,1,0,0,0,7
TGCGAATATGGGATTT-1_V12N28-333_D1,4,2,0,1,0,7
TACATCCCTATCCCTG-1_V12N28-333_D1,5,0,0,3,0,8
GTGGGAAGACTGAATC-1_V12N28-333_D1,6,0,2,0,0,8
TCAACATCGACCGAGA-1_V12N28-333_D1,2,0,4,0,0,6
CTATGTGAGTCACGGC-1_V12N28-333_D1,3,0,1,0,0,4
CCGAACACTGGGCCTC-1_V12N28-333_D1,0,3,1,2,0,6
AAACTTGCAAACGTAT-1_V12N28-333_D1,4,1,2,0,0,7
AGGGCGAGCAGCTGAT-1_V12N28-333_D1,3,0,0,0,0,3
AACACGAGACGCGGCC-1_V12N28-333_D1,2,1,0,0,0,3
TGACGAATATTTCCCT-1_V12N28-333_D1,1,1,0,0,0,2
TCGGAGAGTATCGGGA-1_V12N28-333_D1,2,1,0,1,0,4
CAAATCTCTCACAAGG-1_V12N28-333_D1,0,3,0,0,0,3
AGGCCCTAGAACGCCA-1_V12N28-333_D1,2,0,1,1,0,4
TAGAGATCATGCAACT-1_V12N28-333_D1,0,0,1,0,1,2
TTGTTTCCATACAACT-1_V12N28-333_D1,2,0,1,0,0,3
GAGAGGTGCATTCTGG-1_V12N28-333_D1,0,1,0,2,1,4
GTGGACCAACCCGATT-1_V12N28-333_D1,0,1,0,0,2,3
CTGGGCCTGCTATATC-1_V12N28-333_D1,0,0,1,0,0,1
CATAGTCCACAAGAAC-1_V12N28-333_D1,2,1,0,0,0,3
TTGACATGAACGTGGA-1_V12N28-333_D1,1,0,1,0,1,3
GGTTACCACCCTCGGG-1_V12N28-333_D1,0,0,3,0,0,3
TACCGGTCGTTTCCAT-1_V12N28-333_D1,1,1,1,0,0,3
CGAGTACTAAAGAGGA-1_V12N28-333_D1,1,0,0,0,0,1
GCAAGAATTCCTTGGC-1_V12N28-333_D1,3,1,1,0,0,5
TCGCCGAAGTTGCGTC-1_V12N28-333_D1,2,0,0,0,1,3
TTGAGAGTACTGCTAA-1_V12N28-333_D1,1,0,4,0,0,5
GCCACAATTTAAGGAC-1_V12N28-333_D1,0,1,2,0,1,4
ATATTCAGTTAAACCT-1_V12N28-333_D1,1,0,1,0,0,2
TGAGTGCCTCTTAAAT-1_V12N28-333_D1,0,2,1,0,0,3
ATCAGACGGCACGCCG-1_V12N28-333_D1,2,0,0,0,2,4
GTGCGAAATCGAACAC-1_V12N28-333_D1,2,0,0,0,0,2
GTGCCGCTTCAAAGGT-1_V12N28-333_D1,1,0,0,0,0,1
GATACGATGGGAGTCA-1_V12N28-333_D1,0,1,1,0,0,2
GACACTGAGTTCAGTG-1_V12N28-333_D1,1,0,0,0,1,2
ATCCTGCGTGGAATGG-1_V12N28-333_D1,2,0,3,1,0,6
ATCCTACCTAAGCTCT-1_V12N28-333_D1,1,0,1,0,0,2
AGTGATATGAGTAGTT-1_V12N28-333_D1,2,1,0,0,0,3
ATGATGCAATGGTACA-1_V12N28-333_D1,1,0,0,0,0,1
GAAACCGAATTACCTT-1_V12N28-333_D1,1,0,1,0,0,2
AGTGACCTACTTTACG-1_V12N28-333_D1,1,2,0,0,1,4
CAAATGTCCTTCCGTG-1_V12N28-333_D1,2,0,2,0,2,6
TTACTGGGATATTTCA-1_V12N28-333_D1,0,1,1,0,1,3
CTTGCCCAGGCTCTAC-1_V12N28-333_D1,1,1,3,0,1,6
AAATCGTGTACCACAA-1_V12N28-333_D1,0,0,1,0,0,1
GTGATCATAGATCTGC-1_V12N28-333_D1,0,0,2,0,0,2
TGGCAGATTACGATCA-1_V12N28-333_D1,0,0,0,0,0,0
TCACCCTCTTAAGATT-1_V12N28-333_D1,0,1,2,0,0,3
CAGGATATATCGTTGT-1_V12N28-333_D1,0,0,2,0,0,2
CCTGACCACCGATGGT-1_V12N28-333_D1,0,0,0,0,0,0
CTAAAGGGAAATAGGA-1_V12N28-333_D1,1,1,2,0,0,4
CCGCTATCAGCACCAG-1_V12N28-333_D1,2,0,0,0,2,4
CTTTAGTGCTATTATT-1_V12N28-333_D1,0,0,1,0,0,1
CGGGAATTTATGTAAA-1_V12N28-333_D1,1,0,1,0,1,3
TACGACTGCCTCTTAG-1_V12N28-333_D1,1,1,1,0,1,4
AAACTGCTGGCTCCAA-1_V12N28-333_D1,0,1,1,0,0,2
GTACGTTTGCCCGTCA-1_V12N28-333_D1,0,1,5,0,1,7
GGCAAGGCGAAATAGC-1_V12N28-333_D1,1,1,0,0,1,3
GATCTTGGAGGGCATA-1_V12N28-333_D1,0,0,0,0,0,0
AGCGTGGTATTCTACT-1_V12N28-333_D1,1,2,0,0,3,6
CTAAGGGAATGATTGG-1_V12N28-333_D1,0,0,1,0,0,1
CATGGTAAGTAGCGTT-1_V12N28-333_D1,1,1,2,0,2,6
CGTTGAGCGACCGTCG-1_V12N28-333_D1,1,0,0,0,0,1
TGCCCGTACCGTTAAA-1_V12N28-333_D1,0,0,0,0,0,0
ACAAGGGCAGGCTCTG-1_V12N28-333_D1,0,0,2,0,0,2
GAGATCTTCCATGACA-1_V12N28-333_D1,2,2,0,0,1,5
AATGACGTAGGATGTC-1_V12N28-333_D1,1,0,0,0,0,1
GTGGTGGCCAAGTGAA-1_V12N28-333_D1,1,1,0,0,1,3
TCCCGTGTGCAATTTG-1_V12N28-333_D1,0,0,0,0,1,1
ACATCGTATGCAATGG-1_V12N28-333_D1,0,0,1,0,1,2
GCGAAACTTAACTGGA-1_V12N28-333_D1,0,0,0,0,1,1
AATTGAACGCTCTGGT-1_V12N28-333_D1,1,0,0,0,1,2
ACAAATGGTAGTGTTT-1_V12N28-333_D1,0,2,1,0,0,3
ATGGTCGCGTGGTTTC-1_V12N28-333_D1,1,0,0,0,0,1
TGTTATTGTATGTGGC-1_V12N28-333_D1,1,0,0,0,0,1
TTCCGGTTACCCACTT-1_V12N28-333_D1,0,0,0,0,0,0
GAGTGTGCGGTACCCA-1_V12N28-333_D1,2,0,0,0,1,3
CAAGATATTATAACGT-1_V12N28-333_D1,2,1,0,0,1,4
ACACACCAGGACCAGT-1_V12N28-333_D1,2,1,1,0,0,4
ATGGGCCTCGGCCTCT-1_V12N28-333_D1,2,0,0,0,1,3
AAGGTGATAAACCAGC-1_V12N28-333_D1,3,0,3,0,0,6
TCTTACTTATGCCTCT-1_V12N28-333_D1,3,1,0,0,0,4
AAAGTGTGATTTATCT-1_V12N28-333_D1,1,0,0,0,1,2
TGCTCCACAGTTCTTA-1_V12N28-333_D1,1,0,1,0,1,3
CTGGCTGATTCATCCT-1_V12N28-333_D1,3,0,0,0,0,3
TAAGGCTGAATCCCTC-1_V12N28-333_D1,2,0,0,0,0,2
TCTAGTGATATCGTGG-1_V12N28-333_D1,1,0,0,0,0,1
TCGAAGAACCGAGCAC-1_V12N28-333_D1,1,1,0,0,0,2
GACAAACATATGCAGG-1_V12N28-333_D1,1,2,0,0,0,3
AAGTCAATTGTCGTCA-1_V12N28-333_D1,3,0,0,0,1,4
AGTGAACAAACTTCTC-1_V12N28-333_D1,2,1,0,0,0,3
CATGATGGAAGTTAGC-1_V12N28-333_D1,1,0,0,0,0,1
AAGTGCCTTGACTGTA-1_V12N28-333_D1,2,0,1,0,0,3
ATCGCCAGTCAACATT-1_V12N28-333_D1,3,0,0,0,0,3
ACCGCGGTGGAAGTCG-1_V12N28-333_D1,5,0,0,0,1,6
TCTTCTATAACCCGCC-1_V12N28-333_D1,2,0,0,0,1,3
CACATTTCTTGTCAGA-1_V12N28-333_D1,3,0,0,0,1,4
TAGCGTCCCTCGATTG-1_V12N28-333_D1,2,0,0,0,0,2
GTTCGGATCGGGAACA-1_V12N28-333_D1,3,0,0,0,0,3
CAAACTCGCGACGCCG-1_V12N28-333_D1,2,0,0,0,0,2
GTCTTGTAGCTATTCA-1_V12N28-333_D1,0,0,0,0,1,1
TCTCGACGTATCGCCG-1_V12N28-333_D1,3,0,0,0,1,4
TTGCCAAGCAGAACCC-1_V12N28-333_D1,3,2,0,0,0,5
AAACCCGAACGAAATC-1_V12N28-333_D1,1,0,0,0,1,2
TTGAGCAGCCCACGGT-1_V12N28-333_D1,2,1,0,0,1,4
CGCCTTTAGCATGCTC-1_V12N28-333_D1,1,0,0,0,0,1
TGTGGCTCCCACCAAC-1_V12N28-333_D1,0,0,0,0,1,1
CCGCCGTTGAGGATAA-1_V12N28-333_D1,2,0,0,0,0,2
CAATACGAGAGTCTGA-1_V12N28-333_D1,3,1,0,0,0,4
CATCTAGTGAAGGGAA-1_V12N28-333_D1,0,0,0,0,0,0
GGTGGAGGTTGATACG-1_V12N28-333_D1,0,0,0,0,0,0
CCGCACACGAACGTGT-1_V12N28-333_D1,0,1,0,0,0,1
AGAACCCAGCGTGACA-1_V12N28-333_D1,0,0,0,0,0,0
GCGCTCGATCACCTGT-1_V12N28-333_D1,2,0,0,0,0,2
ATCATGGACTACCGAC-1_V12N28-333_D1,1,0,0,0,0,1
TACGCCGCCTCAGAAG-1_V12N28-333_D1,0,1,0,0,0,1
CGACCTACTAGACAAT-1_V12N28-333_D1,0,0,0,1,0,1
GAGTCTTGTAAAGGAC-1_V12N28-333_D1,5,0,0,1,0,6
AATATCCTAGCAAACT-1_V12N28-333_D1,3,0,0,3,0,6
CCCTAGGCAACAAGAG-1_V12N28-333_D1,3,0,0,1,0,4
ACAAAGAAGGTAGGCC-1_V12N28-333_D1,4,1,1,2,0,8
CCCTGGCTGTTCCTTC-1_V12N28-333_D1,3,0,1,0,0,4
TCGCCGCACCGCGTGA-1_V12N28-333_D1,0,0,0,0,0,0
TATAGCGCACGTTATC-1_V12N28-333_D1,2,1,0,1,0,4
TTATCTGACATTAGGA-1_V12N28-333_D1,3,0,0,3,0,6
AGTGGTGTTACCCGTG-1_V12N28-333_D1,2,0,0,0,0,2
GCCAAGAATACTTCTG-1_V12N28-333_D1,4,1,0,0,0,5
CCGGCGTGAGACTCTG-1_V12N28-333_D1,4,0,0,2,0,6
TTCCCGGCGCCAATAG-1_V12N28-333_D1,7,0,0,1,0,8
AAACAGGGTCTATATT-1_V12N28-333_D1,5,1,0,0,0,6
ACAGTAATACAACTTG-1_V12N28-333_D1,6,0,2,0,1,9
CGAACGGCCGGACAAC-1_V12N28-333_D1,3,2,0,0,0,5
GCAACACACTAGAACT-1_V12N28-333_D1,3,0,4,1,0,8
ACTCCCATTCCTAAAG-1_V12N28-333_D1,3,2,1,1,0,7
ACCTGCGTGTCATGTT-1_V12N28-333_D1,1,0,1,3,0,5
TACTTTCCGCACGCCA-1_V12N28-333_D1,3,0,1,0,0,4
AGGTCAGGTGAGAGTG-1_V12N28-333_D1,3,0,2,0,0,5
TCCTCCTAAGACATTC-1_V12N28-333_D1,3,0,0,0,0,3
ATGTGAAAGCCTAATG-1_V12N28-333_D1,2,1,3,0,0,6
AGTCGGCTCAACTTTA-1_V12N28-333_D1,2,2,0,0,0,4
CGATCTGTTGGAGGAC-1_V12N28-333_D1,0,0,2,0,0,2
ACGGGAGTGTCGGCCC-1_V12N28-333_D1,2,2,1,0,0,5
TTAACTTCAGGTAGGA-1_V12N28-333_D1,4,1,2,0,0,7
CCACGGAGCCATAAGA-1_V12N28-333_D1,3,0,0,0,0,3
CTTCTATGTTGAAGTA-1_V12N28-333_D1,2,2,3,1,1,9
CACCGTTGCGCGATAT-1_V12N28-333_D1,0,0,2,0,0,2
TCTAGCAATCTCCGCC-1_V12N28-333_D1,1,0,3,0,0,4
AGTTTGGCCAGACCTA-1_V12N28-333_D1,3,1,0,0,0,4
TTGTAAGGACCTAAGT-1_V12N28-333_D1,2,3,0,0,1,6
AAATTTGCGGGTGTGG-1_V12N28-333_D1,3,0,0,0,0,3
AAGTTCGGCCAACAGG-1_V12N28-333_D1,0,0,2,0,1,3
CCGCTTACCTCACTCT-1_V12N28-333_D1,3,0,0,0,0,3
ATCACGTGCTAATTAA-1_V12N28-333_D1,1,0,0,0,0,1
GGTGAAGTACAGGGAT-1_V12N28-333_D1,4,0,0,0,0,4
GCTGTATTACTGGCCC-1_V12N28-333_D1,2,0,0,0,2,4
AACGGCCATCTCCGGT-1_V12N28-333_D1,4,0,0,0,1,5
TAAGTAACATCTTGAC-1_V12N28-333_D1,4,0,0,0,1,5
TTCTTGAGCCGCGCTA-1_V12N28-333_D1,3,0,0,0,0,3
AGTGCGTAGCTCGTAA-1_V12N28-333_D1,0,0,1,0,0,1
GGGATGGTCGTAACCG-1_V12N28-333_D1,3,0,0,0,0,3
GTCTGGGCGGTCGAGA-1_V12N28-333_D1,1,0,0,0,0,1
CGGAACGTAAACATAG-1_V12N28-333_D1,3,0,2,0,0,5
TGCGACACCCTAGTGC-1_V12N28-333_D1,2,0,1,0,0,3
CAAACGAGTATCGCAG-1_V12N28-333_D1,2,0,2,0,0,4
TCAGTAGGGACTATAA-1_V12N28-333_D1,1,0,2,0,1,4
GCGGTTCCCTATCATG-1_V12N28-333_D1,5,0,3,0,0,8
GTGACTTCAGTAGTGC-1_V12N28-333_D1,2,0,1,0,0,3
CGTCACGTCCATTGGT-1_V12N28-333_D1,1,0,0,0,0,1
ATAAGTTACCGCGACG-1_V12N28-333_D1,1,0,1,0,0,2
CTGAATCCGAGACCTC-1_V12N28-333_D1,1,0,0,0,0,1
TACGACGCTTGCTGCG-1_V12N28-333_D1,0,0,2,0,0,2
GAATTCACCCGGGTGT-1_V12N28-333_D1,5,0,0,0,1,6
GGGTGACACCTTAACT-1_V12N28-333_D1,2,0,1,0,0,3
TGAGTAAATTAGCGTA-1_V12N28-333_D1,3,0,2,1,0,6
GAGTCCGCTTACCGGA-1_V12N28-333_D1,1,0,1,0,0,2
GGCGCGTTCGAGTTTA-1_V12N28-333_D1,0,2,1,0,0,3
ATTCATATACTGTCCA-1_V12N28-333_D1,1,0,3,1,0,5
ATAAACGGACCCGTAA-1_V12N28-333_D1,3,0,2,2,0,7
GTCGTACCATCTCGGG-1_V12N28-333_D1,1,3,0,0,0,4
ATAATAGCTGTTGAAT-1_V12N28-333_D1,1,0,1,0,0,2
TTCCGCGTGAGGCGAT-1_V12N28-333_D1,0,0,0,0,1,1
TACCGGCTCACTGCCC-1_V12N28-333_D1,0,3,0,0,0,3
GTATCTTTCATAACCA-1_V12N28-333_D1,0,2,0,0,1,3
GTTACCTACAACTTGC-1_V12N28-333_D1,1,0,0,0,0,1
TGACTATAATCCTTTC-1_V12N28-333_D1,1,0,1,0,0,2
AAATACCTATAAGCAT-1_V12N28-333_D1,0,1,2,0,1,4
TTATTAGAGCGTGTTC-1_V12N28-333_D1,1,0,0,0,0,1
ATGTGGACATCTTGAT-1_V12N28-333_D1,0,1,4,0,0,5
GTACGCTTCATTGCAC-1_V12N28-333_D1,1,3,0,0,0,4
CACATATTAGCAGGAT-1_V12N28-333_D1,1,0,0,0,0,1
CAAGAGGGCGGAGTAC-1_V12N28-333_D1,0,2,0,0,0,2
TCGCAAAGATGCATTT-1_V12N28-333_D1,2,2,1,0,0,5
GTCGTTATTCGCTTAT-1_V12N28-333_D1,1,1,1,0,1,4
TCGTGTACTATGGATG-1_V12N28-333_D1,1,0,1,0,0,2
GCGGAGAGGGAGAACG-1_V12N28-333_D1,2,0,0,0,0,2
TCACAGGGAATCGCAA-1_V12N28-333_D1,0,0,3,0,0,3
GACTGCACCAGCCCAG-1_V12N28-333_D1,1,1,1,0,0,3
TCCGCTGTCATCCCGG-1_V12N28-333_D1,0,0,1,0,1,2
AGATACTCAAGATCGA-1_V12N28-333_D1,0,1,1,0,1,3
ACTGAATGGCGAAAGT-1_V12N28-333_D1,0,0,0,0,1,1
TCCTACATCCACGGCC-1_V12N28-333_D1,3,2,0,0,2,7
TTCAGCCCTGGTCCAC-1_V12N28-333_D1,1,1,0,0,0,2
TTAGAGTTTAGAAGGA-1_V12N28-333_D1,2,1,0,0,1,4
GGTTAGCTATATGTCT-1_V12N28-333_D1,2,0,1,0,0,3
CTGGTTTCGAGCAAGA-1_V12N28-333_D1,0,0,0,0,0,0
TGGGCCCATACTAATT-1_V12N28-333_D1,0,0,0,0,1,1
ACTTATTTATGTGCCA-1_V12N28-333_D1,0,0,0,0,1,1
TTAGTTATTCGTGGCA-1_V12N28-333_D1,0,0,0,0,0,0
AACCGCTAAGGGATGC-1_V12N28-333_D1,1,0,1,0,1,3
ATACGTCCACTCCTGT-1_V12N28-333_D1,1,1,0,0,1,3
CGACACGCTCCGACAG-1_V12N28-333_D1,1,1,0,0,0,2
TCTGAACTCGTACCCG-1_V12N28-333_D1,0,0,0,0,1,1
AGGATATAGGGATTTA-1_V12N28-333_D1,0,0,0,0,1,1
GTGATCACTAACGCCT-1_V12N28-333_D1,1,0,0,0,0,1
ACCGGGCCTTTGTTGA-1_V12N28-333_D1,2,1,0,0,0,3
TTGACAGGAGCTCCCG-1_V12N28-333_D1,0,0,2,0,1,3
CTCTTCTATTGACTGG-1_V12N28-333_D1,4,1,1,0,0,6
CGTGGCCGAATATCTA-1_V12N28-333_D1,1,1,0,0,1,3
GGTTTAGCCTTTCTTG-1_V12N28-333_D1,4,1,0,0,0,5
TCAAGGTTACTACACC-1_V12N28-333_D1,2,0,0,0,0,2
TTGACTATTGTCCGGC-1_V12N28-333_D1,0,0,0,0,0,0
CGGGAATATAGTATAC-1_V12N28-333_D1,3,0,0,0,0,3
GCAACAGCAGTATGCG-1_V12N28-333_D1,3,0,0,0,3,6
ATCAAACACTGTTCCA-1_V12N28-333_D1,2,0,0,0,1,3
TGGGCAATAGTTGGGT-1_V12N28-333_D1,1,0,0,0,1,2
TGAATGTCAGCCGGCC-1_V12N28-333_D1,2,0,0,0,0,2
CGGCTCTAAAGCTGCA-1_V12N28-333_D1,2,0,0,0,0,2
GGACACAAGTTTACAC-1_V12N28-333_D1,0,0,0,0,0,0
CCGAGAAGTCGCATAA-1_V12N28-333_D1,3,0,0,0,0,3
AACTACCCGTTTGTCA-1_V12N28-333_D1,1,0,0,0,2,3
GCACAAACGAGGCGTG-1_V12N28-333_D1,0,0,0,0,0,0
CACACAGCTTGCGCTC-1_V12N28-333_D1,2,1,0,0,0,3
GTGCTTACATCAGCGC-1_V12N28-333_D1,0,0,0,0,2,2
GCAAACGTCGCCAGGT-1_V12N28-333_D1,2,0,0,0,0,2
GAATAGCATTTAGGGT-1_V12N28-333_D1,1,0,0,0,0,1
TACTGTTTCTCTGGTA-1_V12N28-333_D1,0,0,0,0,0,0
TCCTATCATAGGTAAC-1_V12N28-333_D1,0,1,0,0,0,1
TTCGGTGGAGACGCCC-1_V12N28-333_D1,0,0,0,0,1,1
TGTTGCCGTCGTCCCA-1_V12N28-333_D1,1,1,0,0,0,2
CCAACTTGATAGATCC-1_V12N28-333_D1,3,1,0,0,0,4
CAAAGGTCATCTGAAA-1_V12N28-333_D1,1,0,0,0,1,2
CTAGCTTAATGGTCCC-1_V12N28-333_D1,0,0,0,0,1,1
AGGCCACATTGGTTAC-1_V12N28-333_D1,1,0,0,0,0,1
TTAGGATGGGAGGGTA-1_V12N28-333_D1,2,0,0,0,0,2
TATGACCTTGCGCTGG-1_V12N28-333_D1,4,0,0,0,0,4
ATATACATGTATGGTA-1_V12N28-333_D1,3,1,0,1,0,5
TGTGTGACCATGAATC-1_V12N28-333_D1,5,0,0,2,0,7
CCCACTCCACGGTATC-1_V12N28-333_D1,1,0,0,1,0,2
GGGCAGACGTCACTGC-1_V12N28-333_D1,1,1,0,1,0,3
TCAAAGAGCTATCTGT-1_V12N28-333_D1,2,1,0,3,0,6
AGATGCATCCTGTGTC-1_V12N28-333_D1,2,0,0,0,0,2
GTGAAGTCACGACTCG-1_V12N28-333_D1,3,1,0,2,0,6
TGATTCAGGTCCCGCG-1_V12N28-333_D1,4,0,0,1,0,5
CGCCACAGGTCGCGAT-1_V12N28-333_D1,4,0,0,2,0,6
TTGAATCGTTGTATAA-1_V12N28-333_D1,0,0,0,4,0,4
TGGCCAATTTGGTACT-1_V12N28-333_D1,3,1,0,0,0,4
CGACCCTTAACGCCGG-1_V12N28-333_D1,2,0,0,0,0,2
TCGGCGTACTGCACAA-1_V12N28-333_D1,2,0,1,2,0,5
GAGTAAGGCCACGGGA-1_V12N28-333_D1,1,0,0,2,0,3
ATCAGCTCGTCCACTA-1_V12N28-333_D1,4,0,0,3,0,7
AGGATCACGCGATCTG-1_V12N28-333_D1,3,0,0,0,0,3
AAATGGCCCGTGCCCT-1_V12N28-333_D1,4,0,0,1,0,5
CAGTACCAGTTTACGT-1_V12N28-333_D1,3,1,0,1,0,5
GGTCGTAAGCTCGCAC-1_V12N28-333_D1,4,0,0,0,0,4
CGTTCATGGTGCGCGT-1_V12N28-333_D1,2,0,0,0,0,2
GACTACAAAGCGGTGG-1_V12N28-333_D1,1,0,1,1,0,3
CAGCTGGCGTAACCGT-1_V12N28-333_D1,2,2,2,0,0,6
ACTCGTAACCCGTCCT-1_V12N28-333_D1,7,0,1,0,0,8
CATATGTCAGGCTACG-1_V12N28-333_D1,5,1,0,1,0,7
GCCCGACTTCTTCCCG-1_V12N28-333_D1,5,0,0,0,0,5
CTGGCATCCGAATGAG-1_V12N28-333_D1,3,2,1,1,0,7
AAGTGCGTTAGAATCT-1_V12N28-333_D1,3,0,0,1,0,4
AGAAGTGATTCGTGAT-1_V12N28-333_D1,1,1,1,0,0,3
TACCTTAAGATTTCCC-1_V12N28-333_D1,2,1,0,0,0,3
AATGACAGCAATGTCT-1_V12N28-333_D1,9,0,0,0,0,9
TCAACGCAGGAAATAA-1_V12N28-333_D1,4,1,1,0,0,6
TATTCCTCCGCCCACT-1_V12N28-333_D1,3,0,1,0,0,4
ATCAAACGAAGGTTTG-1_V12N28-333_D1,3,0,0,0,0,3
TTGATTAGCTGTTTCT-1_V12N28-333_D1,1,0,1,1,0,3
CTGCTGAGGCCACGAA-1_V12N28-333_D1,1,0,0,1,0,2
CCGTGTTAAATTCCAT-1_V12N28-333_D1,5,0,0,0,0,5
CACGTCGGCAACCTCT-1_V12N28-333_D1,2,0,0,0,0,2
GTATTCTGAGAAACGA-1_V12N28-333_D1,3,0,0,0,0,3
CGGTGCGCGTTGGTCC-1_V12N28-333_D1,4,0,0,1,0,5
GTGATTCGCCGCTCAA-1_V12N28-333_D1,3,0,1,0,0,4
GCCCGCGCGTAAACGG-1_V12N28-333_D1,1,0,0,1,0,2
AACGTACTGTGGGTAC-1_V12N28-333_D1,2,1,0,0,1,4
GAGTATGCCCGCCTTG-1_V12N28-333_D1,4,0,0,0,0,4
TGATTCTGTCGCCGGT-1_V12N28-333_D1,1,0,1,0,0,2
GGGCGGCAAATGAATT-1_V12N28-333_D1,0,0,0,1,0,1
TTCCAATCTGGCTATC-1_V12N28-333_D1,4,0,0,0,0,4
GGAACCGTGTAAATTG-1_V12N28-333_D1,3,0,0,0,1,4
TTGGTCACACTCGTAA-1_V12N28-333_D1,0,1,0,0,1,2
CGAACCCGCATGCGTC-1_V12N28-333_D1,3,0,1,0,0,4
GGGCGTCACCACGTAA-1_V12N28-333_D1,2,0,0,0,0,2
TACCAGAAGTAGGTTC-1_V12N28-333_D1,5,0,0,0,0,5
TTGGATATCGTCTACG-1_V12N28-333_D1,4,0,1,0,0,5
TAGATATGGACTGGAA-1_V12N28-333_D1,6,0,0,0,0,6
GCGACGATAGTTGTAC-1_V12N28-333_D1,5,1,1,0,0,7
CTGGATTTACACTTGA-1_V12N28-333_D1,5,0,0,1,0,6
GTTATATTATCTCCCT-1_V12N28-333_D1,2,0,1,0,0,3
TATTCCACTCAGCTCG-1_V12N28-333_D1,5,0,0,0,0,5
CTGTTACCCAATCTAG-1_V12N28-333_D1,2,1,0,0,0,3
ACGCGAAGTCAGACGA-1_V12N28-333_D1,4,1,1,2,0,8
GATAGGTAACGTTGAC-1_V12N28-333_D1,1,2,0,0,0,3
TGTTCGTATTGCGGTG-1_V12N28-333_D1,5,1,1,0,0,7
GGTCAGTGGGTCCCAC-1_V12N28-333_D1,2,0,2,0,0,4
AATTCTAGAGTTAGGC-1_V12N28-333_D1,3,2,0,0,0,5
GTTTACGTTCCATCTG-1_V12N28-333_D1,3,4,1,0,0,8
AGACCCACCGCTGATC-1_V12N28-333_D1,3,1,0,0,0,4
TCTAGCATGCCCAGAA-1_V12N28-333_D1,3,0,0,0,0,3
CCCGCAGCGCGAACTA-1_V12N28-333_D1,3,2,0,0,0,5
CTCTATTTGGCTGCAG-1_V12N28-333_D1,3,1,0,0,0,4
TTCTGCCGCGCCTAGA-1_V12N28-333_D1,0,1,0,0,1,2
ACTCCCTAGAATAGTA-1_V12N28-333_D1,2,1,0,0,0,3
CCGAACCTTCCCGGCC-1_V12N28-333_D1,1,2,1,0,0,4
TCAGACGCTATAGAAG-1_V12N28-333_D1,2,1,0,0,1,4
CAGGCGCCATGCTAGG-1_V12N28-333_D1,1,0,1,0,1,3
CACTCGAGCTGAACAA-1_V12N28-333_D1,0,0,1,0,0,1
ACAAGGAAATCCGCCC-1_V12N28-333_D1,0,1,1,0,1,3
ACCACGTGCAGCTATA-1_V12N28-333_D1,0,0,1,0,1,2
ACGGCGACGATGGGAA-1_V12N28-333_D1,0,0,2,0,0,2
TTACTAAAGGACTTTA-1_V12N28-333_D1,0,0,2,0,0,2
GGCTGAAATAGCAAAG-1_V12N28-333_D1,1,1,1,0,0,3
TTAGACGAGTCACCTC-1_V12N28-333_D1,0,1,0,0,1,2
GTAGTCGCGGGAATCA-1_V12N28-333_D1,0,0,1,0,0,1
GCAAACCCTACATTAT-1_V12N28-333_D1,1,2,0,0,0,3
GTTAAAGTAGGACTGG-1_V12N28-333_D1,1,0,1,0,0,2
ACCCTCCCTTGCTATT-1_V12N28-333_D1,2,0,0,0,1,3
CATGTCTCATTTATGG-1_V12N28-333_D1,0,1,0,0,0,1
AATAGAATCTGTTTCA-1_V12N28-333_D1,0,0,1,0,2,3
TCTCATGAGATAGGGT-1_V12N28-333_D1,1,1,2,0,0,4
ATGACTATGCGACATT-1_V12N28-333_D1,0,0,1,0,0,1
CCTAACCCAAACAAGT-1_V12N28-333_D1,0,1,0,0,1,2
AGTCAAGATGACACTT-1_V12N28-333_D1,3,0,0,0,0,3
CGGGAGCTTCAGTGTA-1_V12N28-333_D1,0,0,2,1,0,3
CCACAGTACCCATCCT-1_V12N28-333_D1,0,0,1,0,0,1
GAGCGCGCACGAGTAG-1_V12N28-333_D1,0,0,0,0,1,1
ACCAGTGCGGGAGACG-1_V12N28-333_D1,0,0,0,0,1,1
TCCTTACGACGGTCCG-1_V12N28-333_D1,2,0,0,0,1,3
TAGTCGATCACGGGTT-1_V12N28-333_D1,3,0,0,0,1,4
AGACGAAGTGCCGGTC-1_V12N28-333_D1,1,0,0,0,0,1
CGCTGGTGACTACCCT-1_V12N28-333_D1,1,0,0,0,0,1
AGGCATTGTCGTAGGG-1_V12N28-333_D1,1,0,0,0,0,1
TGGTAGAATATATGGG-1_V12N28-333_D1,0,1,1,0,0,2
TTCTTATCCGCTGGGT-1_V12N28-333_D1,0,0,1,0,0,1
AGTTTGGCACGGGTTG-1_V12N28-333_D1,1,0,0,0,2,3
GCATCGGCCGTGTAGG-1_V12N28-333_D1,5,0,0,0,0,5
ATGCGAGTCCCACCAC-1_V12N28-333_D1,2,0,0,0,1,3
TCGGCGAACCCAAACC-1_V12N28-333_D1,2,0,0,0,1,3
AGAGTAAACTTCACTA-1_V12N28-333_D1,1,0,0,0,0,1
AAGCCGAAGCGGTTTA-1_V12N28-333_D1,2,0,0,0,0,2
CCCGAGTTTCTCCGTA-1_V12N28-333_D1,2,0,0,0,0,2
AATATCGAATCAATGC-1_V12N28-333_D1,2,0,0,0,1,3
GCGCCTCCCACTCCGA-1_V12N28-333_D1,0,0,0,0,0,0
CGTTAAACTAGTTAGG-1_V12N28-333_D1,4,0,0,0,0,4
TGAGTTAAAGACATTC-1_V12N28-333_D1,1,0,0,0,1,2
AACAGGTAGTATGGAT-1_V12N28-333_D1,1,1,0,0,2,4
GAACGCGGGTCACACG-1_V12N28-333_D1,1,0,0,0,0,1
TGTTTGAGATCGTCAG-1_V12N28-333_D1,0,1,0,0,0,1
ATCTCGTGAGCGAAAC-1_V12N28-333_D1,2,0,0,0,2,4
CTGAGAAAGTTCGGCG-1_V12N28-333_D1,0,0,0,0,0,0
ATTACCACACTGCCTG-1_V12N28-333_D1,1,0,0,0,0,1
CTGCTGTCTAACGAGC-1_V12N28-333_D1,3,0,0,0,0,3
CGTGGAAGCCTCGTAC-1_V12N28-333_D1,1,0,0,0,1,2
GGACTCACAAATTAGG-1_V12N28-333_D1,0,0,0,0,0,0
CTTTGCTGTCATGGAT-1_V12N28-333_D1,3,1,0,0,0,4
GGTGTTGGGCGTCTTA-1_V12N28-333_D1,0,0,0,0,0,0
TACCATGTATTGATTT-1_V12N28-333_D1,0,0,0,0,1,1
GGTCTCCAAGTAGTGC-1_V12N28-333_D1,0,1,0,0,0,1
ATCCTTCTGAAAGAAC-1_V12N28-333_D1,0,0,0,0,0,0
CCGGAAGTTATCAGTC-1_V12N28-333_D1,0,0,0,0,0,0
TTAGAGGGATATACAG-1_V12N28-333_D1,3,0,0,1,0,4
TTGTACACCTCGAACA-1_V12N28-333_D1,5,1,0,0,0,6
GTGGGTACTGAGCGTA-1_V12N28-333_D1,3,0,0,1,0,4
CTTAAGCAGCGAGCCG-1_V12N28-333_D1,2,0,0,1,0,3
GCATTGACTTGCGGAA-1_V12N28-333_D1,1,1,1,2,0,5
CCATAACCTGTGCAGT-1_V12N28-333_D1,6,1,0,0,0,7
GGGCTACTATTTCGTG-1_V12N28-333_D1,2,1,0,2,0,5
GGCGAGCGAAACGGCA-1_V12N28-333_D1,3,4,0,0,0,7
GGAGACCATCTACATA-1_V12N28-333_D1,2,0,0,2,0,4
AGACCAAACCACACCT-1_V12N28-333_D1,1,0,0,2,0,3
CGACGCATCCGTACCT-1_V12N28-333_D1,1,0,0,5,0,6
CCTAGGTAAAGGTAGC-1_V12N28-333_D1,6,0,0,3,0,9
AGCGGCGGTTAGCGGT-1_V12N28-333_D1,0,0,1,0,0,1
CTGGACGCAGTCCGGC-1_V12N28-333_D1,3,0,2,0,0,5
AGCCTAATACCCACGT-1_V12N28-333_D1,4,0,0,0,0,4
AATCTGGCTTTCTAGT-1_V12N28-333_D1,1,2,0,1,0,4
CACCCTTGGTGAGACC-1_V12N28-333_D1,4,0,0,0,0,4
GGATCTTGACTCAACC-1_V12N28-333_D1,5,0,0,0,0,5
ACGAGGATACCACTCT-1_V12N28-333_D1,0,1,1,1,0,3
GAGTTGATGGCAATTT-1_V12N28-333_D1,4,0,0,0,0,4
GTGGCAAACAGCGGCA-1_V12N28-333_D1,2,1,0,1,0,4
GATGTAACGAACCACC-1_V12N28-333_D1,2,0,0,1,0,3
AGCCGTGGCTAAATGT-1_V12N28-333_D1,3,1,0,1,0,5
CTCCCTCCTTTCGATC-1_V12N28-333_D1,2,0,2,0,0,4
TTGGAAGAATACAGTC-1_V12N28-333_D1,4,0,2,0,0,6
AGTTAAGTCAACCGCT-1_V12N28-333_D1,4,0,0,0,0,4
CTCATGGTAATTTGCG-1_V12N28-333_D1,2,0,0,2,0,4
AAAGTAGCATTGCTCA-1_V12N28-333_D1,4,0,0,2,0,6
TTGTGGTAGGAGGGAT-1_V12N28-333_D1,6,0,0,2,0,8
AGTCGTGGGCATTACG-1_V12N28-333_D1,5,0,0,1,0,6
ACCTAAGTACCTTTCA-1_V12N28-333_D1,1,1,0,1,0,3
GTAGAGGGAGACAAGT-1_V12N28-333_D1,1,1,0,3,0,5
GATCCTCGACACTGGC-1_V12N28-333_D1,5,0,0,0,0,5
CCTACATTCACAGACG-1_V12N28-333_D1,3,0,0,0,0,3
TTGACCGTGTTAATGA-1_V12N28-333_D1,3,0,0,0,0,3
TCTGTTACCCAGCATA-1_V12N28-333_D1,4,0,0,1,0,5
CTAACTGGTCCGGTTC-1_V12N28-333_D1,3,0,0,1,0,4
AGCGACAGGAACGGTC-1_V12N28-333_D1,3,0,2,1,0,6
TAATAGAACAGAGTTA-1_V12N28-333_D1,3,0,1,0,0,4
ACAGGTGGAGGTGAGG-1_V12N28-333_D1,2,0,0,0,0,2
TGCGAGAATATTACCC-1_V12N28-333_D1,5,0,0,0,0,5
TTGCGTCGGCCAACCG-1_V12N28-333_D1,2,0,0,0,0,2
AGGCTTCCCGAAGAAG-1_V12N28-333_D1,3,0,1,0,0,4
GCGGACCGCGTTGTGG-1_V12N28-333_D1,2,0,3,1,0,6
GTAATCTGATTCTTCG-1_V12N28-333_D1,6,0,0,0,0,6
CCGCGGAATGCGTCAC-1_V12N28-333_D1,2,0,0,0,0,2
TTCCACACAGATTTGA-1_V12N28-333_D1,5,0,1,0,0,6
CTTCTATTAATGCTAG-1_V12N28-333_D1,6,0,0,0,0,6
CATTTGAGTGGTACGT-1_V12N28-333_D1,4,0,0,0,0,4
TCACAGCAAACTCGAA-1_V12N28-333_D1,3,0,0,1,0,4
CAGACGAACCTGATAC-1_V12N28-333_D1,6,0,1,2,0,9
TAGCTAGAAGGCATGA-1_V12N28-333_D1,4,0,0,0,0,4
ATCCAGAGCAACAACC-1_V12N28-333_D1,5,0,1,0,0,6
TCCGGTTCGTCCGGTC-1_V12N28-333_D1,5,0,0,0,0,5
CGCGCATGTTTGATTG-1_V12N28-333_D1,6,0,0,0,0,6
TGGCGATCAAGTTATG-1_V12N28-333_D1,3,0,0,0,0,3
CCCTTTGACAGGTCTT-1_V12N28-333_D1,3,0,0,0,0,3
CAGAGACGGTCACCCA-1_V12N28-333_D1,1,0,1,0,0,2
TAGCTCGCCTGATAAC-1_V12N28-333_D1,3,0,2,0,0,5
TTGTGTTTCCCGAAAG-1_V12N28-333_D1,2,0,0,0,0,2
TATACACAGACGCCTT-1_V12N28-333_D1,6,0,0,0,0,6
ACATTAGTTTATATCC-1_V12N28-333_D1,8,0,0,0,0,8
CCATCGCAGTTAAACT-1_V12N28-333_D1,3,0,0,0,0,3
AATTAGCGCTGCAGCG-1_V12N28-333_D1,1,0,1,0,0,2
TCCGCTTATCCCATTA-1_V12N28-333_D1,2,0,2,0,0,4
GTTTGGGCTTGTGAGC-1_V12N28-333_D1,3,1,0,0,0,4
CTTGTCAACATTCGAG-1_V12N28-333_D1,1,0,2,0,0,3
GGACCAACAGGATAAC-1_V12N28-333_D1,3,0,2,1,0,6
AAGCTAGATCGAGTAA-1_V12N28-333_D1,0,1,1,0,0,2
TACCGTGCCTCGGACC-1_V12N28-333_D1,0,0,0,0,0,0
GTAGCCAAACATGGGA-1_V12N28-333_D1,1,1,0,0,0,2
TGCCAGTACGTGGAGA-1_V12N28-333_D1,1,1,1,0,0,3
ATAAGGTGGAGAACAT-1_V12N28-333_D1,2,3,0,0,0,5
CTTTAATATTGGTCGA-1_V12N28-333_D1,1,1,0,0,0,2
TGGTTCAACGGGTAAT-1_V12N28-333_D1,2,0,2,0,0,4
GCTGCTACTGCGTAGC-1_V12N28-333_D1,2,0,0,0,1,3
CTGCACAACTACATAT-1_V12N28-333_D1,2,1,1,1,0,5
ATATTCCACATAGTGA-1_V12N28-333_D1,0,1,0,0,0,1
TGGCAAACTAAATTAC-1_V12N28-333_D1,0,1,0,0,0,1
ACCGCAATAACTGCCT-1_V12N28-333_D1,0,3,2,0,0,5
TCGCACCAGGAGGCAG-1_V12N28-333_D1,0,0,0,0,0,0
ACTTCAGGCTGATCCC-1_V12N28-333_D1,0,0,0,0,0,0
ACAAATCGCACCGAAT-1_V12N28-333_D1,0,0,2,0,3,5
TCTGATGTATTCTGTC-1_V12N28-333_D1,1,0,0,0,0,1
CTTTACCGAATAGTAG-1_V12N28-333_D1,0,1,1,0,1,3
GCAGATCCATAAGACT-1_V12N28-333_D1,1,0,4,0,0,5
TTCCTCGGACTAACCA-1_V12N28-333_D1,0,0,1,0,0,1
TTATCCGGGATCTATA-1_V12N28-333_D1,0,1,0,0,1,2
CTGGAAGACACGGTGG-1_V12N28-333_D1,1,0,0,0,1,2
GTTCGTCTAAAGAACT-1_V12N28-333_D1,1,1,1,0,0,3
GTCTATTGGTTCCGGT-1_V12N28-333_D1,2,0,0,0,1,3
CTAGGCGCCCTATCAG-1_V12N28-333_D1,1,0,0,0,1,2
AACGGACGTACGTATA-1_V12N28-333_D1,0,0,0,0,0,0
AACACACGCTCGCCGC-1_V12N28-333_D1,1,0,0,1,4,6
GCTACTATAGTAGAGT-1_V12N28-333_D1,0,1,3,0,0,4
AGCATATCAATATGCT-1_V12N28-333_D1,1,0,0,1,0,2
CGAACAGTATGGGCGT-1_V12N28-333_D1,3,0,0,0,0,3
ACAATTGTGTCTCTTT-1_V12N28-333_D1,0,0,0,0,0,0
GATCGCTACCCGATTT-1_V12N28-333_D1,2,0,0,0,0,2
ATTGCGATCAGTAACT-1_V12N28-333_D1,3,0,0,0,0,3
CAGCAGTCCAGACTAT-1_V12N28-333_D1,0,1,1,0,0,2
AGAGGCTTCGGAAACC-1_V12N28-333_D1,3,1,0,0,0,4
AAACAAGTATCTCCCA-1_V12N28-333_D1,5,0,0,0,0,5
GGCAGCAAACCTATGC-1_V12N28-333_D1,1,0,0,0,0,1
ACTAGTTGCGATCGTC-1_V12N28-333_D1,1,0,1,0,0,2
TTGGACCATCTGGCAA-1_V12N28-333_D1,0,0,0,0,2,2
CCCTCCTCGCTCGTAT-1_V12N28-333_D1,2,0,0,0,0,2
GAGCGCAAATACTCCG-1_V12N28-333_D1,1,0,2,0,1,4
ATTACATGTCAGTCTT-1_V12N28-333_D1,4,0,0,0,0,4
TTGGGACGTAAGAGTT-1_V12N28-333_D1,0,0,0,0,0,0
CTTCGGCCAATTGTTT-1_V12N28-333_D1,1,0,0,0,0,1
AGACCGCTCCGCGGTT-1_V12N28-333_D1,0,0,0,0,3,3
GACCGCGTCTGACGTG-1_V12N28-333_D1,1,1,0,0,0,2
CCAAATAACAAGATTC-1_V12N28-333_D1,0,0,0,0,0,0
TCTTTAGAGTCTAACA-1_V12N28-333_D1,1,0,0,0,0,1
CTCCCAATGAGTCGCG-1_V12N28-333_D1,3,0,0,0,0,3
TAGTCTTTCCGAATTG-1_V12N28-333_D1,4,1,4,0,0,9
GAGTAAACCGGAAAGT-1_V12N28-333_D1,1,0,0,0,1,2
GATCTCGACGCTGTGG-1_V12N28-333_D1,1,0,1,0,0,2
CTGACATAGAAATAGA-1_V12N28-333_D1,0,0,0,0,0,0
TATACCGAGTGCCACA-1_V12N28-333_D1,3,0,0,0,0,3
TCCGAACGTTGCCGCT-1_V12N28-333_D1,0,0,0,0,0,0
GCAGAAGGTAATCTCC-1_V12N28-333_D1,3,1,0,0,0,4
GGTACTAAGTGCTTTG-1_V12N28-333_D1,0,0,0,0,0,0
CAGAATATTCGTTATC-1_V12N28-333_D1,0,0,0,0,1,1
TAATCAACCAAATGGG-1_V12N28-333_D1,1,0,0,0,1,2
TCTGCTTAGAACAAGC-1_V12N28-333_D1,0,0,0,0,1,1
AACTGAGTTATACTGA-1_V12N28-333_D1,0,0,0,0,0,0
CCTCAACGATCGCTGT-1_V12N28-333_D1,2,0,0,2,0,4
CGGTACGGCAAACCCA-1_V12N28-333_D1,3,0,0,0,0,3
CAGATGTTTGTCCCAA-1_V12N28-333_D1,3,0,0,2,0,5
GTTTGTTAGCCAAGTA-1_V12N28-333_D1,4,1,0,3,0,8
ACGTGACAAAGTAAGT-1_V12N28-333_D1,3,1,0,0,0,4
TTGTCACCGCGGTATC-1_V12N28-333_D1,3,0,0,2,0,5
GATCTAACCGTATTCA-1_V12N28-333_D1,3,1,0,1,0,5
ATGGAAATTTAAGGAG-1_V12N28-333_D1,3,1,0,0,0,4
ATTGATCACCACATTT-1_V12N28-333_D1,2,0,0,1,0,3
ACTGCTCGGAAGGATG-1_V12N28-333_D1,2,0,0,1,0,3
TCTAAAGAACAGTCTC-1_V12N28-333_D1,3,0,0,1,0,4
CTGGGTTGAGTTAAAG-1_V12N28-333_D1,2,0,0,1,0,3
CCCAGTAAACTTGGGA-1_V12N28-333_D1,3,0,0,0,0,3
AGATTCACAACCGATA-1_V12N28-333_D1,2,0,0,3,0,5
AGAAGGTACACTTCAC-1_V12N28-333_D1,3,0,0,1,0,4
GCAGGAACTTAGATCT-1_V12N28-333_D1,3,0,0,3,0,6
AATCTAGGTTTACTTG-1_V12N28-333_D1,4,1,0,0,0,5
CCCGGTGTATCGGAAT-1_V12N28-333_D1,5,0,1,1,0,7
TTATCCTCAAGGAATA-1_V12N28-333_D1,4,0,1,2,0,7
AGCATCATTTCGAAAG-1_V12N28-333_D1,3,0,0,1,0,4
CGCGAGTCTGCCGGGT-1_V12N28-333_D1,4,0,0,1,0,5
TGCGTCATGACTGAGC-1_V12N28-333_D1,4,0,0,2,0,6
GTATGAAATTTCACTC-1_V12N28-333_D1,4,0,0,1,0,5
TTGGTTGCGGTGCGCG-1_V12N28-333_D1,1,0,0,3,0,4
ACAGAACTGAGAACAA-1_V12N28-333_D1,4,0,0,1,0,5
CTACTATCATAGGTTT-1_V12N28-333_D1,1,0,0,3,0,4
CCTCTATCGATTAGCA-1_V12N28-333_D1,4,0,1,1,0,6
CCGTATCTCGTCGTAG-1_V12N28-333_D1,0,0,0,2,0,2
TCACGATGTCCGTGGA-1_V12N28-333_D1,3,0,0,0,0,3
TCAACAAAGATAATTC-1_V12N28-333_D1,5,0,0,0,0,5
ATGACGCGTTCTATCC-1_V12N28-333_D1,4,0,0,0,0,4
ATTTGCGCGAGTAGCT-1_V12N28-333_D1,6,0,0,0,0,6
TTCTTGGACGATCTGC-1_V12N28-333_D1,6,0,0,2,0,8
AGACGACGATGCCGCT-1_V12N28-333_D1,3,1,0,0,0,4
GGTCTCTGAATGGACT-1_V12N28-333_D1,6,0,0,0,0,6
GCTCAATCCGTTTATT-1_V12N28-333_D1,3,0,0,1,0,4
CCAGAAAGCAACTCAT-1_V12N28-333_D1,4,0,0,0,0,4
CACCGTTAGGGATCAC-1_V12N28-333_D1,6,0,0,1,0,7
AATAACACTAGAACAA-1_V12N28-333_D1,4,0,0,0,0,4
CACCCGGTTTGTGACT-1_V12N28-333_D1,2,0,1,1,0,4
CCACCAACTTTACTGT-1_V12N28-333_D1,3,0,1,0,0,4
AACTCTCAGTGTGCTC-1_V12N28-333_D1,3,0,0,0,0,3
AAACCGTTCGTCCAGG-1_V12N28-333_D1,1,0,0,1,0,2
CAGCGATTCCCTTCAA-1_V12N28-333_D1,5,0,0,0,0,5
GCTAGCTTGAATAGCT-1_V12N28-333_D1,8,0,0,0,0,8
TTGCGGCATCAGAAAG-1_V12N28-333_D1,3,0,2,0,0,5
AATAGAACAGAGTGGC-1_V12N28-333_D1,6,0,0,0,0,6
GCCATCGAGCTGCGTG-1_V12N28-333_D1,1,0,0,0,0,1
ACACTGATCAAGGTGT-1_V12N28-333_D1,6,0,0,0,0,6
ACCAACGCTTATTTAT-1_V12N28-333_D1,1,0,0,1,0,2
GACATCGATTTATAAC-1_V12N28-333_D1,2,0,0,0,0,2
CAGACACCGATCGCTG-1_V12N28-333_D1,5,1,0,1,0,7
CCAAGAAAGTGGGCGA-1_V12N28-333_D1,6,0,0,0,0,6
GGTAGACCGTTGGGCG-1_V12N28-333_D1,0,0,0,0,0,0
TCGTTAGGAGTCCCTA-1_V12N28-333_D1,2,0,1,0,0,3
ACGGCCAACATGGACT-1_V12N28-333_D1,9,0,0,0,0,9
GTGAGTGGTACAACGC-1_V12N28-333_D1,2,0,0,2,0,4
GAGACTTCGCGACCGA-1_V12N28-333_D1,3,0,0,0,0,3
GAAGTCAGTTGCACTA-1_V12N28-333_D1,2,0,0,0,0,2
GTTTGGTAGGGTCAAC-1_V12N28-333_D1,6,0,0,0,0,6
ACGGCACTTGCTTGGG-1_V12N28-333_D1,1,3,1,0,0,5
CCTCTGTACTATTCTA-1_V12N28-333_D1,3,1,0,0,0,4
CTATTCATGTGTCCCA-1_V12N28-333_D1,2,1,0,1,0,4
GCCCGATCTGTGGTCG-1_V12N28-333_D1,5,0,0,0,0,5
TTAGAAGAACATGACT-1_V12N28-333_D1,3,1,2,0,0,6
AGGATAAAGTCGGGAT-1_V12N28-333_D1,1,0,0,0,0,1
CGGCAAACATCGTGCG-1_V12N28-333_D1,4,0,1,0,0,5
CTAGTTACAACCCGGT-1_V12N28-333_D1,3,0,0,2,0,5
TTCGACAGAGCCCGTG-1_V12N28-333_D1,2,3,1,0,0,6
AAGCATACTCTCCTGA-1_V12N28-333_D1,0,1,0,0,2,3
GACGACGATCCGCGTT-1_V12N28-333_D1,3,0,0,0,1,4
GGTAGAAGACCGCCTG-1_V12N28-333_D1,3,1,2,0,0,6
GAGATGGGAGTCGACA-1_V12N28-333_D1,1,1,1,0,0,3
AACGATAATGCCGTAG-1_V12N28-333_D1,0,0,1,0,0,1
TGGTCCCACGCTACGG-1_V12N28-333_D1,5,0,0,0,0,5
CTGCTTGGCGATAGCT-1_V12N28-333_D1,2,1,1,0,1,5
ATCGGAGACAGACGGC-1_V12N28-333_D1,1,0,0,0,0,1
TAGCGTCCGGTGTGGT-1_V12N28-333_D1,0,3,0,0,0,3
GTTGAGTCCCGCCGGT-1_V12N28-333_D1,1,1,2,0,1,5
AAATAGGGTGCTATTG-1_V12N28-333_D1,2,3,1,0,1,7
AAGTGTTTGGAGACGG-1_V12N28-333_D1,2,0,2,0,0,4
AGCACTACCTCACCAG-1_V12N28-333_D1,1,0,1,0,2,4
TGCCTTGGCCAGGCAA-1_V12N28-333_D1,1,0,0,0,1,2
TCGTCTTAGGCGTTAA-1_V12N28-333_D1,0,0,3,0,0,3
TTCTGACCGGGCTCAA-1_V12N28-333_D1,0,0,0,0,1,1
CAGAACTTAGCCCTCT-1_V12N28-333_D1,0,0,1,0,2,3
AGCTCCTTCGCACATC-1_V12N28-333_D1,0,4,2,0,1,7
ACAGGCTTGCCCGACT-1_V12N28-333_D1,0,3,0,0,1,4
GCTATACGTCTCGGAC-1_V12N28-333_D1,1,1,0,0,0,2
GAGCCAGCTACCTGTG-1_V12N28-333_D1,0,3,0,0,0,3
TGCTAAGTGTCTATTT-1_V12N28-333_D1,1,1,0,0,1,3
GTCCTACGAATAGTCT-1_V12N28-333_D1,0,0,0,0,2,2
CAGTGTCGGCTGGCCC-1_V12N28-333_D1,1,0,0,0,3,4
CTATCGACGAAATACA-1_V12N28-333_D1,1,1,0,0,2,4
CATCATTACCCTGAGG-1_V12N28-333_D1,2,0,0,0,0,2
TAAGTTGCGACGTAGG-1_V12N28-333_D1,2,1,0,0,0,3
AGTGCACGCTTAAGAA-1_V12N28-333_D1,0,1,0,0,0,1
TGTGCCGGTGCCGGAA-1_V12N28-333_D1,1,0,0,0,1,2
AGGAGGCCTTCGCGCG-1_V12N28-333_D1,2,0,1,0,0,3
TCCGCGGCCCAATGAA-1_V12N28-333_D1,1,1,0,0,0,2
TCCGTTAAGCTAATAT-1_V12N28-333_D1,2,0,0,0,1,3
AAATCTAGCCCTGCTA-1_V12N28-333_D1,2,1,0,0,0,3
CGCAGGCGATCCAAAC-1_V12N28-333_D1,0,0,0,0,1,1
CCATATGGAAACTATA-1_V12N28-333_D1,1,0,0,0,0,1
CACCGTATCCCATCCG-1_V12N28-333_D1,2,0,1,0,0,3
GGTCAAGACTACTTCG-1_V12N28-333_D1,1,0,0,0,0,1
CCCGTTTCGCAGATGT-1_V12N28-333_D1,0,0,0,0,0,0
GTTATAATACGGTGAA-1_V12N28-333_D1,1,0,0,0,0,1
ACTTGTGGATGGAACG-1_V12N28-333_D1,1,5,1,0,0,7
GTTCGCTGAGACGTCT-1_V12N28-333_D1,2,0,0,0,0,2
GACACTGGAACCCGAT-1_V12N28-333_D1,3,0,0,0,0,3
CCCAGGTCTGAAGGCT-1_V12N28-333_D1,0,0,0,0,0,0
TCTCGAGGAGGTTCGC-1_V12N28-333_D1,2,0,0,0,0,2
ACTATCTGCCCGCGTA-1_V12N28-333_D1,1,1,0,0,1,3
CCTAAATTGTATCCTA-1_V12N28-333_D1,3,0,0,0,2,5
AGAAATTATGACTCGC-1_V12N28-333_D1,1,0,1,0,1,3
TCCAGCGCTATAAGCG-1_V12N28-333_D1,2,0,0,0,1,3
TCGTGTATTGGTCACG-1_V12N28-333_D1,3,1,0,0,0,4
CCACATACTGCACCCA-1_V12N28-333_D1,3,0,0,0,0,3
GTTGCGGACGGTCAGG-1_V12N28-333_D1,0,0,0,0,0,0
GTATTTAATGGCATAA-1_V12N28-333_D1,0,0,0,0,0,0
GTCGATAGGTGACTTT-1_V12N28-333_D1,2,0,0,0,0,2
AATAATCTTCGTATCG-1_V12N28-333_D1,0,0,0,0,0,0
ATTGTTCAACGATCCG-1_V12N28-333_D1,0,0,0,0,0,0
GTGCAGCGTAGAGTAG-1_V12N28-333_D1,1,0,0,0,0,1
TGTGGTAGGGTGCCTT-1_V12N28-333_D1,1,0,0,0,0,1
TGTGGACTATCTACGT-1_V12N28-333_D1,1,0,0,0,1,2
GGCGGGCTCTAAGAGT-1_V12N28-333_D1,1,0,0,0,0,1
TGTGCCAGAGGCAAAG-1_V12N28-333_D1,4,2,0,1,0,7
TGGCTTATGTATAATG-1_V12N28-333_D1,3,0,0,1,0,4
GCAAGCTGGAAACCGC-1_V12N28-333_D1,4,2,0,1,0,7
GATATCAAGCAGGAGC-1_V12N28-333_D1,5,0,0,0,0,5
CACCAATCATCCGTCT-1_V12N28-333_D1,2,0,0,1,0,3
CCACATGGCTCTTTAT-1_V12N28-333_D1,4,1,0,0,0,5
GTCCTACTCTACGGGC-1_V12N28-333_D1,1,2,0,5,0,8
CTCGAGACATACGATA-1_V12N28-333_D1,1,0,0,1,0,2
TATCAGTGGCGTAGTC-1_V12N28-333_D1,1,2,0,1,0,4
TGACAGGACAAGTCCA-1_V12N28-333_D1,2,0,0,2,0,4
TATTAACACCAAAGCA-1_V12N28-333_D1,1,0,2,1,0,4
TAGGCGATGAGGTCTC-1_V12N28-333_D1,1,0,0,3,0,4
CCGCCGGAACTTCTCG-1_V12N28-333_D1,4,0,0,1,0,5
GCCATTAGCCTCAAAC-1_V12N28-333_D1,4,0,0,1,0,5
GTTAGGCTACCCGTTT-1_V12N28-333_D1,2,0,0,2,0,4
GGGTATTCTAGCAAAC-1_V12N28-333_D1,4,0,0,1,0,5
GCCCTAGCCGTCGCGA-1_V12N28-333_D1,4,2,0,2,0,8
CAGATCCTGGTTTGAA-1_V12N28-333_D1,4,2,0,1,0,7
CTTCAGTGGTCGCCTA-1_V12N28-333_D1,5,0,0,2,0,7
GGGCAACCGCACGTGC-1_V12N28-333_D1,6,1,0,2,0,9
GACCCAATTATGATAC-1_V12N28-333_D1,3,0,0,0,0,3
GAAGCTCGGACCCGTC-1_V12N28-333_D1,2,0,0,0,0,2
CGTCGGGTCTAAGCGC-1_V12N28-333_D1,5,0,0,3,0,8
GAGGCCCGACTCCGCA-1_V12N28-333_D1,5,0,0,2,0,7
TTGCCATAGCCCGCTC-1_V12N28-333_D1,3,0,0,1,0,4
TAACATACACGCGATC-1_V12N28-333_D1,1,0,0,4,0,5
CCGACGGGCATGAGGT-1_V12N28-333_D1,3,0,1,1,0,5
AATGTGCCCGAGGTGT-1_V12N28-333_D1,3,0,0,0,0,3
AGCTGTAACCTCAATC-1_V12N28-333_D1,5,0,0,1,0,6
CGAGTGAAGGTACCAG-1_V12N28-333_D1,2,0,0,0,0,2
AGTCTCACAAGACTAC-1_V12N28-333_D1,2,0,0,3,0,5
AAATTGATAGTCCTTT-1_V12N28-333_D1,4,0,0,0,0,4
TAAGTCGCCGAGTATC-1_V12N28-333_D1,7,0,0,0,0,7
GCGGAGAAACTTCGCA-1_V12N28-333_D1,4,0,0,0,0,4
GGCAAAGGCGCCAATA-1_V12N28-333_D1,1,0,0,2,0,3
ATTTCCGGGTTCTGCG-1_V12N28-333_D1,2,0,0,0,0,2
TAAACCCAGGAGGGCA-1_V12N28-333_D1,3,0,0,1,0,4
TTCGGGCGCTAGTCTT-1_V12N28-333_D1,3,0,0,0,0,3
GTGGAGTCGGCGGTTG-1_V12N28-333_D1,3,0,1,0,0,4
GCACGCCTACTTAGAT-1_V12N28-333_D1,1,0,0,2,0,3
CAATATTCTTGACCTA-1_V12N28-333_D1,2,0,0,0,0,2
CGTTTGTGTAGAGGGT-1_V12N28-333_D1,1,0,2,2,0,5
CATAGCGTTGCCCACC-1_V12N28-333_D1,1,0,0,1,0,2
TGATACATTTAGCCGT-1_V12N28-333_D1,2,0,0,1,0,3
TTCCGGCCTTGAGGCT-1_V12N28-333_D1,5,0,0,1,0,6
CCTATACCGTCCTGTC-1_V12N28-333_D1,5,0,0,0,0,5
TCGTTGCTATCCGGTC-1_V12N28-333_D1,3,0,0,1,0,4
TGGCGACTGCTCCAAA-1_V12N28-333_D1,3,1,0,0,0,4
CAGAGGCGATGCATGA-1_V12N28-333_D1,6,0,0,1,0,7
TCACAGGAGAATAAGA-1_V12N28-333_D1,3,0,0,0,0,3
GGGTTAACATTTGAGT-1_V12N28-333_D1,7,0,0,0,0,7
GCGGGCGAGCCTTACC-1_V12N28-333_D1,7,0,0,0,0,7
TGCCAATGGGTACTCT-1_V12N28-333_D1,7,0,0,0,0,7
AGGGACTCTACGCGAC-1_V12N28-333_D1,4,0,0,0,0,4
GACGCCGTAAAGGCTA-1_V12N28-333_D1,3,0,0,0,0,3
AAAGGCTCTCGCGCCG-1_V12N28-333_D1,5,0,0,0,0,5
CTGGCTGGTTGTCAGT-1_V12N28-333_D1,2,0,0,0,0,2
ACATCCCGGCCATACG-1_V12N28-333_D1,2,0,0,2,0,4
CTCTTGTCCCGCTTGG-1_V12N28-333_D1,5,1,0,0,0,6
TACGCCTCCATTCCGA-1_V12N28-333_D1,7,0,0,0,0,7
CGGAGCAATTTAATCG-1_V12N28-333_D1,4,0,0,1,0,5
AACTAGGCTTGGGTGT-1_V12N28-333_D1,5,0,0,0,0,5
GCGTCGCCAGGGTGAT-1_V12N28-333_D1,5,0,0,1,0,6
GTTGGTCATGCTATCC-1_V12N28-333_D1,4,0,0,0,0,4
GCTGGCGGCGCATGCT-1_V12N28-333_D1,3,2,0,0,0,5
TGAGCGGAAAGTGTTC-1_V12N28-333_D1,4,1,0,1,0,6
CTTTCTGTGCGGGCTT-1_V12N28-333_D1,4,3,1,0,0,8
ATCTAATATCCTACGG-1_V12N28-333_D1,3,2,0,0,0,5
AACCTTTAAATACGGT-1_V12N28-333_D1,3,0,0,0,0,3
TTCACTCGAGCACCTA-1_V12N28-333_D1,2,1,0,0,0,3
CTGCACTCCAGTACAG-1_V12N28-333_D1,4,0,0,0,0,4
CCATTTCTACCTATTA-1_V12N28-333_D1,2,2,0,0,0,4
CAAGCGGCACATAATT-1_V12N28-333_D1,3,0,0,0,0,3
GTTAACATCACTTAAA-1_V12N28-333_D1,1,2,0,0,0,3
ATATAAATGTAGCTGC-1_V12N28-333_D1,3,1,0,0,0,4
GCCTCTATACATAGCA-1_V12N28-333_D1,3,0,1,0,0,4
GTGTCGTATAGCGTTC-1_V12N28-333_D1,1,0,1,0,0,2
ATACGTACTTAGCCAC-1_V12N28-333_D1,0,2,1,1,1,5
GCTATCATACTCATGG-1_V12N28-333_D1,0,1,0,0,1,2
TATCCAATTGGTTATC-1_V12N28-333_D1,1,3,0,0,0,4
TCTCCCTGGGCAGCGT-1_V12N28-333_D1,1,0,2,0,0,3
CCTATAATGAGTGCCC-1_V12N28-333_D1,1,0,2,0,0,3
CAATGCGAGAAGTATC-1_V12N28-333_D1,2,3,0,0,0,5
TACCAATAAAGTACCA-1_V12N28-333_D1,0,3,0,0,0,3
GCTAGGCACCACGGAG-1_V12N28-333_D1,1,0,1,0,1,3
GGTGGACTGCTCTGGC-1_V12N28-333_D1,0,0,0,0,1,1
TATTCCGAGCTGTTAT-1_V12N28-333_D1,0,3,2,0,0,5
TTGAGAAGTTTAGCAT-1_V12N28-333_D1,1,1,1,0,0,3
GTCCGGACCTGAAATT-1_V12N28-333_D1,1,0,0,0,1,2
CTGTGGTCGGGAGATA-1_V12N28-333_D1,0,0,0,0,0,0
CATGTAAGAGACATTT-1_V12N28-333_D1,2,0,0,0,0,2
CACGTTTCGTACACAC-1_V12N28-333_D1,2,1,2,0,0,5
CATCCTCTCAAAGATC-1_V12N28-333_D1,1,3,3,0,0,7
GATTAACCGAAAGCCC-1_V12N28-333_D1,0,0,0,0,2,2
AACGCTGTTGCTGAAA-1_V12N28-333_D1,0,0,0,0,1,1
TTCAGCTGGCGTGCCC-1_V12N28-333_D1,0,0,0,0,1,1
TAGAGGTTCTACTTGT-1_V12N28-333_D1,1,0,0,0,0,1
GTATCAAACGTTAGCT-1_V12N28-333_D1,2,2,0,0,1,5
AATCATGTAAAGACTC-1_V12N28-333_D1,2,0,0,0,0,2
AGTCACTAGCTCTCGA-1_V12N28-333_D1,0,0,0,0,0,0
GCGAAACGATCGGGAG-1_V12N28-333_D1,0,0,1,0,1,2
CATGGATTGTCTTCCG-1_V12N28-333_D1,3,3,0,0,0,6
ATTGGATTACAGCGTA-1_V12N28-333_D1,2,2,0,0,0,4
CACACACGCTAACGAG-1_V12N28-333_D1,2,0,0,0,1,3
CTATGGGAAGCGGAAT-1_V12N28-333_D1,0,0,0,0,0,0
TGCCTAATTGAAGATT-1_V12N28-333_D1,0,1,0,0,0,1
TGGCAATGGGACGGCG-1_V12N28-333_D1,2,0,0,0,0,2
ACCTCCGCCCTCGCTG-1_V12N28-333_D1,0,0,0,0,0,0
CGGCAATAAGATCGCC-1_V12N28-333_D1,1,0,0,0,0,1
CCTTGACCACTTTATT-1_V12N28-333_D1,1,1,0,0,0,2
TCATTTAGAAGTGTGA-1_V12N28-333_D1,0,0,0,0,0,0
CAGAATAACACACGGA-1_V12N28-333_D1,2,1,0,0,0,3
TCTGAGCAATTGACTG-1_V12N28-333_D1,0,0,0,0,0,0
CAACGTGGTGGAGTCT-1_V12N28-333_D1,1,0,0,0,0,1
CACAGTTCGCTTCCCA-1_V12N28-333_D1,0,1,0,0,2,3
TCTCTCGCCGCACATA-1_V12N28-333_D1,0,0,0,0,0,0
TGGGCAGGCCACCGCA-1_V12N28-333_D1,0,0,0,0,2,2
CTCCTGTTCAAGGCAG-1_V12N28-333_D1,1,0,0,0,0,1
TATTTGATTTGCACAG-1_V12N28-333_D1,1,0,0,0,0,1
GCCACTCCTTACGGTA-1_V12N28-333_D1,2,0,0,0,0,2
ACCGATATTTAATCAT-1_V12N28-333_D1,3,1,0,0,0,4
TTATTATCTGGAAGGC-1_V12N28-333_D1,0,0,0,0,0,0
TACATGCCGGAATTGT-1_V12N28-333_D1,6,0,0,0,0,6
GGCACTCAGCCGACCC-1_V12N28-333_D1,0,1,0,0,1,2
AAACCGGAAATGTTAA-1_V12N28-333_D1,4,0,0,0,0,4
AGACAGGCATCTCAGC-1_V12N28-333_D1,0,0,0,0,1,1
GTGGTGATGGTTTGTG-1_V12N28-333_D1,5,0,0,0,0,5
CCGATATGACGTAAGG-1_V12N28-333_D1,1,0,0,0,0,1
CATACACAAAGTCAGC-1_V12N28-333_D1,3,2,0,1,0,6
TCGAGTCTACGATTCG-1_V12N28-333_D1,3,1,0,2,0,6
ACTTCCAGTGGAAGCT-1_V12N28-333_D1,0,1,2,0,0,3
CAATTGGGCCGCACTC-1_V12N28-333_D1,6,0,0,0,0,6
AAATCGCGGAAGGAGT-1_V12N28-333_D1,0,0,0,1,0,1
ATATCAATTCCAGCCT-1_V12N28-333_D1,4,1,0,1,0,6
CTTTGTCGAATGCTCC-1_V12N28-333_D1,3,0,0,0,0,3
TGAGGCATGTACTGTG-1_V12N28-333_D1,2,1,0,1,0,4
TTCGCCGCTCGCGCTA-1_V12N28-333_D1,4,2,0,1,0,7
GACTCCTTCCAATTGA-1_V12N28-333_D1,2,0,0,0,0,2
ACCGAAGAGTCTGGTT-1_V12N28-333_D1,2,0,0,4,0,6
TGGCATGAAGTTTGGG-1_V12N28-333_D1,4,0,0,1,0,5
ACGAGGTTTACAACGT-1_V12N28-333_D1,4,0,0,2,0,6
AACCCATCCCATGATC-1_V12N28-333_D1,2,0,0,4,0,6
TCGACAACTGAACCCG-1_V12N28-333_D1,3,0,1,2,0,6
TATCTTGCAATACAAC-1_V12N28-333_D1,5,0,0,0,0,5
TATTATGTTTGCCTGC-1_V12N28-333_D1,3,0,0,0,0,3
GTCAAAGAAGTGGTGT-1_V12N28-333_D1,2,0,0,0,0,2
GGGACAGAGTTACTCC-1_V12N28-333_D1,4,1,0,1,0,6
AGCAACCGAAAGTAAT-1_V12N28-333_D1,1,0,0,2,0,3
CTCTCTAACTGCCTAG-1_V12N28-333_D1,5,0,0,1,0,6
ATACGGAACGTCGTTT-1_V12N28-333_D1,1,0,0,0,0,1
TCGGTCCCGACAATAG-1_V12N28-333_D1,4,0,0,0,0,4
CGCGCAAATGTCCAGA-1_V12N28-333_D1,3,0,1,0,0,4
TCTAATACTGCCTCAG-1_V12N28-333_D1,5,0,0,0,0,5
CTCGGTTGTCGGCCCT-1_V12N28-333_D1,4,0,0,2,0,6
GGTAACCGGGAGGATA-1_V12N28-333_D1,3,1,1,1,0,6
CAGGCGCACGGTGGTC-1_V12N28-333_D1,2,0,1,0,0,3
TCATCGATGGTCCCAA-1_V12N28-333_D1,3,0,0,0,0,3
CAAAGATTATTGGGCC-1_V12N28-333_D1,4,0,0,1,0,5
ACAATGAATACGGAGA-1_V12N28-333_D1,4,0,1,0,0,5
GCTCCTGACATACTGG-1_V12N28-333_D1,4,0,0,2,0,6
GATGACAAGTAGGGCA-1_V12N28-333_D1,3,0,1,0,0,4
TACGCCGAGGGTACCC-1_V12N28-333_D1,5,0,0,0,0,5
AAGCGTCCCTCATCGA-1_V12N28-333_D1,4,0,0,1,0,5
CACTCCTATGTAAGAT-1_V12N28-333_D1,5,0,0,0,0,5
TCGAGCCAGGCAGGCC-1_V12N28-333_D1,4,0,0,0,0,4
TCGTCAAGTACGCGCA-1_V12N28-333_D1,4,0,0,0,0,4
CCCGTAGCTGGGAAGA-1_V12N28-333_D1,6,0,0,0,0,6
ACCCTATGCCATATCG-1_V12N28-333_D1,5,0,0,1,0,6
GTGGTATAGTCTGCCG-1_V12N28-333_D1,4,0,0,0,0,4
CCGGTTTGTAATTGTG-1_V12N28-333_D1,5,0,0,0,0,5
GTCGCCGTTGTGTGTT-1_V12N28-333_D1,2,0,0,1,0,3
TACTGAACAGATTTAG-1_V12N28-333_D1,4,0,0,0,0,4
TATTAACCTGACCGCG-1_V12N28-333_D1,8,0,0,2,0,10
CTGTAGCCATCTCACT-1_V12N28-333_D1,4,0,0,1,0,5
TACTATGGTTCCTCAG-1_V12N28-333_D1,4,0,0,0,0,4
GAGTCAGACCAGAATC-1_V12N28-333_D1,3,0,0,1,1,5
TAAGGCATAACATCAA-1_V12N28-333_D1,4,0,0,1,1,6
CTTCCGCTCCGTGAAG-1_V12N28-333_D1,2,0,0,1,0,3
GGGCTATGATCGATGG-1_V12N28-333_D1,4,0,0,0,0,4
GGTCGGTCGTCCACAG-1_V12N28-333_D1,4,0,0,1,0,5
GGGACCCGTATATCTT-1_V12N28-333_D1,4,0,0,0,0,4
GAAAGCAGTGCACTTT-1_V12N28-333_D1,2,0,1,1,0,4
AGCGCATAATGAATCG-1_V12N28-333_D1,3,0,0,0,0,3
GCTGCTAAGTAGTCGA-1_V12N28-333_D1,3,1,1,2,0,7
AATAGTCCGTCCCGAC-1_V12N28-333_D1,2,2,0,0,0,4
AGCAGCCAGATGAATA-1_V12N28-333_D1,6,0,0,0,0,6
CCTCGCGCTGTGCGAT-1_V12N28-333_D1,4,0,0,1,0,5
TTGTGTATGCCACCAA-1_V12N28-333_D1,4,1,0,0,0,5
TGCTCGGCGAAACCCA-1_V12N28-333_D1,1,0,2,0,0,3
CGATTAAATATCTCCT-1_V12N28-333_D1,0,0,0,0,0,0
TGCCGTGGATCGTCCT-1_V12N28-333_D1,0,0,0,3,0,3
GTGGACGCATTTGTCC-1_V12N28-333_D1,5,0,0,1,0,6
ACCCGGAAACTCCCAG-1_V12N28-333_D1,4,0,1,0,0,5
CCGCATGTGGTACGAT-1_V12N28-333_D1,7,2,0,0,0,9
GCAAACCTTGGCCATA-1_V12N28-333_D1,6,1,1,1,0,9
ATTCACTGATGTTGGA-1_V12N28-333_D1,2,0,0,2,0,4
ACTCCCTAATGCTAAA-1_V12N28-333_D1,4,2,1,0,0,7
TCCTAAATTGGGAAGC-1_V12N28-333_D1,1,1,1,0,2,5
GAACAGATTACTAAAT-1_V12N28-333_D1,3,0,0,0,1,4
ATACAGGCCCTCCAAT-1_V12N28-333_D1,0,0,0,0,0,0
CGATTCGCCTGGCTGC-1_V12N28-333_D1,1,3,1,0,0,5
TCCGCCTGTCTACAAG-1_V12N28-333_D1,3,0,3,0,1,7
CACATCTCACCGACGA-1_V12N28-333_D1,1,1,0,0,0,2
CGTCGTCCTTCGCGAA-1_V12N28-333_D1,1,1,0,1,0,3
CGTTGAATACCGCGCT-1_V12N28-333_D1,0,1,0,0,2,3
ACCAATATGCAAGTTA-1_V12N28-333_D1,1,1,0,0,0,2
ACGGATGGTGCGGATA-1_V12N28-333_D1,2,0,0,0,0,2
CACCCTAACAAGATCT-1_V12N28-333_D1,0,1,2,0,0,3
AAGCTCTTTCATGGTG-1_V12N28-333_D1,0,0,0,0,0,0
CATGGGTATGCCTTAT-1_V12N28-333_D1,1,1,0,0,0,2
GCGCGTCATTGGTACA-1_V12N28-333_D1,0,0,2,0,0,2
TCTGAAGCACGTGGTC-1_V12N28-333_D1,2,0,0,0,0,2
AAGTTCACTCCAAGCT-1_V12N28-333_D1,0,0,1,0,0,1
TTGGACCTATAACAGT-1_V12N28-333_D1,2,1,0,0,0,3
ATCAGCCTCATGCTGC-1_V12N28-333_D1,0,0,0,0,0,0
AGTACTCTTATGCCCA-1_V12N28-333_D1,1,1,0,0,1,3
GCGCTTAAATAATTGG-1_V12N28-333_D1,0,0,0,0,1,1
TTGTGAACCTAATCCG-1_V12N28-333_D1,0,0,3,0,0,3
AGTCGTCGACCACCAA-1_V12N28-333_D1,1,0,0,0,0,1
TCCTTTAAATCCGCTT-1_V12N28-333_D1,2,0,0,0,0,2
ACTGAAACGCCGTTAG-1_V12N28-333_D1,1,1,0,0,0,2
GCACACACTGGTAGCC-1_V12N28-333_D1,3,0,0,0,1,4
TAAGGGCCTGTCCGAT-1_V12N28-333_D1,1,0,0,0,0,1
GCTAGAGTAGAGATGT-1_V12N28-333_D1,0,2,3,0,0,5
CACAGGGCCATATAGT-1_V12N28-333_D1,1,3,0,0,0,4
CCATGCCCTAGATTTC-1_V12N28-333_D1,1,0,0,0,0,1
TCGCGTAGCAGTGTCC-1_V12N28-333_D1,1,2,1,0,0,4
GACGAGGCTAATAAAC-1_V12N28-333_D1,1,0,0,0,0,1
CTACACTCGCAGATGG-1_V12N28-333_D1,2,0,0,0,0,2
ACGCATACGTTTACTA-1_V12N28-333_D1,1,0,0,0,0,1
GGAGCAACATTTCAAG-1_V12N28-333_D1,0,0,0,0,0,0
CGAGAGGGTAGCCGCG-1_V12N28-333_D1,1,0,0,0,0,1
TCGTGTTCGACCACAA-1_V12N28-333_D1,0,0,0,0,0,0
TCTACCCAATAGAGAG-1_V12N28-333_D1,1,0,0,0,0,1
ATAAACGTTGCACCAC-1_V12N28-333_D1,0,0,1,0,0,1
TCAACTGCAGAGTCAG-1_V12N28-333_D1,0,0,0,0,0,0
AGCTCCATATATGTTC-1_V12N28-333_D1,1,1,0,0,1,3
GTAACATCTAAGATAA-1_V12N28-333_D1,3,0,0,0,0,3
CCGACAATAGGCCGCC-1_V12N28-333_D1,1,0,0,0,1,2
ATGCTTAGGAGTTGAT-1_V12N28-333_D1,2,0,0,0,0,2
AACCCGAGCAGAATCG-1_V12N28-333_D1,1,0,0,0,2,3
CGGGTTTGTTAGGGCT-1_V12N28-333_D1,3,0,0,0,0,3
AGGCACGTGACTGTCC-1_V12N28-333_D1,1,0,0,0,0,1
GACAAGAGATGAGATT-1_V12N28-333_D1,1,0,0,0,0,1
AGCCCTTGGACATCCC-1_V12N28-333_D1,1,0,0,0,0,1
GCAGTTCGATCCGAGC-1_V12N28-333_D1,0,1,0,0,0,1
TCGAGGGCAACAGACG-1_V12N28-333_D1,3,1,0,0,0,4
ACTTTGTCGACGCACT-1_V12N28-333_D1,0,0,0,0,0,0
GAGTATCAAAGTTACA-1_V12N28-333_D1,2,0,3,0,0,5
CCAGGCTGGCGTCTGA-1_V12N28-333_D1,0,0,0,0,1,1
GGACTCTTCCGGTTGA-1_V12N28-333_D1,3,0,1,0,0,4
TCCCAGCACACGACAT-1_V12N28-333_D1,0,0,1,0,0,1
GCTCCATGAGTGCAGA-1_V12N28-333_D1,0,2,0,0,0,2
GCAGTGCGGGCGGATG-1_V12N28-333_D1,9,0,0,0,0,9
GCGTTCTGACTAAGCG-1_V12N28-333_D1,0,0,0,0,0,0
CCTTTGAATTATGGCT-1_V12N28-333_D1,2,0,0,1,0,3
AACGAAAGTCGTCCCA-1_V12N28-333_D1,6,0,0,2,0,8
GCACAACCTCGGGCGT-1_V12N28-333_D1,2,0,0,0,0,2
ATGCACGCGCTGTTCA-1_V12N28-333_D1,1,0,0,1,0,2
CGATGTTGTTATCTAC-1_V12N28-333_D1,4,2,0,2,0,8
GTCTCCTGCCAGTATG-1_V12N28-333_D1,6,0,1,0,0,7
GATGCCTTCTGCGGCA-1_V12N28-333_D1,3,1,0,0,0,4
ACCGGTCAGGTACACC-1_V12N28-333_D1,4,0,0,0,0,4
GTGGAGCGTTTACCGA-1_V12N28-333_D1,3,0,0,0,0,3
AGGCGGTTTGTCCCGC-1_V12N28-333_D1,2,0,1,0,0,3
TCCCTGGCGTATTAAC-1_V12N28-333_D1,3,0,0,1,0,4
AAACACCAATAACTGC-1_V12N28-333_D1,4,0,0,0,0,4
TGGACGCAATCCAGCC-1_V12N28-333_D1,4,2,0,1,0,7
GGAACCTTGACTCTGC-1_V12N28-333_D1,5,0,1,0,0,6
GTATCTCAGTCTTGAC-1_V12N28-333_D1,4,0,0,0,0,4
GCTGAATCTTCCAATC-1_V12N28-333_D1,3,0,0,0,0,3
AGATGCAAGACGTGCA-1_V12N28-333_D1,4,0,0,0,0,4
TTAAGGCCCGTACTTT-1_V12N28-333_D1,3,0,0,1,0,4
AGTATGCTGGAGACCA-1_V12N28-333_D1,4,0,0,0,0,4
GCGGCAAAGTATTGCC-1_V12N28-333_D1,3,0,0,0,0,3
GCGCAAATATATTCAA-1_V12N28-333_D1,3,0,1,0,0,4
GAAGAAACGATATTGT-1_V12N28-333_D1,5,0,0,1,0,6
GGACCTCTAGGCCGCC-1_V12N28-333_D1,5,0,0,1,0,6
AACAGCTGTGTGGCAA-1_V12N28-333_D1,3,0,0,0,0,3
TCGAATATCCCGCAGG-1_V12N28-333_D1,3,0,0,0,0,3
GCGACCCAACCATCTG-1_V12N28-333_D1,2,1,2,0,0,5
AGAGAAGGAGTACAAT-1_V12N28-333_D1,6,0,0,1,0,7
GGCTCCTCCACCTGTT-1_V12N28-333_D1,2,0,0,0,0,2
TCAGTGTATACGTCAT-1_V12N28-333_D1,5,1,0,1,0,7
ATTATTATGTCCGTCA-1_V12N28-333_D1,4,0,0,1,0,5
TTAGGTCATAACCGAC-1_V12N28-333_D1,3,0,1,0,0,4
AAGATGGCACCGGACC-1_V12N28-333_D1,5,0,0,0,0,5
CTACAAGAAATAACCC-1_V12N28-333_D1,3,0,0,0,0,3
ACTATTTCCGGGCCCA-1_V12N28-333_D1,5,0,0,2,0,7
TTGTTTCACATCCAGG-1_V12N28-333_D1,5,0,0,0,0,5
CGCTGTGTGGATGTTG-1_V12N28-333_D1,2,0,1,0,0,3
TCAACATAGCGCCCTA-1_V12N28-333_D1,4,1,0,0,1,6
GGCCGTTTGGGTTTCA-1_V12N28-333_D1,7,0,0,0,0,7
TACTCTTTCGTCTTCA-1_V12N28-333_D1,4,0,0,1,0,5
TTCGCGCGCCATACGA-1_V12N28-333_D1,3,0,0,0,0,3
CGGAAAGAATCAAACG-1_V12N28-333_D1,2,1,0,0,0,3
AGGCAGGGAGCGTACT-1_V12N28-333_D1,2,0,0,0,0,2
CCTTTAAGGGAGCACT-1_V12N28-333_D1,4,1,0,1,0,6
CGCCCAGCACGCCTAG-1_V12N28-333_D1,2,1,0,0,0,3
AGTATTTGGCACGACC-1_V12N28-333_D1,2,0,1,0,0,3
TATCCGCACCGTCGGG-1_V12N28-333_D1,2,0,0,1,0,3
ACCCGTGTCATCAGTA-1_V12N28-333_D1,2,1,1,0,0,4
CAACTGCTCATCCGAT-1_V12N28-333_D1,1,0,0,0,0,1
CCGGAGCGTACTTTCT-1_V12N28-333_D1,5,0,0,1,0,6
TACCGTAGGTTAACTA-1_V12N28-333_D1,3,2,0,0,0,5
TGAGGAGTGCCAGCTT-1_V12N28-333_D1,0,0,0,0,0,0
CCAGTCTTGTCATAGA-1_V12N28-333_D1,1,0,0,0,0,1
GGGCAGAGCAATCGTT-1_V12N28-333_D1,5,0,0,1,0,6
TACCAAATAGCCCAGA-1_V12N28-333_D1,3,0,0,0,0,3
TACCTACTCCCAGTAT-1_V12N28-333_D1,1,0,0,0,0,1
TGTGAGACTAGCCCAA-1_V12N28-333_D1,2,3,0,2,0,7
ATACCTAACCAAGAAA-1_V12N28-333_D1,2,0,0,3,0,5
GTCGGGAAGCAGAAAC-1_V12N28-333_D1,2,0,0,0,0,2
AATTAACGGATTTCCA-1_V12N28-333_D1,4,0,0,0,0,4
GAACCCTCTGTGTTCT-1_V12N28-333_D1,1,0,3,0,0,4
ATATAAAGCGCTCGTG-1_V12N28-333_D1,2,2,0,0,1,5
CCTGGTCGAATGTGGG-1_V12N28-333_D1,3,0,1,0,0,4
CTAGGTTCGGACGTGA-1_V12N28-333_D1,1,1,3,0,0,5
TCGGGAGACAGCGTAC-1_V12N28-333_D1,1,1,0,1,1,4
CATAAGAAGCTTGGCT-1_V12N28-333_D1,1,1,1,1,0,4
AAGCACCCTGCGTATC-1_V12N28-333_D1,2,1,0,0,0,3
AGTTTGCACCTGCCTC-1_V12N28-333_D1,2,0,2,0,0,4
GACTGCAAATCGAGCT-1_V12N28-333_D1,4,0,0,0,0,4
GTGTATATCAGCGGGC-1_V12N28-333_D1,1,0,0,0,0,1
CTTCAACTCCACTTGG-1_V12N28-333_D1,1,2,0,0,0,3
ACTTACGCATCCACGC-1_V12N28-333_D1,0,2,4,0,0,6
CATGAGATGCACTCTC-1_V12N28-333_D1,2,1,0,0,0,3
GAGCACCTGTGTCCAG-1_V12N28-333_D1,2,2,1,0,0,5
CGCGACCGCGACAGAT-1_V12N28-333_D1,1,1,4,0,1,7
GTCCCGCGACGTTATG-1_V12N28-333_D1,0,1,2,0,0,3
GCAGTGTGGCTATAGG-1_V12N28-333_D1,0,0,2,0,1,3
ATACTGCCTTACACCG-1_V12N28-333_D1,0,0,1,0,0,1
TACAGAAACGGTGGGC-1_V12N28-333_D1,0,0,0,0,1,1
GGCGCGGAGATCTTTC-1_V12N28-333_D1,2,1,0,0,0,3
CGTTAATGTCCCGACG-1_V12N28-333_D1,1,0,2,0,0,3
GCTAACTGAAGTCTGA-1_V12N28-333_D1,0,0,0,0,1,1
AGTGATAACCTGCGCG-1_V12N28-333_D1,1,2,0,0,1,4
TATGATCTTCTCTTTA-1_V12N28-333_D1,1,1,0,0,0,2
TGTACCTACACGAGGG-1_V12N28-333_D1,1,0,0,0,0,1
ATATCGTTCCTCGAAC-1_V12N28-333_D1,1,0,0,0,0,1
CGGCGCCATCAATCCC-1_V12N28-333_D1,0,1,2,0,1,4
CCTGTTTGAAGACACG-1_V12N28-333_D1,1,1,0,0,1,3
GCCACTCAGAGCGCGA-1_V12N28-333_D1,0,5,0,0,0,5
TCGGCTTGTATCGACG-1_V12N28-333_D1,1,1,0,0,2,4
TAGATGGTTCCTTACT-1_V12N28-333_D1,1,0,0,0,0,1
ATCGTTAGCTAGCGGA-1_V12N28-333_D1,0,2,1,0,0,3
ACAGCGACATTCTCAT-1_V12N28-333_D1,4,1,0,0,0,5
ATTCAACCATTTAAGG-1_V12N28-333_D1,3,0,0,0,0,3
CACTCTTCTGCTAGCC-1_V12N28-333_D1,1,0,1,0,0,2
CTAACTGATAATCGCC-1_V12N28-333_D1,5,1,0,0,0,6
TGATGTCAATTAAGTG-1_V12N28-333_D1,0,1,0,0,0,1
CGCCGTTCAGCATAGT-1_V12N28-333_D1,2,0,0,0,0,2
ATACTACCCGTACCAC-1_V12N28-333_D1,3,0,0,0,0,3
CCACTGTTTGGATTAA-1_V12N28-333_D1,4,1,0,0,0,5
CACTACGGGAGCTGCC-1_V12N28-333_D1,2,0,0,0,1,3
GACCAAACGTTGACTG-1_V12N28-333_D1,0,0,0,0,1,1
AAGAGGCCCTTTGGAA-1_V12N28-333_D1,4,1,0,0,1,6
ACACGTAGGCCACAAG-1_V12N28-333_D1,3,0,0,0,0,3
TACTCTTACTTTACTG-1_V12N28-333_D1,1,0,0,0,0,1
AGAGCCGCCGAGATTT-1_V12N28-333_D1,0,1,0,0,2,3
GGCCTGCTTCTCCCGA-1_V12N28-333_D1,0,1,0,0,0,1
TCAAGCGCGGACGGTA-1_V12N28-333_D1,1,0,0,0,0,1
ACACTGGGACAGTCGT-1_V12N28-333_D1,2,0,0,0,0,2
TGTGTAGTAGCACGTG-1_V12N28-333_D1,3,0,1,0,0,4
CTAGCCACAGGCGAGC-1_V12N28-333_D1,1,2,0,0,1,4
CTATCGCGTAGAGAAC-1_V12N28-333_D1,0,0,0,0,1,1
GTTCCCGTAAACATAT-1_V12N28-333_D1,0,0,0,0,0,0
TCTTTCCTTCGAGATA-1_V12N28-333_D1,0,0,0,0,0,0
ATATTGGAGAGGCCTT-1_V12N28-333_D1,2,0,1,0,1,4
AGGCGATAACTGGCGT-1_V12N28-333_D1,1,0,0,0,0,1
ACCCGGAGCACCACAA-1_V12N28-333_D1,1,0,0,0,0,1
TGAGCTCAACTGTATA-1_V12N28-333_D1,0,1,0,0,1,2
ACGACCCATGAGTTGC-1_V12N28-333_D1,2,0,0,0,0,2
CGGTCAGTCCATATTT-1_V12N28-333_D1,2,0,0,0,0,2
TCCGGCTGTCGGGTCG-1_V12N28-333_D1,2,0,0,0,2,4
ACACATGATCAAATCT-1_V12N28-333_D1,2,1,2,2,0,7
TATCCATCTCGGTTAG-1_V12N28-333_D1,0,0,0,0,0,0
CTCGTCGAGGGCTCAT-1_V12N28-333_D1,0,1,0,0,0,1
ATCAATGCCGTGGCTG-1_V12N28-333_D1,4,0,0,0,0,4
GAAACATAGGAAACAG-1_V12N28-333_D1,3,1,1,2,0,7
TAATAGGTCACCAGAA-1_V12N28-333_D1,3,1,1,1,0,6
CACCAGTCAGCATGCA-1_V12N28-333_D1,2,0,0,0,0,2
GAGCGCTGTTAGGTAA-1_V12N28-333_D1,3,2,0,1,0,6
CCCTATGTAGAGCAGA-1_V12N28-333_D1,3,0,1,0,0,4
GATCGCTATATCTCAG-1_V12N28-333_D1,1,0,0,2,0,3
AAGGGACTATGCATTC-1_V12N28-333_D1,4,0,0,0,0,4
CTCGGGTTCTCTGGCC-1_V12N28-333_D1,1,0,3,0,0,4
TATATATCGAGAAATG-1_V12N28-333_D1,5,0,0,1,0,6
ACCCGAGCGAAATTAC-1_V12N28-333_D1,4,0,1,0,0,5
TTGTTTCATTAGTCTA-1_V12N28-333_D1,1,1,0,0,1,3
ATGGGACCTGCTGAAC-1_V12N28-333_D1,4,0,0,0,0,4
TGCGACGGCCGAACGT-1_V12N28-333_D1,1,0,0,1,0,2
AGCTAACAAGCAATGT-1_V12N28-333_D1,5,0,0,2,0,7
CGTGTCTCGTTACGAC-1_V12N28-333_D1,3,0,1,1,0,5
CTAAATCCGGTGTACA-1_V12N28-333_D1,1,0,0,1,0,2
GAATAGTGCTCGATTA-1_V12N28-333_D1,4,0,0,1,0,5
AACAATACATTGTCGA-1_V12N28-333_D1,1,0,1,0,0,2
CACATCGTGCACGCGC-1_V12N28-333_D1,6,0,0,1,0,7
ACCGTGACCACGTGGG-1_V12N28-333_D1,4,0,1,0,0,5
CCCAATGAGATTTGCA-1_V12N28-333_D1,5,0,0,0,0,5
TCAGCAGTAGGCCCTG-1_V12N28-333_D1,4,0,0,0,0,4
CTACTCAAGGTATAGT-1_V12N28-333_D1,6,0,0,1,0,7
TAGTAGCTTATACCAG-1_V12N28-333_D1,5,0,0,1,0,6
ACGTTCGTTCAGGAAA-1_V12N28-333_D1,3,0,1,0,0,4
TTAGAATAAGGGTCGG-1_V12N28-333_D1,6,0,0,1,0,7
TTCTAGAAAGTCTTAT-1_V12N28-333_D1,3,0,0,1,0,4
CCTTCAGTTAAAGTGA-1_V12N28-333_D1,4,0,0,0,0,4
TAGCTAGTGATGATGG-1_V12N28-333_D1,2,0,0,1,0,3
AGCCCGGTAGCCTGTA-1_V12N28-333_D1,4,0,0,0,0,4
TACCTCAGTTGTCTGT-1_V12N28-333_D1,1,0,0,1,0,2
GACGGGTTGGCCCGTA-1_V12N28-333_D1,3,0,1,0,0,4
GAAACCTATACAAATG-1_V12N28-333_D1,2,0,0,1,0,3
TCCACCTCTAGCCTTT-1_V12N28-333_D1,5,0,0,1,0,6
AAGACCCAACTGAACA-1_V12N28-333_D1,6,0,0,0,0,6
CATACACGGTTCCCAC-1_V12N28-333_D1,5,1,0,2,0,8
ACTACGCGTTAGAATT-1_V12N28-333_D1,3,0,0,0,0,3
CTTGGCCAAGCTGGGA-1_V12N28-333_D1,3,0,0,0,0,3
TTACCCTAGGGATTGG-1_V12N28-333_D1,6,0,0,3,0,9
TTCGCACTGTACGACA-1_V12N28-333_D1,5,0,0,0,0,5
TAGGTGTTCCACAGAT-1_V12N28-333_D1,3,1,1,1,0,6
GAAGCCTGCACATTCC-1_V12N28-333_D1,1,0,0,2,0,3
GGCTTTCAATAAGGGT-1_V12N28-333_D1,2,2,0,0,0,4
TCCAGGGTATATACGA-1_V12N28-333_D1,1,0,0,3,0,4
CTCGCCGAATGTAGGG-1_V12N28-333_D1,4,0,0,1,0,5
AGGAAGCTGTCCGCCG-1_V12N28-333_D1,6,0,0,1,0,7
GTCTCAAGGCCCGGCT-1_V12N28-333_D1,2,3,1,0,0,6
ACCGACACATCTCCCA-1_V12N28-333_D1,3,1,0,0,0,4
TATACGCGTCATCACT-1_V12N28-333_D1,1,0,0,0,0,1
ATCTGGGCTGTTCTTG-1_V12N28-333_D1,2,0,1,2,0,5
TCAAATTTGAGACTCA-1_V12N28-333_D1,0,2,3,0,0,5
GTTAAGGGTGCGATGT-1_V12N28-333_D1,2,2,0,0,0,4
AGCAAAGGCCGCTAGT-1_V12N28-333_D1,2,1,3,0,0,6
TTATAGGTAATTGTCT-1_V12N28-333_D1,1,1,1,0,0,3
TTGTGCAGCCACGTCA-1_V12N28-333_D1,1,1,1,0,0,3
ACGGACTCTCAAAGCG-1_V12N28-333_D1,0,0,2,0,0,2
ATGCTCTGGCGCGGTA-1_V12N28-333_D1,1,2,0,0,0,3
ATAATCTTGGAGAACC-1_V12N28-333_D1,2,0,2,0,0,4
CTCATTGCTCTAACAA-1_V12N28-333_D1,0,1,1,0,0,2
TAGGTGACGATAACCT-1_V12N28-333_D1,0,1,3,0,0,4
CGGATCCTCAAGGACT-1_V12N28-333_D1,0,0,1,0,0,1
GGGCGTGGTTTCCCAG-1_V12N28-333_D1,0,0,1,0,1,2
TGGCTATGTGACATAC-1_V12N28-333_D1,1,2,2,0,0,5
CTTAGTGTAGTAGCAT-1_V12N28-333_D1,1,1,0,0,0,2
GGATTGCTGTGACTCC-1_V12N28-333_D1,0,0,0,0,0,0
ACTTCCATGCGGGACA-1_V12N28-333_D1,0,3,0,0,0,3
ACTCAAGTGCAAGGCT-1_V12N28-333_D1,2,1,0,0,0,3
ACAAGGATGCTTTAGG-1_V12N28-333_D1,0,0,1,0,0,1
TTGAACGACGTGCTGA-1_V12N28-333_D1,1,0,1,0,0,2
ATTCATCGTTGAGGCA-1_V12N28-333_D1,0,0,0,0,1,1
TGCAACCCATCTGCGG-1_V12N28-333_D1,1,1,0,0,2,4
AGTGCTAAACACAGCA-1_V12N28-333_D1,3,0,0,0,0,3
AACTCCAGAGCGTGTT-1_V12N28-333_D1,0,2,0,0,1,3
TCTCCACAAGTTGAAT-1_V12N28-333_D1,0,0,0,0,0,0
CTTTGCATCGCTCTTG-1_V12N28-333_D1,0,0,0,0,0,0
TCACAAACCGAGGTAC-1_V12N28-333_D1,2,1,3,0,1,7
CCGTAGGAAATCCCTG-1_V12N28-333_D1,1,0,0,0,0,1
AAACATTTCCCGGATT-1_V12N28-333_D1,1,0,0,0,1,2
GCCTCCGACAATTCAC-1_V12N28-333_D1,0,0,0,0,0,0
TCTGCATACCTTGCTT-1_V12N28-333_D1,2,0,1,0,0,3
ACCCATTTGTCCCTCT-1_V12N28-333_D1,1,0,0,0,0,1
CTGCAGAGAATCAGAG-1_V12N28-333_D1,0,0,0,0,0,0
GGAAACTAAATGGGCC-1_V12N28-333_D1,1,0,0,0,0,1
CAACCTACCGAGCAGT-1_V12N28-333_D1,2,1,0,0,1,4
CCGTAGGGTTGTTTAC-1_V12N28-333_D1,3,1,0,0,0,4
GGTTTGTGACCTGAGG-1_V12N28-333_D1,1,3,1,0,0,5
TAACCTAGGGAGTCCA-1_V12N28-333_D1,0,0,0,0,0,0
TTCCATCGACAGCGTG-1_V12N28-333_D1,0,2,0,0,0,2
ATCTCCCACGGAATAT-1_V12N28-333_D1,0,0,1,0,0,1
GTTTCAAACGAGTTGT-1_V12N28-333_D1,0,0,0,0,0,0
GGAACTTTGGCGATTA-1_V12N28-333_D1,1,0,0,0,0,1
CTGCAAGCACGTTCCG-1_V12N28-333_D1,3,1,0,0,0,4
CACAGTCCCGCTTCGC-1_V12N28-333_D1,2,2,0,0,1,5
TACGCTCGGTATTGGA-1_V12N28-333_D1,3,1,0,0,0,4
CTGGTAAAGTGTGGGC-1_V12N28-333_D1,0,0,0,0,1,1
CAACCAGTGGCCTACC-1_V12N28-333_D1,1,0,0,0,0,1
TCTTCGCGGTGAGAGG-1_V12N28-333_D1,0,2,0,0,1,3
TTCGGGTTGCCACGGG-1_V12N28-333_D1,0,0,0,0,2,2
ACCGATAGGCATAACC-1_V12N28-333_D1,2,1,0,0,0,3
CTTATAGATGGCTGTT-1_V12N28-333_D1,1,0,0,0,0,1
AGACGCCCACTTCGCC-1_V12N28-333_D1,0,0,0,0,1,1
AGGTCGCCTCCCAACA-1_V12N28-333_D1,1,0,0,0,1,2
CCTCACGTCAGCTAAT-1_V12N28-333_D1,1,0,0,0,0,1
CCACCTGTATGGAATA-1_V12N28-333_D1,1,0,0,0,0,1
GGACTCGAAGCTTTCA-1_V12N28-333_D1,1,0,0,0,1,2
AAGCCGGAGAGCAGGA-1_V12N28-333_D1,1,0,0,0,1,2
GCCTATCAGGTAAGAT-1_V12N28-333_D1,0,0,0,0,0,0
TCAGAGTGTGAGCATG-1_V12N28-333_D1,2,0,0,0,1,3
CCTATGGCTCCTAGTG-1_V12N28-333_D1,0,0,3,0,0,3
TGCTTAGAGAGAATGC-1_V12N28-333_D1,5,0,0,0,0,5
CGTGCTTCTACCTAAA-1_V12N28-333_D1,2,2,0,0,0,4
ACTCCAATATCATCAT-1_V12N28-333_D1,0,0,2,0,0,2
GCCGACCCACGACTGC-1_V12N28-333_D1,7,1,3,0,0,11
GAGGGTAGTAACAAAG-1_V12N28-333_D1,4,0,1,0,0,5
GGCCGAGACTCTGGTG-1_V12N28-333_D1,2,0,0,2,0,4
TATATAGGGCTTTACG-1_V12N28-333_D1,3,0,0,0,0,3
TGCCGGATGTACGAGC-1_V12N28-333_D1,5,1,0,0,0,6
AGGTAGATCGAGATAT-1_V12N28-333_D1,3,1,0,1,0,5
GATCAACATAAAGGGA-1_V12N28-333_D1,2,0,0,0,0,2
TAACAGCGTTTGTGCT-1_V12N28-333_D1,2,0,0,0,0,2
CTATAGGCGTTGATGT-1_V12N28-333_D1,1,1,1,0,0,3
GGTTTAATTACCATCG-1_V12N28-333_D1,5,3,0,1,0,9
CTCTTCTGGAAGTTAG-1_V12N28-333_D1,6,0,0,0,0,6
ATCTGACATGGAAGGA-1_V12N28-333_D1,5,0,0,1,0,6
TACGTACTAGTGCTGA-1_V12N28-333_D1,5,0,0,0,0,5
ATGACTATCAGCTGTG-1_V12N28-333_D1,6,0,0,0,0,6
CTTTGGGATTGTTGCA-1_V12N28-333_D1,4,3,0,1,0,8
AGACTGTTACCGGGTC-1_V12N28-333_D1,3,0,0,1,0,4
TCCTAACCGTCGGGCA-1_V12N28-333_D1,2,0,0,1,0,3
ACGCAAACTAATAGAT-1_V12N28-333_D1,2,2,0,1,0,5
AAGTGAGTCGGGTTTA-1_V12N28-333_D1,2,0,0,1,0,3
TAAAGCGGTATTTCCA-1_V12N28-333_D1,3,0,1,0,0,4
CTCCTCCAGCTCACAC-1_V12N28-333_D1,4,0,0,0,0,4
CGGTCCGTCGCAAGCC-1_V12N28-333_D1,4,0,0,0,0,4
CCTATATTTGTCCTGG-1_V12N28-333_D1,2,0,0,0,0,2
TCCAATAAAGGCTACC-1_V12N28-333_D1,3,1,0,0,0,4
AAAGGCTACGGACCAT-1_V12N28-333_D1,2,0,1,0,0,3
CGTGACCAGTCCTCTG-1_V12N28-333_D1,4,1,0,0,0,5
GATCTGCTATCTAAGG-1_V12N28-333_D1,2,1,0,0,0,3
CGAATGACGCATAATG-1_V12N28-333_D1,6,1,0,1,0,8
GCTCAATGTAATACCG-1_V12N28-333_D1,1,2,0,1,0,4
CTATGCCCGAATGCAA-1_V12N28-333_D1,6,1,0,1,0,8
CACAGGGCCGTTGTCA-1_V12N28-333_D1,2,2,0,2,0,6
TCAATACGCCGTCATG-1_V12N28-333_D1,6,0,0,0,0,6
AGCGGACACTTCGTAG-1_V12N28-333_D1,4,0,0,1,0,5
ATACGTTATGCACGGA-1_V12N28-333_D1,2,0,1,1,0,4
GAGTAGATACTAGTTG-1_V12N28-333_D1,7,1,0,0,0,8
CCAGCTCGAACGCATT-1_V12N28-333_D1,3,0,2,0,0,5
TGCTTCCCAAGCAGTA-1_V12N28-333_D1,2,1,0,1,0,4
GTAGACACGCCTGACT-1_V12N28-333_D1,1,0,0,0,0,1
CTCACATTTACTAAAT-1_V12N28-333_D1,0,1,2,0,0,3
GAATGCGAATCGGTTC-1_V12N28-333_D1,3,0,0,0,0,3
TAAGGCCCGTCACCCT-1_V12N28-333_D1,1,0,2,0,0,3
GAGTATGCGCGTGCAT-1_V12N28-333_D1,3,0,0,2,0,5
ATCCACATCGACAGAA-1_V12N28-333_D1,0,1,0,0,1,2
TAGACGAAACGCCAAT-1_V12N28-333_D1,2,0,2,1,0,5
CAGCAGTCTGTGCTGC-1_V12N28-333_D1,1,2,1,0,0,4
CTCACTGTGATACTTA-1_V12N28-333_D1,2,2,1,0,1,6
TTAATTGCTTTGGGTG-1_V12N28-333_D1,0,3,1,0,1,5
GTAGTCTACGATATTG-1_V12N28-333_D1,0,1,0,0,0,1
TTGCCGCTTTCTAGTA-1_V12N28-333_D1,1,0,0,0,0,1
GAACCTTTAACGATCC-1_V12N28-333_D1,1,1,2,0,0,4
TGGACCAATCTAAGAT-1_V12N28-333_D1,1,0,3,0,0,4
CTAGTAGAAAGGGATT-1_V12N28-333_D1,1,2,0,0,0,3
AACCTCGCTTTAGCCC-1_V12N28-333_D1,1,2,2,0,1,6
GAGTGTCAACCAGAAA-1_V12N28-333_D1,1,1,0,0,0,2
GTGATCCTTGTCATGA-1_V12N28-333_D1,2,1,0,0,1,4
CTCAACTAACCCGGAT-1_V12N28-333_D1,0,0,1,0,0,1
AGTGGCGTCTGAAGGT-1_V12N28-333_D1,1,2,2,0,0,5
GGGAAGGGCTTTCTCA-1_V12N28-333_D1,1,0,0,0,0,1
AGGCCTGAGAATCTCG-1_V12N28-333_D1,2,0,1,0,0,3
AGCCACAGGTTACCCG-1_V12N28-333_D1,2,2,0,0,1,5
TGCAATCTAACACGGT-1_V12N28-333_D1,0,0,2,0,0,2
GTTTGGGTTTCGCCCG-1_V12N28-333_D1,1,0,0,0,0,1
CCTATGTCCACTCCAC-1_V12N28-333_D1,2,0,0,0,0,2
CTGCCTTTCTAGTAAA-1_V12N28-333_D1,1,0,2,0,1,4
TTAGTAAACCTGCTCT-1_V12N28-333_D1,2,0,0,0,0,2
TTGTGGTGGTACTAAG-1_V12N28-333_D1,0,0,3,0,0,3
CCTCCTGTTGTGTCGT-1_V12N28-333_D1,0,0,2,0,1,3
ACAAAGCATGACCTAG-1_V12N28-333_D1,1,0,0,0,1,2
ATAGCAACTAGGGAAG-1_V12N28-333_D1,0,0,1,0,0,1
CCGCTCTTCCGAACTA-1_V12N28-333_D1,3,0,0,0,0,3
TAGAATAGCCGATGAA-1_V12N28-333_D1,1,0,0,0,0,1
GGTCTCCGTCCAGGTT-1_V12N28-333_D1,0,0,0,0,0,0
TAATTACGTCAGTAGA-1_V12N28-333_D1,2,0,0,0,0,2
TACGTAAAGCGGAGTG-1_V12N28-333_D1,1,0,0,0,0,1
GCTACAATCGAGGATA-1_V12N28-333_D1,5,0,0,0,0,5
TCAGCCAATCCGTAAA-1_V12N28-333_D1,3,0,0,0,0,3
ATCATAGCCCTATGTA-1_V12N28-333_D1,3,0,0,0,0,3
GAGGCCTGTTGATACA-1_V12N28-333_D1,0,1,0,0,1,2
ATATACGCTCGTGACG-1_V12N28-333_D1,0,0,0,0,0,0
CCCTTTAATGGAGTTC-1_V12N28-333_D1,1,0,0,0,1,2
TTACACGATCTGCGAC-1_V12N28-333_D1,2,0,0,0,0,2
TCGCATAAAGGGCGCA-1_V12N28-333_D1,2,0,0,0,0,2
TGTAGCCATCCCATTC-1_V12N28-333_D1,0,0,0,0,0,0
GGGTCTATCGCTTTCC-1_V12N28-333_D1,1,1,0,0,0,2
GGAGGGTCAAGTAAGA-1_V12N28-333_D1,0,0,0,0,0,0
TACGGCATGGACGCTA-1_V12N28-333_D1,0,0,0,0,0,0
CACGTCAATCAATGGA-1_V12N28-333_D1,1,0,0,0,0,1
CGCTTGGACGGATAGA-1_V12N28-333_D1,4,1,0,0,1,6
CGCGGTACGGTATACA-1_V12N28-333_D1,1,0,1,0,0,2
CCTACTCAACACGATT-1_V12N28-333_D1,0,0,0,0,0,0
CGTTTGGTGTTGTGGG-1_V12N28-333_D1,0,0,0,0,0,0
GTTGTTGCAAGATGGC-1_V12N28-333_D1,0,0,0,0,0,0
CATTCGTCGTAGCGGT-1_V12N28-333_D1,0,0,0,0,2,2
CAGCCTCGATAGCGGT-1_V12N28-333_D1,3,0,0,0,0,3
TCATAAGTCCAAGAAG-1_V12N28-333_D1,1,0,0,0,1,2
AAAGTGCCATCAATTA-1_V12N28-333_D1,0,1,0,0,0,1
GTTGCAGTCGACAACA-1_V12N28-333_D1,0,0,0,0,0,0
TAAATGGGCTACTGAG-1_V12N28-333_D1,1,0,0,0,0,1
GGGAACGGTTTCAGAT-1_V12N28-333_D1,1,0,1,1,0,3
ACGACTGGTCATACTC-1_V12N28-333_D1,7,0,0,0,0,7
TACTCCTCTAGTTGAC-1_V12N28-333_D1,2,2,0,1,0,5
GTAGCTCCGGGAGGCT-1_V12N28-333_D1,0,0,0,0,0,0
GGACTCGTGAGTGGTC-1_V12N28-333_D1,3,0,0,0,0,3
GTAGTTCGAAGGCGAA-1_V12N28-333_D1,3,1,3,0,0,7
CTCAAACCACTGCCCG-1_V12N28-333_D1,4,0,1,0,0,5
GAGGGAGTCAGATCGC-1_V12N28-333_D1,2,1,0,0,0,3
GCGTCCCTAAGACATA-1_V12N28-333_D1,2,0,0,1,0,3
TCTCTTACCGCGAACC-1_V12N28-333_D1,2,1,0,0,0,3
GGCTACTATACACTCC-1_V12N28-333_D1,2,0,0,0,0,2
CGTTGCCCGCGTGGGA-1_V12N28-333_D1,6,2,0,0,0,8
TATAGAGTCGCTTGAA-1_V12N28-333_D1,3,1,0,0,0,4
ATGTTGTAGTCTGTTT-1_V12N28-333_D1,4,1,0,2,0,7
AGTATACACAGCGACA-1_V12N28-333_D1,3,0,0,0,0,3
TGTGGTTGCTAAAGCT-1_V12N28-333_D1,2,3,0,0,0,5
TGATTCCCGGTTACCT-1_V12N28-333_D1,3,0,1,0,0,4
CACTGACGATTGTGGA-1_V12N28-333_D1,0,0,0,1,0,1
AACATTGTGACTCGAG-1_V12N28-333_D1,4,1,1,0,0,6
GTCCAATATTTAGCCT-1_V12N28-333_D1,5,0,0,1,0,6
GCTCTTTCCGCTAGTG-1_V12N28-333_D1,2,0,0,1,0,3
GGGTCAGGAGCTAGAT-1_V12N28-333_D1,1,0,0,1,0,2
AGGTGGTGACCTTCGC-1_V12N28-333_D1,5,2,0,0,0,7
CCCGGGTCGTTCAGGG-1_V12N28-333_D1,5,0,0,1,0,6
AGCCAAGCTTTGTGTC-1_V12N28-333_D1,2,0,1,2,0,5
TGTGGCGGGCTTCTGG-1_V12N28-333_D1,3,1,0,1,0,5
CGAGGGTATCCAGGTG-1_V12N28-333_D1,4,0,0,0,0,4
CGTTCAGACCCGCGAA-1_V12N28-333_D1,3,0,0,1,0,4
TCATATGAGCTTTGTT-1_V12N28-333_D1,1,2,0,2,0,5
AGTTGACGGTCCTTGC-1_V12N28-333_D1,2,1,0,1,0,4
ATAATTAGCTAAGTAG-1_V12N28-333_D1,4,0,0,1,0,5
GGTCTTGAGCGCTCTT-1_V12N28-333_D1,0,1,1,0,0,2
CGTTGTCGGCAATTGA-1_V12N28-333_D1,4,0,0,1,1,6
TCTTGCTCCCGATACT-1_V12N28-333_D1,2,1,2,0,0,5
AGCAGAAGGAGAAAGA-1_V12N28-333_D1,2,0,1,0,0,3
GAAGCCACTGATTATG-1_V12N28-333_D1,2,0,2,0,0,4
TGCTCTTGAGAGTTTG-1_V12N28-333_D1,1,1,2,0,0,4
GACATCCGTCGAACTG-1_V12N28-333_D1,0,0,2,1,0,3
AGATATAATACGACTA-1_V12N28-333_D1,1,0,1,0,2,4
TCGCTACTGGCTTTGA-1_V12N28-333_D1,0,1,1,0,0,2
GTGACAGCTTCCCACT-1_V12N28-333_D1,2,0,1,0,0,3
GTGACGCAGGTTTCAT-1_V12N28-333_D1,0,3,0,0,0,3
GGGAAGACGGTCTGTC-1_V12N28-333_D1,0,0,1,0,0,1
CGTCGCATGTGAGCCA-1_V12N28-333_D1,2,0,0,0,0,2
AGAAGGTTGTAGGTCG-1_V12N28-333_D1,0,2,1,0,0,3
GGCCGGCGTCTGCTAT-1_V12N28-333_D1,1,1,0,1,2,5
TTGACCAGGAACAACT-1_V12N28-333_D1,0,1,3,0,0,4
AGTCGTATAAAGCAGA-1_V12N28-333_D1,0,0,0,0,0,0
GGCGTAGGGAAAGCTG-1_V12N28-333_D1,1,1,1,0,0,3
AAACCTAAGCAGCCGG-1_V12N28-333_D1,2,0,0,0,0,2
ATTGCCTTTATGTTTG-1_V12N28-333_D1,0,2,2,0,0,4
CAGGCAGTCTTACCAG-1_V12N28-333_D1,0,0,0,0,0,0
AGCTAAGTACGCAGGC-1_V12N28-333_D1,1,1,0,0,0,2
AAATCCGATACACGCC-1_V12N28-333_D1,0,0,1,0,1,2
CGAGAGCTTTCACTAC-1_V12N28-333_D1,0,0,2,0,0,2
CGCCCAGCGTTTCACG-1_V12N28-333_D1,1,0,0,0,2,3
TTAAGTATTGTTATCC-1_V12N28-333_D1,0,0,1,0,0,1
AAACGGGCGTACGGGT-1_V12N28-333_D1,1,3,0,0,0,4
GTATCCTTTGGTAACC-1_V12N28-333_D1,1,1,0,0,1,3
CATAGTCAAATACATA-1_V12N28-333_D1,1,0,0,0,0,1
TCTATGCTATAACGAC-1_V12N28-333_D1,1,2,0,0,1,4
ACGTTCTGTACAAGTC-1_V12N28-333_D1,2,0,3,0,0,5
CGCGAAGTGGCATACT-1_V12N28-333_D1,0,0,0,0,1,1
ACCAACCGCACTCCAC-1_V12N28-333_D1,1,0,0,0,0,1
GTCATGCGCGAGGGCT-1_V12N28-333_D1,1,0,0,0,0,1
TAGGCTAAAGTGGCAC-1_V12N28-333_D1,2,0,0,0,1,3
TGGCTACACTCTACCT-1_V12N28-333_D1,0,0,0,0,0,0
TGTCCACGGCTCAACT-1_V12N28-333_D1,0,0,0,0,0,0
AATTGCAGCAATCGAC-1_V12N28-333_D1,3,0,0,0,0,3
GTCAACCAGGCCTATA-1_V12N28-333_D1,0,1,1,0,1,3
ATCTTATCGCACACCC-1_V12N28-333_D1,1,0,0,0,0,1
GTCTATTGCATGCTCG-1_V12N28-333_D1,3,1,0,0,0,4
GCACGTGGTTTACTTA-1_V12N28-333_D1,1,1,0,0,0,2
ATTCGCGCCTTGAGAG-1_V12N28-333_D1,1,0,0,0,1,2
AGCGATGCGCCTAATA-1_V12N28-333_D1,2,0,0,0,0,2
TCTATAGGTGGGTAAT-1_V12N28-333_D1,0,0,0,0,0,0
AGATACCAATAGAACC-1_V12N28-333_D1,0,0,0,0,0,0
CGTGTATGGGAGCTGA-1_V12N28-333_D1,0,0,0,0,0,0
ATGTACATGCGGTGAG-1_V12N28-333_D1,2,1,0,0,1,4
TTGGCTCAATATGTGT-1_V12N28-333_D1,1,0,0,0,0,1
GTTCGGAGCACTCAAC-1_V12N28-333_D1,2,0,0,0,1,3
TCCCTCTTCTCAAGGG-1_V12N28-333_D1,1,0,0,0,1,2
TTACGTATCTATGACA-1_V12N28-333_D1,3,0,0,0,0,3
CCCATATAGGTCGATT-1_V12N28-333_D1,1,2,0,0,1,4
GTCCACGTCGCATTCG-1_V12N28-333_D1,3,0,0,0,0,3
AATTGTGGTTGCCAAA-1_V12N28-333_D1,0,0,0,0,0,0
AGGAACGAACGACTTC-1_V12N28-333_D1,0,0,0,0,0,0
TAATTCCAATGCTTCA-1_V12N28-333_D1,1,0,0,0,2,3
AGGGCCCTAATGTTCT-1_V12N28-333_D1,0,1,0,0,0,1
AGGTGTTGCCGACCAC-1_V12N28-333_D1,0,0,0,0,1,1
CTGAGAGTAGAAATAC-1_V12N28-333_D1,0,0,0,0,0,0
TAGAAGAAGGGTTACA-1_V12N28-333_D1,2,0,0,0,0,2
GGTGACTGATAGAGAG-1_V12N28-333_D1,0,0,0,0,0,0
TACCCTCGGTAACCCT-1_V12N28-333_D1,1,0,0,0,1,2
CGTGGTACCCAAAGGC-1_V12N28-333_D1,1,0,0,0,0,1
TATGTAAAGTGCTTAA-1_V12N28-333_D1,5,1,0,0,0,6
GTAACTGCCCAAGGAG-1_V12N28-333_D1,5,1,0,0,0,6
GGTGCATAAATGATTA-1_V12N28-333_D1,3,0,0,2,0,5
TAGTCCCGGAGACCAC-1_V12N28-333_D1,3,0,2,0,0,5
CGGCCAGAGCGACCAT-1_V12N28-333_D1,1,0,0,0,0,1
TGAATGAGTGTTTCCC-1_V12N28-333_D1,4,0,0,1,0,5
TTCACTTCCTAGAACG-1_V12N28-333_D1,2,2,0,1,0,5
CGCTTAGTATTGATAC-1_V12N28-333_D1,5,0,1,0,0,6
AACGCGACCTTGGGCG-1_V12N28-333_D1,4,0,0,2,0,6
GTGCACCAGCTTCAAC-1_V12N28-333_D1,3,1,0,0,0,4
TTCTATTAAACGCAGC-1_V12N28-333_D1,1,0,0,1,0,2
TGGCAAGCACAAGTCG-1_V12N28-333_D1,4,0,1,1,0,6
ATCTGCTGTTATCGCC-1_V12N28-333_D1,2,0,0,2,0,4
AATTCCAAGCATGTAC-1_V12N28-333_D1,4,1,0,0,0,5
AAACGGTTGCGAACTG-1_V12N28-333_D1,2,0,0,1,0,3
GAAGGAGTCGAGTGCG-1_V12N28-333_D1,5,0,1,1,0,7
GGCAAGCCCATAGTGG-1_V12N28-333_D1,3,0,0,0,0,3
TGACCAAATCTTAAAC-1_V12N28-333_D1,2,0,0,0,0,2
TTCGGTACTGTAGAGG-1_V12N28-333_D1,2,0,0,0,1,3
ATGTACGATGACGTCG-1_V12N28-333_D1,4,1,0,1,0,6
ATCTAGCTTGTGAGGG-1_V12N28-333_D1,2,1,0,0,0,3
AGCGGGTCTGACACTC-1_V12N28-333_D1,1,0,2,1,0,4
GAGGTACGCGTGTCCC-1_V12N28-333_D1,1,0,0,0,0,1
GCACTGCCTACCTTTA-1_V12N28-333_D1,4,0,0,1,0,5
GGAGCGAGGCCTACTT-1_V12N28-333_D1,2,4,0,1,0,7
AAACTCGGTTCGCAAT-1_V12N28-333_D1,0,3,2,0,0,5
GGCGCTTCATTCCCTG-1_V12N28-333_D1,0,1,0,0,0,1
TGCTCGGTGGGTCACC-1_V12N28-333_D1,1,0,1,0,0,2
AAGCGCAGGGCTTTGA-1_V12N28-333_D1,1,1,3,0,0,5
GACCTTCCACGTCTAC-1_V12N28-333_D1,0,2,2,0,1,5
GTTAGCCCATGACATC-1_V12N28-333_D1,1,2,1,0,0,4
AATTCGATTCGAGGAT-1_V12N28-333_D1,1,1,1,1,0,4
AGTCTTTAAAGTGTCC-1_V12N28-333_D1,1,0,0,0,0,1
GACTAGGCCGTTAGGT-1_V12N28-333_D1,1,0,1,0,0,2
TCCAAGCCTAGACACA-1_V12N28-333_D1,0,1,1,0,0,2
GATTGGGAAAGGTTGT-1_V12N28-333_D1,0,2,2,0,0,4
GATGAGGAACCTTCGG-1_V12N28-333_D1,0,1,3,0,1,5
TGAATACCGACGCGTA-1_V12N28-333_D1,0,0,0,1,2,3
AATCGTGAGCCGAGCA-1_V12N28-333_D1,0,0,0,0,0,0
GCGAAGAATCTGACGG-1_V12N28-333_D1,1,0,0,0,0,1
GAACAACTGGGATGAA-1_V12N28-333_D1,1,0,0,0,0,1
TCGCCGACATATTCGC-1_V12N28-333_D1,0,0,1,0,1,2
CGTAGAGAGTAATTAT-1_V12N28-333_D1,1,0,1,0,1,3
CGATAGTCGTACTGCA-1_V12N28-333_D1,1,0,0,0,1,2
CGCATGCCGAATGCGT-1_V12N28-333_D1,0,2,0,0,1,3
CTCTAGCCCTCGGAAA-1_V12N28-333_D1,0,0,0,0,1,1
TCCAACTCAGCTATCT-1_V12N28-333_D1,4,1,0,0,1,6
GTCTAGTGAGCCGCTT-1_V12N28-333_D1,2,0,0,0,0,2
TACCGAATAATTGTAA-1_V12N28-333_D1,0,0,0,0,1,1
ATATAACACGGGCGCA-1_V12N28-333_D1,2,1,0,0,0,3
GCATGCTAATAACGAT-1_V12N28-333_D1,0,0,0,0,0,0
TCCGGGCTTGACGGGA-1_V12N28-333_D1,2,0,0,0,0,2
ATTATTCAGAGTCACT-1_V12N28-333_D1,1,1,2,0,1,5
TAGCAGTATGACTAAA-1_V12N28-333_D1,1,0,0,0,0,1
TATGAAGAATTAAGGT-1_V12N28-333_D1,2,1,0,0,1,4
CAAGGCCAGTGGTGCA-1_V12N28-333_D1,1,0,0,0,0,1
TGCGTACGGCTAATTG-1_V12N28-333_D1,1,0,1,0,0,2
CAGATAATGGGCGGGT-1_V12N28-333_D1,1,0,0,0,0,1
GAGAACGGTTCTGACT-1_V12N28-333_D1,4,2,0,0,0,6
CGCTTCGGTCTAAGAC-1_V12N28-333_D1,0,0,0,0,1,1
AGCATTACGAGGCAAG-1_V12N28-333_D1,1,0,0,0,2,3
AAGTTGTGATGTTATA-1_V12N28-333_D1,2,1,0,0,1,4
TTGCTCATAGTACGTG-1_V12N28-333_D1,2,0,0,0,1,3
TACTTAAACATGTACA-1_V12N28-333_D1,2,0,0,0,0,2
AGTGAGTCGAATTAAC-1_V12N28-333_D1,2,0,0,0,0,2
TAGGCCTATATAGTCT-1_V12N28-333_D1,0,0,0,0,1,1
ACTCGCCGTTCGATAA-1_V12N28-333_D1,0,2,0,0,1,3
GGTACGTTGCGGCCGG-1_V12N28-333_D1,2,0,0,0,0,2
TATTGCCGGGCTTGTA-1_V12N28-333_D1,1,0,0,0,2,3
GGTAAACTCTGCGCTG-1_V12N28-333_D1,3,0,0,0,1,4
TCCCTTGTCTGAAACT-1_V12N28-333_D1,3,1,0,0,0,4
CATGATCGCTTTGAGA-1_V12N28-333_D1,2,0,0,0,0,2
GGACGGGCGACCAACC-1_V12N28-333_D1,0,0,0,0,2,2
GAGAGGCCTATGTGTA-1_V12N28-333_D1,1,0,0,0,2,3
TCGTAACTCCCAAGAC-1_V12N28-333_D1,3,0,0,0,0,3
CGTATCTAGAACTAAG-1_V12N28-333_D1,2,0,0,0,0,2
GCACCTTCCCGAAGGT-1_V12N28-333_D1,0,0,0,0,0,0
TACCTCTTTACCATCC-1_V12N28-333_D1,2,0,0,0,0,2
TGACTCTAACTGGTAA-1_V12N28-333_D1,3,0,0,0,0,3
GAGAAACTGGATCCCA-1_V12N28-333_D1,2,0,0,0,0,2
ATCCGGACCAGCCTGA-1_V12N28-333_D1,2,1,0,0,0,3
TTATTTAGGTTCCTTA-1_V12N28-333_D1,0,1,0,0,0,1
CGAATTCCCGGTTCAA-1_V12N28-333_D1,0,0,0,0,0,0
CGTAACTTCGACACTT-1_V12N28-333_D1,2,1,0,1,0,4
CATACTTCTTTCTCCG-1_V12N28-333_D1,4,0,0,0,0,4
AGCCCGCAACAAGCAG-1_V12N28-333_D1,1,0,0,2,0,3
TCGTACCGACGTCAAG-1_V12N28-333_D1,5,3,0,0,0,8
ATTATCGGAATGTACG-1_V12N28-333_D1,0,0,0,1,0,1
ACCTACTATAAATCTA-1_V12N28-333_D1,4,1,0,0,0,5
TATCCTATCAACTGGT-1_V12N28-333_D1,5,0,1,0,0,6
GCGCGGTCTAGTAACT-1_V12N28-333_D1,6,0,0,1,0,7
CCTTCGTATAGAATCC-1_V12N28-333_D1,3,0,0,2,0,5
TGGGCGATACAATAAG-1_V12N28-333_D1,3,0,0,0,0,3
TGACATGTAACGTGAC-1_V12N28-333_D1,1,0,0,2,0,3
TTGGGAAGACGAGCCG-1_V12N28-333_D1,2,0,1,1,0,4
GGTGTAAATCGATTGT-1_V12N28-333_D1,1,1,1,0,0,3
GAACTGTGGAGAGACA-1_V12N28-333_D1,2,0,0,0,0,2
TCCACATCGTATATTG-1_V12N28-333_D1,2,1,0,3,0,6
CCTATGGTCAAAGCTG-1_V12N28-333_D1,2,3,0,0,0,5
TCCTTGTCCTTTAATT-1_V12N28-333_D1,1,1,0,2,0,4
AAGTTTATGGGCCCAA-1_V12N28-333_D1,0,1,0,0,0,1
GTCCGGGTTCACATTA-1_V12N28-333_D1,0,2,1,0,0,3
ATGTAGCGCGCGTAGG-1_V12N28-333_D1,1,1,0,0,0,2
TACGGAAGCCAAACCA-1_V12N28-333_D1,1,1,1,0,0,3
GCCCTGAGGATGGGCT-1_V12N28-333_D1,0,2,1,0,0,3
CGGGCGATGGATCACG-1_V12N28-333_D1,2,0,0,0,0,2
TGCGGACTTGACTCCG-1_V12N28-333_D1,0,1,0,0,1,2
TAATACTAGAACAGAC-1_V12N28-333_D1,1,0,0,0,1,2
TCAAATTGTTGTGCCG-1_V12N28-333_D1,1,0,0,0,0,1
GGGCAGTCAACGCCAA-1_V12N28-333_D1,1,0,0,0,0,1
TCGCTGCCAATGCTGT-1_V12N28-333_D1,0,2,0,0,1,3
TACGTGGGCCCAGGGC-1_V12N28-333_D1,1,0,0,0,0,1
GCCTACGTTCTGTGCA-1_V12N28-333_D1,0,0,2,0,3,5
TTGCGTGTGTAGGCAT-1_V12N28-333_D1,0,0,0,0,0,0
TCCTAAAGATTCAGAC-1_V12N28-333_D1,2,3,1,0,0,6
TGGGTGCACAAGCCAT-1_V12N28-333_D1,1,1,3,0,0,5
GGGAGCGACCGTAGTG-1_V12N28-333_D1,0,0,0,0,0,0
CATAGAGGAGATACTA-1_V12N28-333_D1,0,0,2,0,0,2
CTTCGATTGCGCAAGC-1_V12N28-333_D1,2,1,0,0,0,3
GTGCCTGAGACCAAAC-1_V12N28-333_D1,2,1,0,0,0,3
TCATCCTCAGCTGCTT-1_V12N28-333_D1,1,1,0,0,0,2
TGCAACTACTGGTTGA-1_V12N28-333_D1,0,0,0,0,0,0
ATGTTGATTAGAGACT-1_V12N28-333_D1,0,0,0,0,0,0
GTTTCTAGAGGCGCGG-1_V12N28-333_D1,2,1,0,0,0,3
TACAAGGGCTTCTTTA-1_V12N28-333_D1,1,0,0,0,0,1
ACAGGCACGGATCCTT-1_V12N28-333_D1,0,1,0,0,0,1
CCCAAGTCATTACACT-1_V12N28-333_D1,0,1,0,0,0,1
ACTCTGACCTAATAGA-1_V12N28-333_D1,2,0,1,0,0,3
GGATGGCTTGAAGTAT-1_V12N28-333_D1,0,2,0,0,1,3
ACCCTCCCGTCAGGGC-1_V12N28-333_D1,5,1,0,0,0,6
AGCTTCTTCTCGAGCA-1_V12N28-333_D1,1,0,0,0,0,1
TTGCGCTTGATCAATA-1_V12N28-333_D1,5,2,0,0,2,9
TGGGTGTAATAGATTT-1_V12N28-333_D1,1,0,0,0,2,3
CATGGTTTATTAATCA-1_V12N28-333_D1,1,0,0,0,0,1
TTGCCTTCTCGCCGGG-1_V12N28-333_D1,1,0,0,0,0,1
TTAAAGTAAGTCGCCA-1_V12N28-333_D1,0,0,0,0,0,0
AGTTGGCAAGGCTAGA-1_V12N28-333_D1,1,0,0,0,1,2
CCGCACTTGCAATGAC-1_V12N28-333_D1,0,0,0,0,0,0
AATGTTGTCGTGAGAC-1_V12N28-333_D1,1,0,0,0,1,2
CCAAGGTTGCCCTTTC-1_V12N28-333_D1,2,0,0,0,0,2
TGTGACTAGAGTTTGC-1_V12N28-333_D1,7,0,0,0,2,9
TTGTGATCTGTTCAGT-1_V12N28-333_D1,0,0,0,0,1,1
GGAGTTGATTCTGTGT-1_V12N28-333_D1,1,0,0,0,1,2
GTAGTGAGCAACCTCA-1_V12N28-333_D1,2,0,0,0,0,2
AAGACATACGTGGTTT-1_V12N28-333_D1,1,0,0,0,1,2
CATCCCGAGATTCATA-1_V12N28-333_D1,2,0,0,0,0,2
GGCCGCAGGAACCGCA-1_V12N28-333_D1,2,1,0,0,0,3
CCAGAAACTGATGCGA-1_V12N28-333_D1,0,0,0,0,2,2
ACCCGTAGTCTAGTTG-1_V12N28-333_D1,2,0,0,0,1,3
AGGGTCTGGACGCAGT-1_V12N28-333_D1,1,0,0,0,0,1
TTGAAACCCTCATTCC-1_V12N28-333_D1,0,1,0,0,0,1
TCAATCCCGCGCCAAA-1_V12N28-333_D1,1,0,0,0,1,2
AGGACATCGGCACACT-1_V12N28-333_D1,1,0,0,0,0,1
GACAAGACGCCCGTGC-1_V12N28-333_D1,3,0,0,0,0,3
GAGTAAATTAAGAACC-1_V12N28-333_D1,2,0,0,0,1,3
TAAGTCGGTGAGCTAG-1_V12N28-333_D1,1,0,0,0,0,1
CTTACTGACTCCTCTG-1_V12N28-333_D1,1,0,0,0,0,1
TTAACTGATCGTTTGG-1_V12N28-333_D1,2,0,0,0,0,2
GTTCAGTCGCCAAATG-1_V12N28-333_D1,1,0,0,0,0,1
AGTAGAAGGCGCCTCA-1_V12N28-333_D1,3,0,0,1,0,4
CTATTTGCTTGGAGGA-1_V12N28-333_D1,3,1,0,1,0,5
AGCCATATAGTATGTG-1_V12N28-333_D1,2,0,1,1,0,4
TGTTCCGGCCTGAGCT-1_V12N28-333_D1,2,0,1,0,0,3
TGCCGTGGGACCCAAT-1_V12N28-333_D1,2,1,0,1,0,4
TTGCAAGAAGACTCCT-1_V12N28-333_D1,0,0,3,0,0,3
CCGCTCCAGGGCGATC-1_V12N28-333_D1,1,3,0,1,1,6
CAAACCCTCCGGCGGG-1_V12N28-333_D1,1,0,0,0,0,1
CGGACCTTTACGTCCC-1_V12N28-333_D1,1,1,1,0,0,3
ACGTAGGAGAGTCGCT-1_V12N28-333_D1,1,1,0,0,0,2
CTGCGACCTCGCCGAA-1_V12N28-333_D1,1,1,1,0,1,4
GGCCCAGCTGGTTTGC-1_V12N28-333_D1,2,2,0,0,0,4
GGATTAATCATGGACC-1_V12N28-333_D1,0,0,0,0,1,1
GAGATGGCTTTAATCA-1_V12N28-333_D1,1,3,1,0,1,6
AGTACAGAAGCTTATA-1_V12N28-333_D1,0,0,1,0,0,1
GCGGCTTTAGCAAGTT-1_V12N28-333_D1,0,0,0,0,1,1
ACCGAGTCTCCTTATT-1_V12N28-333_D1,3,0,0,0,1,4
GACCACACTTCCCTTT-1_V12N28-333_D1,0,2,2,0,1,5
TGTAGCCAATTCCGTT-1_V12N28-333_D1,2,1,0,0,1,4
CTCGTCTGTGCCTTCG-1_V12N28-333_D1,1,1,0,0,0,2
GGACTCTTTGACTAAG-1_V12N28-333_D1,0,0,0,0,0,0
TCATCGACGACCGTCG-1_V12N28-333_D1,2,0,1,0,0,3
TACTACGTGCAATGCG-1_V12N28-333_D1,0,0,3,0,0,3
CCCTACTTGAACAATG-1_V12N28-333_D1,0,0,0,0,0,0
GCAGCTGTCAACGCAT-1_V12N28-333_D1,3,0,0,0,0,3
ATCTACCATCTGCTCC-1_V12N28-333_D1,3,1,0,0,1,5
TCTCAAATCAATCGGG-1_V12N28-333_D1,1,0,0,0,0,1
ACTCCGGCCGACCACT-1_V12N28-333_D1,1,1,1,0,0,3
TACACCTCTTCGAATC-1_V12N28-333_D1,0,0,0,0,0,0
GTGGCTGTTTCTGTTC-1_V12N28-333_D1,1,1,0,0,0,2
ACGACTCTAGGGCCGA-1_V12N28-333_D1,0,1,0,0,0,1
TCGTTTACGCGACCCT-1_V12N28-333_D1,1,1,0,0,0,2
AGGATATCCGACTGCA-1_V12N28-333_D1,2,1,0,0,0,3
GACACTTCCAATTACC-1_V12N28-333_D1,1,1,0,0,1,3
ACGGTACAGTTCAATG-1_V12N28-333_D1,1,1,0,0,1,3
CTTGATGACCATCCAG-1_V12N28-333_D1,1,0,0,0,0,1
CTGGTAAAGACTTACA-1_V12N28-333_D1,0,1,0,0,0,1
CTTGCCCACCCACGCA-1_V12N28-333_D1,0,1,0,0,0,1
CATTACGCAGGAAGGG-1_V12N28-333_D1,2,1,0,0,0,3
GGACAACCATGAAGCC-1_V12N28-333_D1,3,0,0,0,0,3
GTTATCAAGCTATCGA-1_V12N28-333_D1,2,0,0,0,1,3
AGGTGCACGTCCACAT-1_V12N28-333_D1,0,0,0,0,0,0
AAAGAATGTGGACTAA-1_V12N28-333_D1,0,0,0,0,2,2
ACCAAGTCATCGGCAG-1_V12N28-333_D1,4,2,0,0,0,6
AGTAACTATAGCAGCC-1_V12N28-333_D1,2,1,0,0,1,4
GGGAAAGAATGCCAAC-1_V12N28-333_D1,0,1,0,0,0,1
AATCGGTATAGCCCTC-1_V12N28-333_D1,2,0,0,0,1,3
GGCACTGCGGTGGTTT-1_V12N28-333_D1,3,0,0,0,0,3
CGTCCTCATCGCGTGC-1_V12N28-333_D1,0,0,0,0,0,0
CTTAACTTACAGTATA-1_V12N28-333_D1,0,0,0,0,0,0
GTGAGTCGACTAATAG-1_V12N28-333_D1,4,0,0,0,0,4
TGTACTTCCGGGCATG-1_V12N28-333_D1,1,1,0,0,0,2
CACAAACCGCAGAACT-1_V12N28-333_D1,0,0,0,0,2,2
GCTTTACACAACTGGG-1_V12N28-333_D1,1,0,0,0,0,1
CACCGATGATGGGTAC-1_V12N28-333_D1,2,0,0,0,0,2
TCAATATACAGGAGGC-1_V12N28-333_D1,1,0,0,0,0,1
AACGACCTCCTAGCCG-1_V12N28-333_D1,0,0,0,0,0,0
GTTACCAAGGCGTACG-1_V12N28-333_D1,1,1,0,0,0,2
TAGCTCACTGTGTTTG-1_V12N28-333_D1,0,0,0,0,0,0
TCGGCAGGGTTAAGGG-1_V12N28-333_D1,1,2,0,0,2,5
TGTTAACAAAGTGACT-1_V12N28-333_D1,0,0,0,0,1,1
CAGAGCGATGGATGCT-1_V12N28-333_D1,1,0,0,0,1,2
CATAGTGGGCACGCCT-1_V12N28-333_D1,1,0,0,0,0,1
AAACGCTGGGCACGAC-1_V12N28-333_D1,0,0,1,0,0,1
TGTTCTCATACTATAG-1_V12N28-333_D1,0,0,0,0,0,0
GCACACAGCTATTACC-1_V12N28-333_D1,1,0,1,1,1,4
GTATCAAGGTACTTCC-1_V12N28-333_D1,1,2,2,0,0,5
GGAAAGGGAATTGAGC-1_V12N28-333_D1,1,1,0,2,1,5
TACACAGCCGTGGTGC-1_V12N28-333_D1,3,0,0,1,0,4
CGGTTGGGCAGGGTCC-1_V12N28-333_D1,0,2,1,0,0,3
GCACGCCGATTCCCGC-1_V12N28-333_D1,3,2,0,0,0,5
CGCTTTCCGCCAAGGT-1_V12N28-333_D1,0,0,0,0,0,0
TGCCCGATAGTTAGAA-1_V12N28-333_D1,1,0,0,0,0,1
TCAGAACGGCGGTAAT-1_V12N28-333_D1,0,2,0,0,0,2
CCACTCAGATCCGCAA-1_V12N28-333_D1,1,0,0,0,1,2
GAAGGGTCATTAAGAC-1_V12N28-333_D1,0,0,0,0,1,1
GCGGTCTTGCTTTCAC-1_V12N28-333_D1,1,0,0,0,2,3
GGAAGGACACCGTATA-1_V12N28-333_D1,1,0,0,0,2,3
CGCGGGAATTCCTTTC-1_V12N28-333_D1,0,0,0,0,4,4
TCTATCCGATTGCACA-1_V12N28-333_D1,1,1,0,0,0,2
TACTCGTTTGAATCAA-1_V12N28-333_D1,0,2,0,0,0,2
GTCTGCCGACTCGACG-1_V12N28-333_D1,2,1,0,0,1,4
TACGGGTAATAACATA-1_V12N28-333_D1,3,0,0,0,0,3
CCAGTTCGGTAACTCA-1_V12N28-333_D1,2,2,1,0,0,5
CGTGCACACCACTGTA-1_V12N28-333_D1,1,0,0,0,2,3
CTTCAGTTGGACAACG-1_V12N28-333_D1,1,0,0,0,0,1
TGATCTATCACACTCT-1_V12N28-333_D1,1,1,0,0,0,2
TAGCAGATACTTAGGG-1_V12N28-333_D1,5,2,1,0,0,8
CACCGGGCATCACAAG-1_V12N28-333_D1,0,0,0,0,0,0
AGTGGCCCGCAAATGG-1_V12N28-333_D1,2,2,0,0,0,4
CTCGCTAGGTAAGCGA-1_V12N28-333_D1,0,0,1,0,0,1
GATAGATAGTACAGTC-1_V12N28-333_D1,1,0,0,0,0,1
CGAGACTACTGCTGCT-1_V12N28-333_D1,4,0,0,0,0,4
ACATTTGAAACCTAAC-1_V12N28-333_D1,1,0,0,0,0,1
GACACAGCCGGGACTG-1_V12N28-333_D1,3,0,0,0,2,5
ACGGAACACGAGTGCC-1_V12N28-333_D1,1,0,0,0,0,1
ACGCCAGTGCGTTTGC-1_V12N28-333_D1,3,1,0,0,1,5
GCACCTAGGCGAGTCC-1_V12N28-333_D1,1,1,0,0,0,2
TCACTATCCCTTCGGT-1_V12N28-333_D1,3,0,1,0,1,5
TGAGTGTAACAACGGG-1_V12N28-333_D1,2,0,0,0,2,4
ATTGGTTGTGCATTAC-1_V12N28-333_D1,3,0,0,0,0,3
CTGGCGATTTACATGT-1_V12N28-333_D1,4,0,0,0,1,5
TCCACCAAGACATAGG-1_V12N28-333_D1,1,0,0,0,0,1
AACGTCGCTGCACTTC-1_V12N28-333_D1,1,1,0,0,0,2
GTCTCCCGAGTCCCGT-1_V12N28-333_D1,1,1,0,0,0,2
AGCCCGCACTACAATG-1_V12N28-333_D1,0,0,0,0,1,1
GGCACGCTGCTACAGT-1_V12N28-333_D1,1,0,0,0,0,1
GCTTGAGTGACCTCTG-1_V12N28-333_D1,1,1,0,0,0,2
ATAGCCATAACAGTCA-1_V12N28-333_D1,0,0,0,0,1,1
TAGGAGGCTCGAGAAC-1_V12N28-333_D1,0,0,0,0,0,0
GTCGGGTGAAGTACCG-1_V12N28-333_D1,2,0,0,0,0,2
CACCCGCGTTTGACAC-1_V12N28-333_D1,0,1,0,0,1,2
TCTCAGGCTACTCGCT-1_V12N28-333_D1,1,0,0,0,0,1
TAGATTCTCTAGCAAA-1_V12N28-333_D1,3,0,0,0,0,3
CCCATTATTGTATCCT-1_V12N28-333_D1,1,0,1,0,1,3
GTTAATAGCGTCATTA-1_V12N28-333_D1,1,0,0,0,1,2
TACTCATTGACGCATC-1_V12N28-333_D1,2,1,0,0,0,3
TAGTGACAAGCTCTAC-1_V12N28-333_D1,1,0,0,0,0,1
ATCGCCGTGGTTCATG-1_V12N28-333_D1,1,0,1,0,1,3
CTGCTCTCAACACACC-1_V12N28-333_D1,2,0,0,0,1,3
GCATGACACAAAGGAA-1_V12N28-333_D1,0,0,0,0,0,0
CAACGATCGATCCAAT-1_V12N28-333_D1,3,0,0,0,1,4
CTATCACAACGCTGGA-1_V12N28-333_D1,0,0,5,0,1,6
TCAGCGCACGCCGTTT-1_V12N28-333_D1,0,0,0,1,1,2
AATGTTAAGACCCTGA-1_V12N28-333_D1,0,0,0,0,1,1
CTTACATAGATTTCTT-1_V12N28-333_D1,2,0,0,0,0,2
AACATAGCGTGTATCG-1_V12N28-333_D1,1,0,1,1,2,5
AGCAGTCGAAGCATGC-1_V12N28-333_D1,0,0,1,0,3,4
GTACTACGGCCTCGTT-1_V12N28-333_D1,4,0,0,0,0,4
TTGGCCAAATTGTATC-1_V12N28-333_D1,3,0,0,0,1,4
TCAGAGGACGCGTTAG-1_V12N28-333_D1,1,0,0,0,0,1
AGTAATCTAAGGGTGG-1_V12N28-333_D1,2,0,0,0,1,3
AATTATACCCAGCAAG-1_V12N28-333_D1,0,0,1,0,0,1
CCCTACCCACACCCAG-1_V12N28-333_D1,3,1,0,0,1,5
CTCTGTCCATGCACCA-1_V12N28-333_D1,1,0,1,0,0,2
TCGCCTCCTTCGGCTC-1_V12N28-333_D1,0,0,0,0,0,0
CCTGATTCGCGAAGAA-1_V12N28-333_D1,0,2,0,0,0,2
GACTTCAACGCATCAA-1_V12N28-333_D1,2,0,0,0,1,3
GCTTCCCGTAAGCTCC-1_V12N28-333_D1,3,0,0,0,0,3
AGAACTGTACTTTGTA-1_V12N28-333_D1,4,0,0,0,0,4
CCTTAAGTACGCAATT-1_V12N28-333_D1,0,0,0,0,0,0
GGCCAATTGTATAGAC-1_V12N28-333_D1,5,0,0,0,0,5
AGAATACAGGCTATCC-1_V12N28-333_D1,1,0,0,0,0,1
AATACCTGATGTGAAC-1_V12N28-333_D1,1,0,0,0,1,2
TAGAGTGTTCCGGGTA-1_V12N28-333_D1,1,1,0,0,0,2
GCTTCCATGTAACCGC-1_V12N28-333_D1,4,0,0,0,2,6
GGTTCGCATTTGCCGT-1_V12N28-333_D1,1,0,2,0,0,3
TCAATCCGGGAAGTTT-1_V12N28-333_D1,1,0,0,0,5,6
CCGGAAGTGCAATATG-1_V12N28-333_D1,3,0,0,0,2,5
CTCATAAATGTGTATA-1_V12N28-333_D1,2,2,0,0,2,6
GACGGGCATCGAATTT-1_V12N28-333_D1,2,0,0,0,2,4
GCTAAGCCCAGTATGC-1_V12N28-333_D1,5,1,0,0,2,8
GCTATAAGGGCCAGGA-1_V12N28-333_D1,7,0,0,0,0,7
GCGGATTACTTGTTCT-1_V12N28-333_D1,2,0,0,0,0,2
TACAACAGCGCATACA-1_V12N28-333_D1,1,0,0,0,0,1
TCTAACCTAGCCTGCG-1_V12N28-333_D1,2,0,0,0,0,2
TCTACCCGCATCATTT-1_V12N28-333_D1,4,1,0,0,1,6
GTCTTACCACGCCAAG-1_V12N28-333_D1,1,0,0,0,1,2
AATAACGTCGCGCCCA-1_V12N28-333_D1,0,0,0,0,1,1
CGTTTCGGTTATATGC-1_V12N28-333_D1,3,0,1,0,0,4
TACGCTGCACGGTCGT-1_V12N28-333_D1,0,0,0,0,1,1
CGTTAAATACGACCAG-1_V12N28-333_D1,0,0,0,0,0,0
TCGACTGACGATGGCT-1_V12N28-333_D1,0,0,0,0,0,0
ACGCTACTGAATGGGC-1_V12N28-333_D1,4,0,1,0,0,5
AAGGGTTAGCCATGCG-1_V12N28-333_D1,1,2,0,0,0,3
ACGTTTCGGTGCACTT-1_V12N28-333_D1,0,0,0,0,0,0
TTAACCCGAGGCGTGT-1_V12N28-333_D1,2,0,0,0,0,2
GCCCGTCAAGCCCAAT-1_V12N28-333_D1,0,0,0,0,0,0
ATTCGTCCCGAGGTTA-1_V12N28-333_D1,1,0,0,0,0,1
TCAAATTATGTTCGAC-1_V12N28-333_D1,1,0,0,0,0,1
AACGTTCTACCATTGT-1_V12N28-333_D1,2,0,0,0,1,3
TATCCCTCGATCTGCA-1_V12N28-333_D1,0,0,0,2,0,2
CTCTAACACCGGCAGC-1_V12N28-333_D1,0,1,0,1,1,3
GGCTGGCAATCCCACG-1_V12N28-333_D1,1,1,0,0,2,4
CAAACCATAAGCGTAT-1_V12N28-333_D1,0,0,0,2,0,2
CATGTGGGCTCATCAC-1_V12N28-333_D1,0,0,0,0,1,1
CCCGTGACAGTGCCTT-1_V12N28-333_D1,2,0,0,1,0,3
GATTATCTTGCATTAT-1_V12N28-333_D1,1,0,1,0,0,2
GAGTCCACCAGGTTTA-1_V12N28-333_D1,1,0,0,0,0,1
TGTACTATCGCTCGTT-1_V12N28-333_D1,1,0,1,0,0,2
TTAGCGAATAGATAGG-1_V12N28-333_D1,1,0,0,0,1,2
ACATACAATCAAGCGG-1_V12N28-333_D1,2,0,0,0,3,5
ATTCGTGTACCCATTC-1_V12N28-333_D1,3,0,0,0,0,3
GCTAGCAACGCACCTA-1_V12N28-333_D1,1,1,0,0,1,3
ACCTCAGCGAGGCGCA-1_V12N28-333_D1,1,0,0,1,1,3
TCCGGGCCACTAACGG-1_V12N28-333_D1,1,0,0,0,1,2
TCCCAATATCGACGAC-1_V12N28-333_D1,1,0,0,1,0,2
GGATTGAAGTAGCCTC-1_V12N28-333_D1,0,0,0,0,0,0
GGCGCACAGTTTACCT-1_V12N28-333_D1,0,0,0,0,2,2
CCCGGCACGTGTCAGG-1_V12N28-333_D1,2,1,0,0,0,3
AGTAAGGGACAGAATC-1_V12N28-333_D1,3,0,0,0,0,3
TTGCGCACAACCACGT-1_V12N28-333_D1,0,0,0,0,1,1
CCTGCTACAACCATAC-1_V12N28-333_D1,2,0,0,0,0,2
CTGGGCTACTGGAGAG-1_V12N28-333_D1,1,0,0,0,0,1
AGCTACGAATGGTGGT-1_V12N28-333_D1,0,0,0,0,0,0
ATTCGTTTATCGTATT-1_V12N28-333_D1,3,0,0,0,0,3
GGCATTCCCTCCCTCG-1_V12N28-333_D1,1,0,0,1,1,3
AGTTATTCAGACTGTG-1_V12N28-333_D1,1,0,0,0,0,1
CCACTTTCCTTCTAGG-1_V12N28-333_D1,0,0,0,0,0,0
CGCAGTTCTATCTTTC-1_V12N28-333_D1,2,0,0,0,0,2
AGGAGCGTTTATTATC-1_V12N28-333_D1,0,1,0,0,1,2
GACAGGTAATCCGTGT-1_V12N28-333_D1,1,0,0,0,0,1
TTCCCAAAGTACTGAT-1_V12N28-333_D1,0,0,0,0,1,1
CTGCAGGGTGACGCTC-1_V12N28-333_D1,1,1,0,0,0,2
TCATGGAGGCCTTTGT-1_V12N28-333_D1,2,1,0,0,1,4
ATGGCCCGAAAGGTTA-1_V12N28-333_D1,2,0,0,0,0,2
CGTAATATGGCCCTTG-1_V12N28-333_D1,1,0,0,1,0,2
AGAGTCTTAATGAAAG-1_V12N28-333_D1,2,0,0,0,0,2
GAACGTTTGTATCCAC-1_V12N28-333_D1,0,0,0,1,0,1
ATTGAATTCCCTGTAG-1_V12N28-333_D1,3,0,0,0,1,4
TACCTCACCAATTGTA-1_V12N28-333_D1,1,0,0,0,0,1
AGTCGAATTAGCGTAA-1_V12N28-333_D1,2,0,0,0,1,3
TTGAAGTGCATCTACA-1_V12N28-333_D1,0,0,0,0,0,0
