key,microglia,other,astrocyte,oligo,neuron,n_cells
GATAAGGGACGATTAG-1_V12N28-333_C1,0,2,0,1,0,3
GTGCAAATCACCAATA-1_V12N28-333_C1,1,2,0,0,0,3
TGTTGGCTGGCGGAAG-1_V12N28-333_C1,5,3,0,2,0,10
GCATCCTCTCCTATTA-1_V12N28-333_C1,3,7,0,0,0,10
GCGAGGGACTGCTAGA-1_V12N28-333_C1,3,6,0,2,0,11
TGGTACCGGCACAGCC-1_V12N28-333_C1,5,5,1,1,0,12
GCGCGTTTAAATCGTA-1_V12N28-333_C1,0,4,1,0,0,5
TGCCTTGCCCTTACGG-1_V12N28-333_C1,1,4,3,0,0,8
GACGACTTTCCAAGAA-1_V12N28-333_C1,0,2,1,1,0,4
CCAGTGAGCTCCTTGT-1_V12N28-333_C1,1,4,1,0,3,9
ATACCCTGGCTCAAAT-1_V12N28-333_C1,1,2,2,2,0,7
GGGTTTCCGGCTTCCA-1_V12N28-333_C1,2,3,1,1,0,7
TAACCGTCCAGTTCAT-1_V12N28-333_C1,0,6,1,2,0,9
AAACAACGAATAGTTC-1_V12N28-333_C1,1,2,0,1,0,4
CAAGGGAGTGTATTTG-1_V12N28-333_C1,1,1,0,6,0,8
CCAAGCTTGATCTCCT-1_V12N28-333_C1,0,5,0,2,0,7
TTATTTCATCCCAAAC-1_V12N28-333_C1,0,4,2,2,0,8
GAGCGCTATGTCAGGC-1_V12N28-333_C1,1,3,0,1,0,5
TATGGCAGACTTTCGA-1_V12N28-333_C1,0,4,0,2,0,6
CTTCGTGCCCGCATCG-1_V12N28-333_C1,0,1,0,3,0,4
AAACGGGTTGGTATCC-1_V12N28-333_C1,0,3,0,1,0,4
TGCAAACCCACATCAA-1_V12N28-333_C1,0,2,0,5,0,7
GACGGGATGTCTTATG-1_V12N28-333_C1,0,3,0,1,0,4
GGCGAGCATCGAGGAC-1_V12N28-333_C1,0,7,0,0,0,7
CGCGTGCTATCAACGA-1_V12N28-333_C1,2,3,2,2,0,9
TGAAACCTCAACTCAC-1_V12N28-333_C1,0,3,0,3,0,6
CACATAAGGCGACCGT-1_V12N28-333_C1,0,2,0,2,0,4
TGACCCAACTCACATT-1_V12N28-333_C1,0,3,0,2,0,5
ATACGCCGATCTACCG-1_V12N28-333_C1,0,3,0,2,0,5
ACTTATCTGATCTATA-1_V12N28-333_C1,0,6,0,0,0,6
GTGTGAGCCGAGGTGC-1_V12N28-333_C1,1,3,1,2,0,7
GATGATTTGAAACTGG-1_V12N28-333_C1,0,2,0,1,0,3
GGGAACCACCTGTTTC-1_V12N28-333_C1,0,4,1,2,0,7
GTTCGTTGCGGACCAG-1_V12N28-333_C1,0,3,0,1,0,4
TGAGGTTGATCCCAAG-1_V12N28-333_C1,0,1,0,2,0,3
GATGCCACACTACAGC-1_V12N28-333_C1,2,3,0,0,0,5
AGGCAAAGAGGAATCA-1_V12N28-333_C1,1,2,0,1,0,4
AAGTAAGCTTCCAAAC-1_V12N28-333_C1,1,5,1,1,0,8
AACGTAGTCTACCCAT-1_V12N28-333_C1,1,2,0,2,0,5
GTTTGAGCGGTTATGT-1_V12N28-333_C1,0,1,0,3,0,4
GAAGCAAGGCAATGTT-1_V12N28-333_C1,2,3,0,2,0,7
TCACTCAGCGCATTAG-1_V12N28-333_C1,1,3,0,0,0,4
TACAATGAAACCAGCA-1_V12N28-333_C1,1,2,0,1,0,4
GTGCGCTTACAAATGA-1_V12N28-333_C1,0,5,0,1,0,6
GCACTCCCACAGTCCC-1_V12N28-333_C1,0,2,0,0,0,2
CGAAGACTGCCCGGGA-1_V12N28-333_C1,0,1,3,0,0,4
CAGGATCCGCCCGACC-1_V12N28-333_C1,0,4,1,0,0,5
CACGATTGGTCGTTAA-1_V12N28-333_C1,3,1,0,5,0,9
GGTTGTATCGTGAAAT-1_V12N28-333_C1,1,1,3,7,0,12
TCTTATGGGTAGTACC-1_V12N28-333_C1,0,3,0,2,0,5
TACAAGCTGTTCACTG-1_V12N28-333_C1,0,2,1,4,0,7
GTATCTTGTTGCTCAC-1_V12N28-333_C1,0,1,2,5,0,8
ATACCAGGTGAGCGAT-1_V12N28-333_C1,0,1,2,1,0,4
CCTAAACAGGGTCCGT-1_V12N28-333_C1,0,1,3,2,1,7
ATGGTGCTCAAAGCCA-1_V12N28-333_C1,0,2,0,2,0,4
CAAATGCGGAGTGTTC-1_V12N28-333_C1,1,1,2,6,0,10
CGTGCCCGACATTTGT-1_V12N28-333_C1,0,3,1,6,0,10
GTATCTCCCTAACTGT-1_V12N28-333_C1,0,0,1,2,0,3
ATTTGCCTAGTTACGA-1_V12N28-333_C1,0,0,0,0,0,0
ACGTCCTAAACGAGAT-1_V12N28-333_C1,0,0,0,1,0,1
CTGGGATCGCCCAGAT-1_V12N28-333_C1,0,0,8,1,0,9
CTGCAAATGGGCTCCA-1_V12N28-333_C1,0,0,8,3,0,11
CATTATAACAGGGTCC-1_V12N28-333_C1,0,1,2,0,0,3
GTCTCGCCAACACGCC-1_V12N28-333_C1,0,1,0,1,0,2
TAAAGGAGAAACTAGT-1_V12N28-333_C1,0,0,1,1,1,3
TCCCACGGAGGGAGCT-1_V12N28-333_C1,0,0,0,1,1,2
AGCTTCAATACTTTGA-1_V12N28-333_C1,0,0,0,1,2,3
TTCCACATTTCTCGTC-1_V12N28-333_C1,0,6,0,2,0,8
ACAAACCGACAAGGCG-1_V12N28-333_C1,0,2,0,1,0,3
AGACGGGATTGGTATA-1_V12N28-333_C1,0,3,1,1,1,6
AACCTAAAGCCGTCCG-1_V12N28-333_C1,0,0,0,1,0,1
TACAAATTGCGGAGGT-1_V12N28-333_C1,0,0,0,0,0,0
CCCGCTAGAGGGTTAA-1_V12N28-333_C1,0,0,0,0,0,0
CATTGCAAAGCATAAT-1_V12N28-333_C1,2,0,1,0,0,3
TGTACGCTATCAGCTT-1_V12N28-333_C1,0,1,0,2,1,4
TTCTTCGCAATAGAGC-1_V12N28-333_C1,0,1,0,2,3,6
TGTGATTCCAGCGCTT-1_V12N28-333_C1,0,2,0,0,0,2
ATTCAGGATCGCCTCT-1_V12N28-333_C1,0,1,0,1,0,2
GCCCATGGGTGCAATG-1_V12N28-333_C1,0,3,0,1,0,4
TTCCCGACGCTTCACT-1_V12N28-333_C1,0,0,0,0,0,0
AGCGGTTGAGATGTAC-1_V12N28-333_C1,0,1,0,1,0,2
GCTGTCTGTGATCGAC-1_V12N28-333_C1,0,1,0,0,0,1
AAAGACATGAAGTTTA-1_V12N28-333_C1,1,1,0,0,0,2
CAACAGAATAACGCTA-1_V12N28-333_C1,0,2,0,1,1,4
TGCGGTCTACGAGTAA-1_V12N28-333_C1,0,1,0,0,2,3
AAGACTCACGCCCACT-1_V12N28-333_C1,0,1,0,0,0,1
CTTTGAAACATATTCC-1_V12N28-333_C1,0,2,0,1,1,4
CTGGGCACTAGTCGGA-1_V12N28-333_C1,0,4,0,1,0,5
CGCCCTTACATCCACC-1_V12N28-333_C1,0,0,0,0,1,1
CACGACCACAGACTTT-1_V12N28-333_C1,0,3,0,0,1,4
CAATCCATTATCCGTT-1_V12N28-333_C1,0,2,0,0,0,2
GTGGCGTGCACCAGAG-1_V12N28-333_C1,1,2,0,1,0,4
CGGAGTCCTAACCTGG-1_V12N28-333_C1,0,1,0,2,2,5
GGTCCCATAACATAGA-1_V12N28-333_C1,0,2,0,0,0,2
ATCTCATAAACCTACC-1_V12N28-333_C1,0,1,0,0,0,1
TGCATGGCAGTCTTGC-1_V12N28-333_C1,0,3,0,0,0,3
TTGCAGGTCATGAAGT-1_V12N28-333_C1,1,1,0,0,0,2
AGCTGCATTTGAGGTG-1_V12N28-333_C1,0,2,0,2,0,4
TAATCAGGAATGCTGC-1_V12N28-333_C1,0,3,0,0,0,3
CCATCATAAGAACAGG-1_V12N28-333_C1,0,2,0,2,1,5
TCGTATCACCAAGCTA-1_V12N28-333_C1,0,1,0,1,0,2
ATTCAGATGAATCCCT-1_V12N28-333_C1,1,0,0,0,0,1
AAAGGTCAACGACATG-1_V12N28-333_C1,0,1,0,0,1,2
AGCTGCTGTGCCGAAT-1_V12N28-333_C1,0,1,0,0,0,1
CTAGCGCCAATCCTAC-1_V12N28-333_C1,0,0,0,1,1,2
GCTCGACCGAACTGAA-1_V12N28-333_C1,0,4,0,1,1,6
ACAGTGCAGCGCATTT-1_V12N28-333_C1,0,3,0,1,0,4
CGGCTGAAGGTTACGC-1_V12N28-333_C1,0,2,0,1,0,3
CACCTCTACGAGTGTG-1_V12N28-333_C1,0,0,0,0,0,0
ATACGACAGATGGGTA-1_V12N28-333_C1,0,0,0,0,0,0
ACTTCCTGTCGTGCGA-1_V12N28-333_C1,0,1,0,0,1,2
CGTAACGGAACGATCA-1_V12N28-333_C1,0,0,0,0,0,0
AAATCACTCCTAAACG-1_V12N28-333_C1,0,3,0,0,1,4
CTCCGAGTAAATCCGC-1_V12N28-333_C1,0,6,0,0,1,7
ACGCTAGTATCAGTGC-1_V12N28-333_C1,0,3,0,0,0,3
AGAGTGAACAGACACC-1_V12N28-333_C1,0,2,1,0,0,3
ACACCCGTAAATCTGT-1_V12N28-333_C1,0,0,1,0,0,1
GCTTTGCTGCCGGGTA-1_V12N28-333_C1,0,2,0,0,0,2
ATCTATCGATGATCAA-1_V12N28-333_C1,0,6,0,1,0,7
CGGTAACAAGATACAT-1_V12N28-333_C1,4,4,0,3,0,11
TCGCCGGAGAGTCTTA-1_V12N28-333_C1,7,4,0,0,0,11
GGAGGAGTGTGTTTAT-1_V12N28-333_C1,4,2,0,2,0,8
TTAGGTGTGACTGGTC-1_V12N28-333_C1,2,4,0,2,0,8
CAGGGCTAACGAAACC-1_V12N28-333_C1,6,6,0,0,0,12
CCCGTGGGTTAATTGA-1_V12N28-333_C1,2,6,1,2,0,11
GACCGACCGCTAATAT-1_V12N28-333_C1,2,1,2,2,0,7
GGTATCAAGCATAGAA-1_V12N28-333_C1,1,2,0,1,0,4
TGCATGAGTAGATTCG-1_V12N28-333_C1,0,3,1,0,0,4
AATTCCAACTTGGTGA-1_V12N28-333_C1,2,3,0,2,0,7
TGCCGATGTCATCAAT-1_V12N28-333_C1,0,3,0,2,0,5
GCTGGGTCCGCTGTTA-1_V12N28-333_C1,0,3,1,1,0,5
TGAACACCCGAAGCAG-1_V12N28-333_C1,1,3,0,2,0,6
AACATTGGTCAGCCGT-1_V12N28-333_C1,0,4,0,1,0,5
GTGGGTCTTCTTTGCG-1_V12N28-333_C1,0,4,1,2,0,7
CATCGAATGGATCTCT-1_V12N28-333_C1,0,1,0,1,0,2
GCTACACTGTCCGAAC-1_V12N28-333_C1,1,5,0,3,0,9
CGGGTTGTAGCTTTGG-1_V12N28-333_C1,0,3,1,3,0,7
CCTAAGTGTCTAACCG-1_V12N28-333_C1,0,5,0,3,0,8
TCTGTGACTGACCGTT-1_V12N28-333_C1,1,4,0,3,0,8
TTATCATACTCGCAAA-1_V12N28-333_C1,3,3,1,3,0,10
AGCGTAGCGCTAGACC-1_V12N28-333_C1,0,2,1,0,0,3
TCCCTCCGAAATCGTT-1_V12N28-333_C1,0,0,1,5,0,6
AGGTCGCCACTTCGGT-1_V12N28-333_C1,0,3,0,2,0,5
CTAGCAACTAATTTAC-1_V12N28-333_C1,0,3,0,2,2,7
TTGCTAGCTACCAATC-1_V12N28-333_C1,1,3,0,3,0,7
GCCGGTTTGGGCGGAT-1_V12N28-333_C1,0,3,1,0,0,4
TGTAACTTGTCAACCT-1_V12N28-333_C1,0,3,0,1,0,4
CGAGATGTTGCCTATA-1_V12N28-333_C1,0,2,0,0,0,2
GTTACGAAATCCACGC-1_V12N28-333_C1,0,1,0,3,0,4
CTTGTCGTACGTGTCA-1_V12N28-333_C1,1,3,0,2,0,6
GCGTCCAGCTCGTGGC-1_V12N28-333_C1,1,2,0,1,0,4
CCCTTCTCGTACGCGA-1_V12N28-333_C1,1,3,0,1,0,5
CCAAAGTCCCGCTAAC-1_V12N28-333_C1,1,5,0,1,0,7
CCGCTTCGCGGTTAAC-1_V12N28-333_C1,1,3,0,1,0,5
GTTACGGCCCGACTGC-1_V12N28-333_C1,0,3,1,2,0,6
CCCGCTTGCCCTCGTC-1_V12N28-333_C1,1,2,0,2,0,5
TAGTGAGAAGTGGTTG-1_V12N28-333_C1,3,4,0,1,0,8
CGCTACCGCCCTATGA-1_V12N28-333_C1,0,3,0,1,0,4
AAACAATCTACTAGCA-1_V12N28-333_C1,0,4,1,1,0,6
GCGCGATGGGTCAAGT-1_V12N28-333_C1,0,3,0,1,0,4
ATAAACCATTGGACGG-1_V12N28-333_C1,0,4,1,3,0,8
TCGGGCACTTCTGGAT-1_V12N28-333_C1,0,2,0,0,0,2
TCTGTGGCTACATTTC-1_V12N28-333_C1,0,2,0,5,0,7
CTCTGTGCCTGCTATG-1_V12N28-333_C1,0,2,0,2,0,4
CACGACTAAAGTTCTG-1_V12N28-333_C1,1,1,0,3,0,5
GAGGAGTAATTCCTAC-1_V12N28-333_C1,0,3,0,1,0,4
AGAGGTATCTCGGTCC-1_V12N28-333_C1,0,2,0,2,0,4
GGCGTACCCTATATAA-1_V12N28-333_C1,0,3,0,4,0,7
GCCGGAAACACATCTT-1_V12N28-333_C1,4,0,0,0,0,4
AAATGTGGGTGCTCCT-1_V12N28-333_C1,0,2,0,3,0,5
ACCAGGAGTGTGATCT-1_V12N28-333_C1,0,2,2,3,0,7
TGTGGAGGAAGCTTAA-1_V12N28-333_C1,0,1,0,4,0,5
AAGGAGAACTTATAAG-1_V12N28-333_C1,1,4,0,4,0,9
CCCTCGGGAGCCTTGT-1_V12N28-333_C1,0,4,0,3,0,7
ACTGTTTAGTGTAGGC-1_V12N28-333_C1,0,3,0,2,0,5
CGTCAGTTTATCGTCT-1_V12N28-333_C1,0,1,1,4,0,6
GCGTGTATGTCGTATT-1_V12N28-333_C1,1,0,3,1,0,5
ACAATCGATCTTTATA-1_V12N28-333_C1,0,0,2,2,1,5
CAGCCCTCACAGGCAG-1_V12N28-333_C1,0,0,6,5,0,11
CGCGTCATATTAAACC-1_V12N28-333_C1,0,0,2,3,0,5
GAAGACTTCAATGCCG-1_V12N28-333_C1,0,0,6,1,0,7
ACCAAACTAGAAATCC-1_V12N28-333_C1,0,1,0,0,0,1
GAATCTATACTCGGAC-1_V12N28-333_C1,0,0,0,0,0,0
TCGGCTAACTTCCCTT-1_V12N28-333_C1,0,1,0,0,0,1
ACGTGGTCGAATGTGC-1_V12N28-333_C1,0,1,0,0,0,1
ATATCGTGCCAGACCC-1_V12N28-333_C1,0,0,0,0,0,0
GTAGCTAGTAAGCGCG-1_V12N28-333_C1,0,2,0,0,0,2
ACGCTTAGTGTCTCTC-1_V12N28-333_C1,0,1,0,0,1,2
TCCGGCCTGCATCGAT-1_V12N28-333_C1,0,2,0,1,0,3
TAGTGGAACTCATACA-1_V12N28-333_C1,0,1,0,2,0,3
ATCATCTGCCCAGTGT-1_V12N28-333_C1,2,2,0,0,0,4
GTTATTAAATACGACC-1_V12N28-333_C1,1,1,1,0,0,3
GCGCTAAGTATGCATG-1_V12N28-333_C1,0,1,0,1,0,2
CCTGACGCAACCTTTA-1_V12N28-333_C1,0,1,0,0,0,1
CCCAAGAATGCACGGT-1_V12N28-333_C1,0,0,0,1,0,1
AACTGGGTTCGAGCCG-1_V12N28-333_C1,1,1,0,1,0,3
GGTTCCACCCGCTTCT-1_V12N28-333_C1,0,1,0,1,1,3
CATGCACGTGTTACTG-1_V12N28-333_C1,0,1,0,0,0,1
AGCGTTCCGATTTAAA-1_V12N28-333_C1,0,3,1,0,0,4
CCTACGCGACCTTACA-1_V12N28-333_C1,0,2,0,2,2,6
CGAATTACATGGTGTT-1_V12N28-333_C1,0,1,0,1,0,2
GAGGTCTTAGTGGGTC-1_V12N28-333_C1,1,3,0,0,0,4
GCCGCTAGATACGCAG-1_V12N28-333_C1,0,1,0,0,1,2
GTCACCTGTCTATGTC-1_V12N28-333_C1,0,2,0,1,1,4
CCGATTGGTCAATGAA-1_V12N28-333_C1,0,3,0,0,0,3
CCTGTGCGGATTGTAA-1_V12N28-333_C1,0,1,0,0,1,2
TTACGTAGCGCGTGCT-1_V12N28-333_C1,0,1,0,0,1,2
GGAGGCGAAGAACCGC-1_V12N28-333_C1,0,1,0,1,0,2
GGGTCACGTGCTTATG-1_V12N28-333_C1,0,0,0,0,0,0
GCTCCGGACGTTGATA-1_V12N28-333_C1,0,3,0,2,0,5
ATGTTTGTAAGATCAT-1_V12N28-333_C1,0,3,0,0,0,3
TGACCCAGCATTCCCG-1_V12N28-333_C1,0,2,0,1,0,3
TGGTCGTTTGATAGAT-1_V12N28-333_C1,1,1,0,0,0,2
TGTAATGCCTTCGGAC-1_V12N28-333_C1,0,7,0,1,0,8
TGCTCACACAACAACC-1_V12N28-333_C1,1,1,0,0,0,2
TACGATCCAAGCCACT-1_V12N28-333_C1,0,3,0,0,1,4
TTGTAACTTCATAGCG-1_V12N28-333_C1,0,1,0,0,0,1
AGATTCAAGCGGGTCG-1_V12N28-333_C1,1,2,0,0,1,4
CTCAGCAGACTGCCGA-1_V12N28-333_C1,0,3,0,1,1,5
GTAACATCAGCTCATC-1_V12N28-333_C1,0,1,0,0,0,1
ATGGAACAGAATAAAC-1_V12N28-333_C1,0,0,0,1,1,2
GGGCCTATACAACCGG-1_V12N28-333_C1,0,2,0,3,2,7
TCAAACAATTAGGACA-1_V12N28-333_C1,0,1,0,0,0,1
AAACCACTACACAGAT-1_V12N28-333_C1,2,2,0,0,0,4
AAACGACAGTCTTGCC-1_V12N28-333_C1,0,6,0,0,1,7
TTGAGGGTCGAACGCG-1_V12N28-333_C1,0,3,0,0,0,3
TGTTGATCACTGTTTA-1_V12N28-333_C1,0,0,0,0,0,0
AGGGTGTGCTACACGC-1_V12N28-333_C1,0,0,0,0,1,1
AATGGCCGCCAATGCG-1_V12N28-333_C1,0,0,0,0,0,0
TCGGCGGTATTAGATT-1_V12N28-333_C1,0,1,0,0,0,1
GGGTCACTGAGTAGTG-1_V12N28-333_C1,0,1,0,0,0,1
GAATTATGCAACCTAC-1_V12N28-333_C1,0,0,0,0,0,0
GATCTTAGTGAACGTG-1_V12N28-333_C1,0,3,0,0,0,3
GCCACCCATTCCACTT-1_V12N28-333_C1,0,0,0,0,0,0
TACTCACAACGTAGTA-1_V12N28-333_C1,4,2,0,1,0,7
GTTCGGTGTGGATTTA-1_V12N28-333_C1,1,8,0,1,0,10
TCTTTCGGCGGGACAC-1_V12N28-333_C1,1,5,0,4,0,10
GGAGACATTCACGGGC-1_V12N28-333_C1,6,5,0,1,0,12
GGGATTATCTCACAAC-1_V12N28-333_C1,2,4,0,0,0,6
TAGAACGCCAGTAACG-1_V12N28-333_C1,1,5,0,1,0,7
ACGAGTCGCCGGCGTT-1_V12N28-333_C1,1,2,0,2,0,5
TGATGGGACTAAGTCA-1_V12N28-333_C1,1,5,0,1,0,7
TGCGAGAAACGTTACG-1_V12N28-333_C1,1,5,0,1,0,7
TCGCCTCGACCTGTTG-1_V12N28-333_C1,4,1,0,0,0,5
AACTCGATAAACACGT-1_V12N28-333_C1,0,4,0,3,0,7
AGGAAAGCCTCTGATG-1_V12N28-333_C1,0,4,1,3,0,8
GAAGGACTAAATTGAA-1_V12N28-333_C1,1,3,0,4,0,8
GTATCGGGACGAGCTG-1_V12N28-333_C1,2,2,0,4,0,8
CCTGTGCATAGGAGAC-1_V12N28-333_C1,0,1,0,3,0,4
CATACGGGTGCATGAT-1_V12N28-333_C1,0,1,0,3,0,4
CCACTAAACTGAATCG-1_V12N28-333_C1,1,1,1,1,0,4
AAATTGCGGCGGTTCT-1_V12N28-333_C1,1,2,0,1,0,4
AGTCCAGCGGGTACGT-1_V12N28-333_C1,2,4,0,2,0,8
CATTCAGGTCAGTGCG-1_V12N28-333_C1,0,3,2,0,0,5
CTAAAGTCCGAAGCTA-1_V12N28-333_C1,0,1,0,1,0,2
AATCAGACTGCAGGAC-1_V12N28-333_C1,1,3,0,3,0,7
AGTATCCATAATAACG-1_V12N28-333_C1,0,3,0,0,0,3
CTGGCTGCTAACGTAA-1_V12N28-333_C1,1,4,0,4,0,9
GTTCCAAGACAGCGAC-1_V12N28-333_C1,1,3,1,0,0,5
AAGACTAACCCGTTGT-1_V12N28-333_C1,0,0,1,2,0,3
GATTAATCCTGGCTCA-1_V12N28-333_C1,1,5,0,2,0,8
CGCGCAAGGAACTACA-1_V12N28-333_C1,0,4,0,1,0,5
CAGTAGCGAGGTAGTA-1_V12N28-333_C1,0,5,0,3,0,8
ACGGCGGGTTGCCCTG-1_V12N28-333_C1,2,3,0,5,0,10
CTAGGCGGCAGAGAAT-1_V12N28-333_C1,0,1,0,0,0,1
GTGCGCAGCTTGCTCC-1_V12N28-333_C1,0,1,1,2,0,4
TCACTATCGTGCAATC-1_V12N28-333_C1,0,4,1,2,0,7
TATGATTCTGCTTGGT-1_V12N28-333_C1,0,5,0,3,0,8
TAAGATTTAGCGGGAG-1_V12N28-333_C1,0,1,0,4,0,5
TTACGGTGTCACCGAG-1_V12N28-333_C1,0,3,0,2,0,5
CTACACTAGCTTGTTC-1_V12N28-333_C1,0,4,0,0,0,4
TGAGCAGTCGTGAAGT-1_V12N28-333_C1,0,2,2,3,0,7
CGCTGAGGACGTCCAA-1_V12N28-333_C1,2,3,0,4,0,9
GTGTATGACTTTAAAG-1_V12N28-333_C1,0,4,0,2,0,6
CTAAACGGGTGTAATC-1_V12N28-333_C1,0,4,0,1,0,5
TGTACTGTGCCAAAGT-1_V12N28-333_C1,1,6,0,3,0,10
GGCCACAAGCGATGGC-1_V12N28-333_C1,0,1,0,4,0,5
GTCAATTGTACTGAAG-1_V12N28-333_C1,1,4,0,2,0,7
AGGGACAGCACGGCGG-1_V12N28-333_C1,0,1,0,4,0,5
AGCTTATAGAGACCTG-1_V12N28-333_C1,0,2,0,0,0,2
AACTAGCGTATCGCAC-1_V12N28-333_C1,0,2,1,2,0,5
AACTTTAGCTGCTGAG-1_V12N28-333_C1,0,3,3,1,0,7
CCCAAGACAGAGTATG-1_V12N28-333_C1,1,2,0,2,0,5
GGCATCAACGAGCACG-1_V12N28-333_C1,1,1,2,2,0,6
ATGCATTCCGTGATGG-1_V12N28-333_C1,0,2,0,4,0,6
TTATAGATGCACATTA-1_V12N28-333_C1,0,3,0,2,0,5
GAACCATCTGGGAGAC-1_V12N28-333_C1,2,2,0,1,0,5
TGCTATACAAACGGAC-1_V12N28-333_C1,0,2,1,5,0,8
ACTTGCCATATTGTAC-1_V12N28-333_C1,0,2,0,3,0,5
TATTCCGGCAGTCCTA-1_V12N28-333_C1,0,3,0,2,0,5
GACGGACCGCGTTCCT-1_V12N28-333_C1,0,2,0,5,0,7
ATGTGTAGTTTAGTCA-1_V12N28-333_C1,1,4,0,3,0,8
ATACCAGCAAATTGCT-1_V12N28-333_C1,0,3,0,3,0,6
AAGTTTACTAATGGCA-1_V12N28-333_C1,0,2,0,4,0,6
CTCTCGATGTGCGCCT-1_V12N28-333_C1,1,0,5,5,0,11
GATTGACACTCTGCTC-1_V12N28-333_C1,0,0,2,1,1,4
TATCACAGCACGGGCA-1_V12N28-333_C1,0,0,7,5,1,13
ACCGTTCCCGCTCTGA-1_V12N28-333_C1,0,0,3,5,1,9
CCGCCACCACAATCCA-1_V12N28-333_C1,0,6,2,2,0,10
CATTCACTGACAGCTA-1_V12N28-333_C1,1,0,2,2,0,5
CGGCTGCAAGATTAAG-1_V12N28-333_C1,0,3,1,1,0,5
CATGAACCTCTTATCA-1_V12N28-333_C1,0,5,0,4,0,9
TTAATGCGAGGTAACT-1_V12N28-333_C1,0,0,0,0,0,0
AATAAGTCCTCGAGAC-1_V12N28-333_C1,0,2,0,4,0,6
ACCAGCCCGGTCTTTG-1_V12N28-333_C1,0,0,0,0,0,0
CTACGAACTAGGTCGA-1_V12N28-333_C1,0,2,0,5,0,7
CACTACTCAGTTCTGT-1_V12N28-333_C1,0,1,0,2,0,3
CGGAAATTTCACATCC-1_V12N28-333_C1,1,0,0,0,0,1
ATCCACGCTAAATGTT-1_V12N28-333_C1,0,0,0,0,0,0
GTTCAATCTATGTCAA-1_V12N28-333_C1,1,2,0,2,1,6
ATAAAGGTCAAGTACG-1_V12N28-333_C1,0,1,0,0,1,2
CAACTCCAACGTTTAG-1_V12N28-333_C1,0,1,0,0,1,2
TAGGAACAGCCTCCAG-1_V12N28-333_C1,0,0,2,0,0,2
ATGGGAACGGAAGCGG-1_V12N28-333_C1,0,0,0,1,0,1
CACACGTTTCAATGGG-1_V12N28-333_C1,0,2,0,1,0,3
GGTGTTCTGTTTCTAC-1_V12N28-333_C1,0,0,0,0,0,0
AGTAACGTTCATCCTG-1_V12N28-333_C1,0,2,0,1,0,3
GTATAGTGGCCCATGT-1_V12N28-333_C1,0,2,0,3,0,5
TCTACACGTTCATGCA-1_V12N28-333_C1,0,0,0,0,0,0
AATCTGGGTAGACCCT-1_V12N28-333_C1,0,1,0,1,1,3
TCGGTTAGCCATGTAG-1_V12N28-333_C1,0,1,0,1,0,2
TGCCATGGCTTATAAG-1_V12N28-333_C1,1,4,1,0,1,7
TAAGTAAATGTGCCGC-1_V12N28-333_C1,0,2,0,3,0,5
GTGTCCGATAAGGCAT-1_V12N28-333_C1,0,1,0,1,0,2
TGGCACGAGCTCGAGT-1_V12N28-333_C1,0,2,0,1,1,4
ACCGGTCTGAGTACGG-1_V12N28-333_C1,0,1,0,0,1,2
GAACTTAGCGCCCGGT-1_V12N28-333_C1,0,1,0,0,0,1
AGTAGCTAGACGCCGA-1_V12N28-333_C1,0,4,0,1,1,6
ATAGGAATCTAAGCTT-1_V12N28-333_C1,0,1,0,0,0,1
CTTCCTGCATATTTAC-1_V12N28-333_C1,0,0,0,0,1,1
CAATATGTAGATTTAC-1_V12N28-333_C1,0,6,1,1,0,8
ACAAGGCCTACCAGCC-1_V12N28-333_C1,1,1,0,1,0,3
TTATAGTCCAAGGTGC-1_V12N28-333_C1,1,1,0,0,0,2
AAACGCCCGAGATCGG-1_V12N28-333_C1,0,1,0,0,0,1
CCTCGTTACGCCTGTT-1_V12N28-333_C1,0,3,0,0,0,3
GAACGGTGTAAAGCAG-1_V12N28-333_C1,0,1,0,2,0,3
ACGCATAAATGACATG-1_V12N28-333_C1,0,3,0,1,1,5
GGTTCGATGCTGAGTT-1_V12N28-333_C1,0,1,0,0,1,2
CTTTGGCAGACAGAGT-1_V12N28-333_C1,0,1,0,0,0,1
TTCGTGGGCTGGAAGC-1_V12N28-333_C1,0,1,0,0,2,3
CAAAGGTTAAATTCAG-1_V12N28-333_C1,0,1,0,0,1,2
GTTTGGCGTCAGGCAC-1_V12N28-333_C1,0,2,0,0,2,4
GCTTTCTATCTCAACT-1_V12N28-333_C1,0,2,0,0,1,3
TGCATCTCCGGATCTT-1_V12N28-333_C1,0,1,1,2,2,6
CTGAAACGGCCCTCAG-1_V12N28-333_C1,0,2,0,0,0,2
TAGCAGTAAATACGCG-1_V12N28-333_C1,0,3,2,0,0,5
CGGGCTACTTAAATTG-1_V12N28-333_C1,0,1,0,1,0,2
ATTATGCTCAGTATTG-1_V12N28-333_C1,0,2,0,0,0,2
TGATGCTCACGTAGTC-1_V12N28-333_C1,0,1,0,0,0,1
GTCTAAGATGCCCAGC-1_V12N28-333_C1,0,1,0,0,0,1
AACCCGATAGGGCTTC-1_V12N28-333_C1,0,2,0,0,0,2
CGCTATCGTGGCTTTA-1_V12N28-333_C1,0,3,0,0,0,3
CGTCTCTCGCCGAGGC-1_V12N28-333_C1,0,2,0,0,1,3
GGTCTTGGTGTTAACT-1_V12N28-333_C1,9,2,0,3,0,14
GGCTGGCAGCTTTATG-1_V12N28-333_C1,1,6,0,1,0,8
CGCCAATTATTGCGTT-1_V12N28-333_C1,2,3,0,2,0,7
GGTAACCGGCAAAGGT-1_V12N28-333_C1,4,5,0,3,0,12
TGGGACCATTGGGAGT-1_V12N28-333_C1,2,4,1,2,0,9
CTGCAGGTGCTCGGCC-1_V12N28-333_C1,0,6,0,3,0,9
CCGGTGCGAGTGATAG-1_V12N28-333_C1,0,3,0,4,0,7
GGGTACACTCTGGAGG-1_V12N28-333_C1,1,3,3,2,0,9
TAGCCAGAGGGTCCGG-1_V12N28-333_C1,1,3,1,3,0,8
CTTGTGAGGACAGCGG-1_V12N28-333_C1,1,1,0,1,0,3
GAAGGGCATAACCATG-1_V12N28-333_C1,0,5,2,1,0,8
CAACATGGCCTGATAA-1_V12N28-333_C1,1,2,0,3,0,6
CAATTTGACCGGGAAG-1_V12N28-333_C1,2,1,0,1,0,4
TCTGACTGTAATGGTT-1_V12N28-333_C1,2,2,0,1,0,5
TTCATAGCCTTGTAAC-1_V12N28-333_C1,0,2,0,1,0,3
TGGAAACGGAGTGAAC-1_V12N28-333_C1,0,1,0,4,0,5
ATCGCACGATTGTTCA-1_V12N28-333_C1,2,2,0,3,0,7
CGCCACCCGCATTAAC-1_V12N28-333_C1,2,4,0,3,0,9
TGGACCACGGCGTTGA-1_V12N28-333_C1,0,3,0,1,0,4
GTATATGTTACGGCGG-1_V12N28-333_C1,0,1,2,0,0,3
GTATTCTTACCGTGCT-1_V12N28-333_C1,1,0,2,5,0,8
TTCAGAGTAACCTGAC-1_V12N28-333_C1,1,2,0,1,0,4
GCGGTAACCCAAATGA-1_V12N28-333_C1,0,2,1,0,0,3
CTACGTGTTGCCACCA-1_V12N28-333_C1,0,4,0,1,0,5
CTAGATAAACTCCTCG-1_V12N28-333_C1,0,4,1,1,0,6
TCCATTAGTTGGATAG-1_V12N28-333_C1,1,1,0,5,0,7
CTGGCTCCTGCGGGAT-1_V12N28-333_C1,1,3,0,2,0,6
CAGTCTCTCGGCTAAT-1_V12N28-333_C1,0,3,2,2,0,7
GTATGACGTGGGAAAC-1_V12N28-333_C1,1,4,0,1,0,6
AGTCACTCCGCCTCAT-1_V12N28-333_C1,2,4,0,1,0,7
GCAGCGGTGGGCATTA-1_V12N28-333_C1,0,5,0,0,0,5
TATGGAGTTTCTCGTT-1_V12N28-333_C1,1,0,0,2,0,3
ACTCAACGAATGTATT-1_V12N28-333_C1,0,3,0,2,0,5
AACACGCGGCCGCGAA-1_V12N28-333_C1,0,1,0,1,0,2
CGATATTAGCCGCAGG-1_V12N28-333_C1,0,2,2,3,0,7
AGCGTCTGAACCCGCA-1_V12N28-333_C1,0,0,2,3,0,5
GATGTCCGGATCACAT-1_V12N28-333_C1,0,8,0,0,0,8
GGTCACGTTAGATTCA-1_V12N28-333_C1,1,4,0,5,0,10
TTAAGGATACGGAGGT-1_V12N28-333_C1,0,4,0,2,0,6
GTGCGGGACCATCGGC-1_V12N28-333_C1,2,2,0,2,0,6
CCATCTTGTTCACAAT-1_V12N28-333_C1,0,1,0,0,0,1
TCCGAGAAGGCTAAGC-1_V12N28-333_C1,2,1,0,0,0,3
TGGCGGTGTGCGATTG-1_V12N28-333_C1,0,2,1,4,0,7
ATCCTGCTGCAGATAG-1_V12N28-333_C1,0,1,1,1,0,3
TTATGCGTCCCGGTCC-1_V12N28-333_C1,0,2,0,0,0,2
CATAATGAGCGGGCGA-1_V12N28-333_C1,0,1,0,3,0,4
AGACATAGATCCTTCC-1_V12N28-333_C1,0,3,0,0,0,3
GGTGAAACCGGGAATG-1_V12N28-333_C1,1,5,1,3,0,10
AACTGGTGTGGGCCTT-1_V12N28-333_C1,0,1,0,0,0,1
GTAGCGCTGTTGTAGT-1_V12N28-333_C1,1,1,0,0,0,2
TTGTTTGTGTAAATTC-1_V12N28-333_C1,2,3,0,3,0,8
GGATCAAAGGACGAGG-1_V12N28-333_C1,0,4,0,1,0,5
CGTAGCGCCGACGTTG-1_V12N28-333_C1,0,0,0,2,0,2
CAAGTGAACTTTGGTT-1_V12N28-333_C1,0,1,1,2,0,4
GTAGACAACCGATGAA-1_V12N28-333_C1,0,2,0,3,0,5
CAATGGTCGGCCTGGG-1_V12N28-333_C1,0,3,0,2,0,5
ACAGATTAGGTTAGTG-1_V12N28-333_C1,1,1,0,3,0,5
GTTATCACCTTCTGAA-1_V12N28-333_C1,0,1,2,3,0,6
TGGTATCGGTCTGTAT-1_V12N28-333_C1,2,1,0,3,0,6
GGAATAACCTCAAGAA-1_V12N28-333_C1,1,1,1,4,0,7
ATTATCTCGACAGATC-1_V12N28-333_C1,0,3,0,3,0,6
CCGAGGGATGTTAGGC-1_V12N28-333_C1,1,0,3,4,0,8
TGAGATCAAATACTCA-1_V12N28-333_C1,0,0,3,6,0,9
AAACGAAGAACATACC-1_V12N28-333_C1,0,0,9,5,0,14
CTGGTCCTAACTTGGC-1_V12N28-333_C1,0,0,7,1,2,10
TGCACGAGTCGGCAGC-1_V12N28-333_C1,0,0,13,1,0,14
ATAGTCTTTGACGTGC-1_V12N28-333_C1,0,0,5,1,0,6
TGGAGCTAAAGTTCCC-1_V12N28-333_C1,0,1,0,2,0,3
GGGTGGTCCAGCCTGT-1_V12N28-333_C1,0,6,0,2,0,8
CATGCATGGAGACCCT-1_V12N28-333_C1,0,4,0,3,0,7
ACACGGCACTATGCAT-1_V12N28-333_C1,0,4,0,5,0,9
CCCTGGTATGGGCGGC-1_V12N28-333_C1,0,1,0,3,0,4
GGAGGATTGAAAGGAG-1_V12N28-333_C1,0,0,0,2,0,2
CCGCTGGTGCCATTCA-1_V12N28-333_C1,0,0,0,3,0,3
GTTAGAGTGTGCCGCT-1_V12N28-333_C1,0,0,1,6,0,7
TCGGAATGACCATCAA-1_V12N28-333_C1,0,0,0,0,0,0
TTCAATTAGCCATAAT-1_V12N28-333_C1,0,0,0,0,0,0
ACCACAACTCAGAACA-1_V12N28-333_C1,0,0,0,4,0,4
GATCCTCTTGCGCTTA-1_V12N28-333_C1,0,1,0,0,0,1
TTCTACCTTTATGTTG-1_V12N28-333_C1,0,0,0,1,0,1
GAAATACCTGCTGGCT-1_V12N28-333_C1,0,0,0,3,0,3
ATTCTGAGTATGAACT-1_V12N28-333_C1,0,1,0,3,0,4
GGATTAAGCTAAGGTC-1_V12N28-333_C1,0,1,3,1,0,5
AGTACGTGGCCTGTCT-1_V12N28-333_C1,0,1,0,0,0,1
TCAGGGTGCACGAAAC-1_V12N28-333_C1,0,1,0,1,0,2
AAATTTACCGAAATCC-1_V12N28-333_C1,0,1,0,2,0,3
TTGAGGCATTTAACTC-1_V12N28-333_C1,0,2,1,3,0,6
AACCAGTATCACTCTT-1_V12N28-333_C1,0,0,0,1,0,1
CACCGGAGATATCTCC-1_V12N28-333_C1,0,2,0,0,0,2
GACTGGGCGCCGCAAC-1_V12N28-333_C1,0,4,1,1,0,6
CACGTCTATGATGTGG-1_V12N28-333_C1,0,1,1,1,0,3
TTAAGACGAACGAACC-1_V12N28-333_C1,0,1,0,3,1,5
TGACCAGCTTCAAAGT-1_V12N28-333_C1,0,1,0,3,0,4
AGAGTTAGAGACCGAT-1_V12N28-333_C1,0,1,0,0,0,1
TTCGGACTGATGCCTT-1_V12N28-333_C1,1,1,0,0,0,2
CTCGAATGGAACGTAT-1_V12N28-333_C1,0,1,0,1,0,2
GGACGGCTTGCGCAAC-1_V12N28-333_C1,0,1,2,1,0,4
CTAAGTACAGGGCTAC-1_V12N28-333_C1,0,1,0,0,0,1
ACAAATTCAGATCTGA-1_V12N28-333_C1,0,1,0,0,2,3
CATGGAAATGGGACCA-1_V12N28-333_C1,1,3,0,2,0,6
GGTGGACCACGTGTTA-1_V12N28-333_C1,0,1,0,2,1,4
CACGACGTAATAGTAA-1_V12N28-333_C1,1,4,0,1,1,7
CGGGTTCGGCACGTAT-1_V12N28-333_C1,0,1,0,0,0,1
CTGGGCTATCCTTTGG-1_V12N28-333_C1,1,2,2,2,4,11
GTATTAGGGTTCGCGT-1_V12N28-333_C1,0,3,0,0,0,3
TCATTCGTATAATTTG-1_V12N28-333_C1,0,3,0,1,0,4
AATAGCAAGCCTCCTG-1_V12N28-333_C1,0,1,0,2,0,3
CATCTACCCGAGAACG-1_V12N28-333_C1,0,0,0,0,0,0
GCTTCAGTGGGATTAC-1_V12N28-333_C1,0,1,0,0,0,1
TCTGTGATGGAGGTTG-1_V12N28-333_C1,0,2,0,1,1,4
ATCCACTTTCAGACTA-1_V12N28-333_C1,0,1,0,2,1,4
ATGGTTACGAAACATG-1_V12N28-333_C1,0,1,0,0,1,2
GGCCCAATCTAGAGGG-1_V12N28-333_C1,0,2,0,0,2,4
GATGGTGAAATAACCC-1_V12N28-333_C1,0,2,0,0,2,4
AGAGGGACAATTGTCC-1_V12N28-333_C1,0,1,0,0,1,2
CGCGTACATTCTGGAA-1_V12N28-333_C1,0,1,0,1,0,2
CAAGAAACCCTAAACT-1_V12N28-333_C1,0,2,0,0,0,2
TTGGTGCGGTGTTGAA-1_V12N28-333_C1,0,3,0,1,0,4
GGTTCCCTAGTGTCTC-1_V12N28-333_C1,1,1,0,0,0,2
CGATAACCAATTTGAG-1_V12N28-333_C1,0,2,0,0,0,2
GCCCACTGGTCCACAA-1_V12N28-333_C1,0,2,0,0,0,2
GAGGGCCGGCAGAGTC-1_V12N28-333_C1,0,1,2,0,0,3
CGACACGGATGCCCAC-1_V12N28-333_C1,0,1,0,0,0,1
CTGTCTGTGGCTGGCT-1_V12N28-333_C1,1,4,0,1,0,6
ATATTATCCCGTATTT-1_V12N28-333_C1,5,1,0,1,0,7
GCGCTGGCGGAAAGTC-1_V12N28-333_C1,1,4,0,3,0,8
ATCTAACGTCCCTATG-1_V12N28-333_C1,0,1,0,2,0,3
GTCAGACAGCGTTGGA-1_V12N28-333_C1,1,2,0,4,0,7
GCCAGGCTTAGTGGTA-1_V12N28-333_C1,0,6,0,0,0,6
ATTCAAAGTACCTGTT-1_V12N28-333_C1,0,6,0,2,0,8
TGGACGTAGGCGAATC-1_V12N28-333_C1,2,3,1,0,0,6
ACACATTGACGCAACA-1_V12N28-333_C1,2,4,1,2,0,9
GATATCAGTATGTATC-1_V12N28-333_C1,1,4,0,1,0,6
TGGGCCTTGCCTGCAT-1_V12N28-333_C1,1,0,0,2,0,3
CAAAGTCAGGTTAGCT-1_V12N28-333_C1,0,5,0,0,0,5
GGATCCCTACCAGCTA-1_V12N28-333_C1,0,1,0,0,0,1
ATCGTCCAATCGAGTC-1_V12N28-333_C1,0,2,0,4,0,6
ACATGGCTCAATTTAG-1_V12N28-333_C1,0,1,0,2,0,3
AGGCCCAGTGACTGGT-1_V12N28-333_C1,1,1,0,1,0,3
GCTTCCAGCTTAGATT-1_V12N28-333_C1,0,3,0,1,0,4
TGCTTGAAACCATGCA-1_V12N28-333_C1,0,2,0,1,0,3
CAATATTGGACTAGTG-1_V12N28-333_C1,0,3,0,0,0,3
CGTGCTGGCCTAGTCG-1_V12N28-333_C1,0,1,0,5,0,6
CCTGCGATAGAACTGT-1_V12N28-333_C1,1,3,0,2,0,6
GGGTAATGCTGTGTTT-1_V12N28-333_C1,2,0,0,5,0,7
AACGCGAACGGCAACA-1_V12N28-333_C1,2,2,1,1,0,6
TGTCGGCATGGTGGAA-1_V12N28-333_C1,0,0,0,0,0,0
AGCGTACGAGAGCTAG-1_V12N28-333_C1,0,5,0,2,0,7
ATACTCTCGCCACTCT-1_V12N28-333_C1,0,1,0,1,0,2
AATCCATGCAAGGGTG-1_V12N28-333_C1,0,5,0,2,0,7
TTAAACAGAGTCCCGC-1_V12N28-333_C1,2,2,0,1,0,5
CCACAGCTGAAATCAT-1_V12N28-333_C1,0,2,0,2,1,5
CGGTTCCGGCTTCTTG-1_V12N28-333_C1,1,1,0,4,0,6
GACGTGAGACTCCATG-1_V12N28-333_C1,0,5,1,5,0,11
TCGTTGGCTCGTCAAT-1_V12N28-333_C1,1,2,0,1,0,4
GGTGAACGGGCTAGCC-1_V12N28-333_C1,0,2,0,3,0,5
GCACTGTGCAAATGTA-1_V12N28-333_C1,0,2,0,4,0,6
ACGAGAACCCATCACG-1_V12N28-333_C1,0,3,0,1,0,4
CCAGCTACGCCTCATA-1_V12N28-333_C1,0,3,0,0,0,3
TCCCGGTCAGGAATTT-1_V12N28-333_C1,0,3,0,2,0,5
TCGCATTCAATGACTT-1_V12N28-333_C1,1,0,0,2,0,3
CTGGTTCAACGCATCA-1_V12N28-333_C1,0,2,1,2,0,5
GGTGATTTCATCTTGT-1_V12N28-333_C1,1,0,0,3,0,4
CACCCTTTCCTCGCTC-1_V12N28-333_C1,0,5,1,0,0,6
CAACTTGTAGTGGGCA-1_V12N28-333_C1,0,2,0,1,0,3
AATATCAAGGTCGGAT-1_V12N28-333_C1,0,1,0,2,0,3
ACTCAGACCTGCTTCT-1_V12N28-333_C1,2,2,2,0,0,6
TTGGAGTCTCCCTTCT-1_V12N28-333_C1,2,4,0,3,0,9
GGATACTCATGAATTG-1_V12N28-333_C1,0,1,0,1,0,2
TGGGCACAAACAGAAC-1_V12N28-333_C1,1,5,0,2,0,8
GAGCCACGGTAGTAGG-1_V12N28-333_C1,0,3,0,3,0,6
TCGATAGGCTAGTCGC-1_V12N28-333_C1,0,2,1,0,0,3
TAACCGCCCGCAGTGC-1_V12N28-333_C1,0,3,0,1,0,4
GCCTATTTGCTACACA-1_V12N28-333_C1,1,1,1,3,0,6
TTGACGATTCAGCACG-1_V12N28-333_C1,2,2,0,0,0,4
TTAAACCGGTAGCGAC-1_V12N28-333_C1,0,4,2,6,0,12
ACCGAAAGGGCCCTGC-1_V12N28-333_C1,1,2,0,3,0,6
ACGTTCCGCGCTCCGT-1_V12N28-333_C1,0,1,0,4,0,5
ATACCAGGCTAATAGA-1_V12N28-333_C1,3,3,0,1,0,7
CGGCTTTGTATGATAA-1_V12N28-333_C1,0,2,0,4,0,6
CTTGACCCGAAAGATA-1_V12N28-333_C1,0,3,0,2,0,5
CGCAGAAACATTTGCG-1_V12N28-333_C1,1,1,1,0,0,3
GACCCGTCGCCGGCTA-1_V12N28-333_C1,0,2,0,2,0,4
AATCGGGACACTACGA-1_V12N28-333_C1,0,3,0,2,0,5
GTCACAAAGTTTCCAA-1_V12N28-333_C1,1,2,0,4,0,7
TATATTCGCGTCGATA-1_V12N28-333_C1,0,1,0,6,0,7
CCTCCCGACAATCCCT-1_V12N28-333_C1,0,1,0,6,0,7
CGACATGCGATCTTCT-1_V12N28-333_C1,1,0,2,2,0,5
AACACGACTGTACTGA-1_V12N28-333_C1,0,3,0,4,0,7
CCCAACCACACTAACA-1_V12N28-333_C1,0,1,2,4,0,7
CACCGCCGACCAGCGA-1_V12N28-333_C1,0,3,0,2,0,5
TGGTATCGCATCCCAA-1_V12N28-333_C1,1,0,1,8,0,10
CAGAGTGATTTAACGT-1_V12N28-333_C1,0,0,0,0,0,0
AACCCTGGTGGAACCA-1_V12N28-333_C1,1,0,2,4,0,7
GTCAGTTGTGCTCGTT-1_V12N28-333_C1,0,0,0,0,0,0
ATTGACGTAACTCGGT-1_V12N28-333_C1,1,2,1,1,0,5
GATGTCGGTCAACTGC-1_V12N28-333_C1,0,0,2,0,0,2
AGGGCAGCGGCGTGGT-1_V12N28-333_C1,0,1,2,1,0,4
ACATCGTTAACCTAGT-1_V12N28-333_C1,0,0,2,4,1,7
TCCATTGTGACCTCGT-1_V12N28-333_C1,1,1,0,2,0,4
TGTTTAATACTTCATC-1_V12N28-333_C1,0,0,0,6,0,6
TTGCTGGCCGGGCTTC-1_V12N28-333_C1,0,0,0,0,0,0
CATATTATTTGCCCTA-1_V12N28-333_C1,0,1,0,1,0,2
CTGCCTAGCCACCAAG-1_V12N28-333_C1,0,0,0,1,0,1
GACTACAATTGCTCGT-1_V12N28-333_C1,0,2,0,0,0,2
AACGTGATGAAGGACA-1_V12N28-333_C1,0,0,2,0,0,2
ACTCTCTTATACACGA-1_V12N28-333_C1,0,0,1,3,0,4
CGCATCATGGCTTCAG-1_V12N28-333_C1,0,0,0,0,0,0
CGGCTCTTCGTCGAAC-1_V12N28-333_C1,0,3,0,0,1,4
ATTCTTCGTACTTATG-1_V12N28-333_C1,1,2,0,0,0,3
AGTGAGGGTTTCTGAC-1_V12N28-333_C1,0,2,2,1,0,5
GCCAGGCGTTCGCATG-1_V12N28-333_C1,0,1,0,1,0,2
GACTAACACAGCACCT-1_V12N28-333_C1,0,0,0,1,0,1
CAATGGAATCTACATA-1_V12N28-333_C1,0,2,0,1,0,3
GTGGTCAGCGAAGTAT-1_V12N28-333_C1,1,2,1,1,0,5
ATGGCTGGAAATGGCC-1_V12N28-333_C1,0,1,1,0,0,2
ATCAGGTCGCCATTGC-1_V12N28-333_C1,0,0,0,1,0,1
TATCACCATGTAAAGT-1_V12N28-333_C1,1,2,0,2,0,5
AGCGCTTATGGGCAAG-1_V12N28-333_C1,0,1,0,4,0,5
AAGCGGCGTCATGGGT-1_V12N28-333_C1,0,0,0,0,0,0
ACTAATACGTCAGGCG-1_V12N28-333_C1,0,3,0,0,0,3
GGCTGAGCATCGTAAG-1_V12N28-333_C1,0,3,2,1,1,7
CGGTTGGGTTCAAGTT-1_V12N28-333_C1,1,1,0,2,0,4
GACTGATTGGTCACAA-1_V12N28-333_C1,1,2,0,1,1,5
AGACGGGCCGATTTAA-1_V12N28-333_C1,1,2,0,1,0,4
ACCAGTGCCCGGTCAA-1_V12N28-333_C1,0,2,0,0,0,2
GTCCTTTAATGACTTC-1_V12N28-333_C1,1,1,2,1,0,5
CCTACAAGTCCGGAAT-1_V12N28-333_C1,0,2,1,1,0,4
GCCTGCTACACTGAGA-1_V12N28-333_C1,0,0,0,2,0,2
GACTCGGTCGGCGGAT-1_V12N28-333_C1,0,0,1,0,0,1
CTAGACATATATGTAG-1_V12N28-333_C1,0,4,0,0,1,5
TCGCCCAACTGACTCC-1_V12N28-333_C1,1,0,0,1,0,2
AAACTAACGTGGCGAC-1_V12N28-333_C1,0,5,0,0,0,5
AACTGAGGTCAGCGTC-1_V12N28-333_C1,0,0,0,1,1,2
ACAATGATTCTTCTAC-1_V12N28-333_C1,1,0,0,3,2,6
ATAAGTACCCGATTGT-1_V12N28-333_C1,0,2,0,0,0,2
ATTGGGAGTTCTGTAA-1_V12N28-333_C1,0,1,0,0,0,1
CGAACATAGTCAGAAA-1_V12N28-333_C1,0,5,0,0,0,5
TAGCTCAGATCCTAGT-1_V12N28-333_C1,0,1,0,0,0,1
GTGTCGTATTCACCTT-1_V12N28-333_C1,0,1,0,0,0,1
CTCACCGATCCAAACT-1_V12N28-333_C1,0,2,0,0,0,2
ATATGTGCACAAACCA-1_V12N28-333_C1,0,1,0,1,1,3
CAGTCCAACGCCTTCT-1_V12N28-333_C1,0,6,0,0,0,6
TCGTCCGGGTACACTC-1_V12N28-333_C1,0,0,0,0,0,0
GCAGAAACGTAATCCA-1_V12N28-333_C1,0,0,0,0,0,0
TTCGAGCCGGCGCTAC-1_V12N28-333_C1,0,3,0,0,0,3
GGAAGATAAGACTGTA-1_V12N28-333_C1,0,0,0,0,0,0
GCATAAATTGAACGCC-1_V12N28-333_C1,0,5,0,0,0,5
CGCCGGTGTCGCAGTA-1_V12N28-333_C1,0,5,0,1,0,6
GACCTGGTCTGGGCGT-1_V12N28-333_C1,6,3,0,2,0,11
AGCCGCTTGATTAGCG-1_V12N28-333_C1,4,3,1,1,0,9
CCCGGCTAGGTGAGAA-1_V12N28-333_C1,0,3,0,3,0,6
CGAGCCGAGCACTCGA-1_V12N28-333_C1,3,3,1,0,0,7
TAGTGCTTGAATCCTT-1_V12N28-333_C1,1,6,1,2,0,10
CAACCGCACCTAGACA-1_V12N28-333_C1,1,5,0,0,0,6
ACCACTGTTCAAGAAG-1_V12N28-333_C1,2,3,1,1,0,7
AGATGCTATAACGAGC-1_V12N28-333_C1,0,3,0,2,0,5
AATTACTCGTACGCTC-1_V12N28-333_C1,0,1,0,1,0,2
CGTCAATCTTTAACAT-1_V12N28-333_C1,1,2,0,2,0,5
CCAAAGCAGTTGGTTG-1_V12N28-333_C1,1,5,0,2,0,8
CCATATTGGATCATGA-1_V12N28-333_C1,2,4,0,3,0,9
CGTACCGAAAGTCTAG-1_V12N28-333_C1,0,3,1,1,0,5
CTCGAGATCCAAAGCA-1_V12N28-333_C1,0,1,1,2,0,4
TGGATAGAGTAACAGA-1_V12N28-333_C1,0,2,0,2,0,4
TCACAGATCCTCAAAC-1_V12N28-333_C1,0,1,0,1,0,2
AGAGCTACGAAAGCAT-1_V12N28-333_C1,0,4,0,3,0,7
TGCGTGATTGGGTGTC-1_V12N28-333_C1,0,5,0,2,0,7
CACATGTTTGGACATG-1_V12N28-333_C1,0,4,0,0,0,4
TTCGCATCCGGAAGCA-1_V12N28-333_C1,1,4,0,1,0,6
CCCTAGTGTCAGGTGT-1_V12N28-333_C1,0,1,2,3,0,6
TTACCGCCTTAGGGAA-1_V12N28-333_C1,0,1,2,0,0,3
CCAGTCCATTATTCGA-1_V12N28-333_C1,1,6,0,1,0,8
CGTAAACGCTTGAGTG-1_V12N28-333_C1,0,2,1,0,0,3
ATTCCTTCCAGGCGGT-1_V12N28-333_C1,0,5,0,1,0,6
TTCCTTTCTGTGTTGC-1_V12N28-333_C1,0,2,1,4,0,7
AGTTGACATCGGCTGG-1_V12N28-333_C1,1,0,1,0,0,2
AACTCGATGGCGCAGT-1_V12N28-333_C1,2,1,0,0,0,3
GATAAGGCAGATGCAA-1_V12N28-333_C1,0,1,3,2,0,6
GGCTGGCTAGCTTAAA-1_V12N28-333_C1,1,3,0,2,0,6
CCTCATGCAGCTACGA-1_V12N28-333_C1,1,2,0,3,0,6
GACGCCTGTTGCAGGG-1_V12N28-333_C1,1,2,0,3,0,6
TAATTAGATGGATATG-1_V12N28-333_C1,2,2,1,3,0,8
GAGGGCATCGCGTATC-1_V12N28-333_C1,1,4,2,0,0,7
CTTGTGAGTCTTTGAC-1_V12N28-333_C1,1,3,1,2,0,7
TCAACACATTGGGTAA-1_V12N28-333_C1,0,2,0,1,0,3
ACTGTATACGCGAGCA-1_V12N28-333_C1,0,0,0,1,0,1
GTGAAACGTGCTCCAC-1_V12N28-333_C1,1,3,0,1,0,5
CGAGTGCTATAGTTCG-1_V12N28-333_C1,0,2,0,4,0,6
GTACTGCATGAAGCGT-1_V12N28-333_C1,0,2,0,0,0,2
GTAACTTGCGGCAGTC-1_V12N28-333_C1,0,2,0,0,0,2
GAATCGCCGGACACGG-1_V12N28-333_C1,0,3,0,3,0,6
GGGAGTAATGGCTGGC-1_V12N28-333_C1,2,3,0,2,0,7
CATGAACCGACATTTG-1_V12N28-333_C1,0,2,0,0,0,2
TCTGTCATACAAGAGC-1_V12N28-333_C1,0,1,0,4,0,5
GTCGTCAATTATAAGG-1_V12N28-333_C1,1,2,0,3,0,6
TAAAGAGCCCGAAACC-1_V12N28-333_C1,2,3,0,2,0,7
GTACTGAGGTCGTAAC-1_V12N28-333_C1,2,2,1,1,0,6
AAAGACCCAAGTCGCG-1_V12N28-333_C1,0,3,1,1,0,5
CGTCAGTGCGCACAAG-1_V12N28-333_C1,0,1,0,1,0,2
TGTATCCTTATTCCAT-1_V12N28-333_C1,0,2,0,2,0,4
ATTCTCGTCTCTTTAG-1_V12N28-333_C1,0,1,0,1,0,2
AAAGTCACTGATGTAA-1_V12N28-333_C1,1,1,1,1,0,4
TGTCTACAGTTTCTGT-1_V12N28-333_C1,1,2,0,1,0,4
TTAACGTCGCAAGACC-1_V12N28-333_C1,0,1,0,3,0,4
CTATGTCTATTGAAAC-1_V12N28-333_C1,0,1,0,4,0,5
TCGGGTGAAACTGCTA-1_V12N28-333_C1,1,5,0,4,0,10
TGTCCCGACATAGCAC-1_V12N28-333_C1,1,3,2,1,0,7
ACAGCATAGAGCCAGT-1_V12N28-333_C1,1,4,0,1,0,6
ATATTCCCACAGGTCA-1_V12N28-333_C1,0,3,0,2,0,5
TTGGATCGACTTCTGG-1_V12N28-333_C1,1,4,1,0,0,6
CACCATCGGAGGAGAC-1_V12N28-333_C1,2,5,0,3,0,10
TCGTTCGTTATTATGT-1_V12N28-333_C1,0,2,0,2,0,4
CTTAACTTCGAAGTAC-1_V12N28-333_C1,0,1,0,1,0,2
GCACAAGTGTCGGAAG-1_V12N28-333_C1,1,3,0,4,0,8
TACCAGCTAGGTTTAA-1_V12N28-333_C1,1,1,1,3,0,6
ACGTACAGATTTCTCT-1_V12N28-333_C1,0,3,0,5,0,8
AATTTGGTTCCAAAGA-1_V12N28-333_C1,0,2,0,0,0,2
GTAAGGATTTGTCGGA-1_V12N28-333_C1,0,3,1,5,0,9
CATCATCTACCCGGAC-1_V12N28-333_C1,0,1,0,3,0,4
ACGATGGATCCGATGC-1_V12N28-333_C1,0,0,0,3,0,3
CACTCAGCTCTTGAGG-1_V12N28-333_C1,2,1,3,4,0,10
CGAAACATAGATGGCA-1_V12N28-333_C1,0,0,0,0,0,0
GATGGTGCCCTAGGCA-1_V12N28-333_C1,0,1,0,0,0,1
GGAAGCTCGCTTACAG-1_V12N28-333_C1,0,0,0,0,0,0
CACCGATACACCGAGC-1_V12N28-333_C1,0,3,0,0,0,3
CAGCCGGGCCCTCTAT-1_V12N28-333_C1,0,1,1,4,0,6
CGGAGCTTATAACACC-1_V12N28-333_C1,1,0,0,1,0,2
ATTACAACTACCGGCC-1_V12N28-333_C1,2,1,1,0,0,4
TCCTCTGGCCCATTAG-1_V12N28-333_C1,0,1,0,0,0,1
CGGCACCGTTAGCGCC-1_V12N28-333_C1,0,0,2,1,0,3
TCGGTCCCTGACTCCA-1_V12N28-333_C1,0,3,0,0,0,3
TGGTTGGAGGATCCTG-1_V12N28-333_C1,1,0,2,1,0,4
CTGCGGTAGTCACGTG-1_V12N28-333_C1,1,2,1,5,0,9
GTGCCTCAGTGTACGG-1_V12N28-333_C1,0,2,1,0,1,4
ATCGTTCACTTTCGCC-1_V12N28-333_C1,0,1,0,5,0,6
ACTTACCGGGCGCGCA-1_V12N28-333_C1,1,2,1,0,0,4
CTAGACTGCATTTCGT-1_V12N28-333_C1,0,0,0,0,0,0
TTGCCGGTGATCCCTC-1_V12N28-333_C1,0,0,1,3,2,6
CTGTCACGCCAGGCGC-1_V12N28-333_C1,0,0,1,2,0,3
CGGTATAGGTATTAGC-1_V12N28-333_C1,0,1,0,1,0,2
CCAACGCTTGCCAGGG-1_V12N28-333_C1,1,1,0,0,0,2
CGTTGAGTAATTGCGT-1_V12N28-333_C1,0,1,0,4,0,5
TGTATTTACCTAATGC-1_V12N28-333_C1,0,0,2,3,0,5
TAAATGCCGTCTCATG-1_V12N28-333_C1,0,2,1,0,2,5
CGGTTTATGAAGGAAC-1_V12N28-333_C1,0,1,0,1,0,2
GCAAGATGTGTTCGCG-1_V12N28-333_C1,1,1,2,1,0,5
AAAGGTAAGCTGTACC-1_V12N28-333_C1,0,1,0,1,0,2
GTACGTCACGTATTAA-1_V12N28-333_C1,0,1,1,0,0,2
AGTACCTTCGAGTGCT-1_V12N28-333_C1,0,0,0,0,0,0
ATTGTGACTTCGCTGC-1_V12N28-333_C1,1,1,0,4,0,6
TGTATCAGACTGAAGC-1_V12N28-333_C1,1,4,1,1,0,7
GAGACCCTGCAACGCC-1_V12N28-333_C1,0,2,2,1,0,5
TGGGTGGGATGTCATT-1_V12N28-333_C1,0,1,0,0,0,1
GGCTAATGATTGAAAT-1_V12N28-333_C1,0,3,0,0,0,3
ATAACGTTACCTCCAC-1_V12N28-333_C1,0,2,0,1,0,3
TGCGAGATGGCGGCCA-1_V12N28-333_C1,0,2,1,0,0,3
CACACTTGTATTGCGA-1_V12N28-333_C1,0,1,0,1,1,3
GCTGGTGACTCGTAGT-1_V12N28-333_C1,1,2,2,0,1,6
CGACACCGCTTAAGGA-1_V12N28-333_C1,0,3,0,0,1,4
GTAACAACTGACCTTG-1_V12N28-333_C1,0,2,0,1,1,4
CAACTGAGGGTATGAC-1_V12N28-333_C1,0,0,0,0,0,0
CTAATTATGAAGCGTA-1_V12N28-333_C1,0,0,0,2,0,2
CCGATCTTAAGAGGCT-1_V12N28-333_C1,0,2,0,0,0,2
CGACTCGGTACACGGT-1_V12N28-333_C1,0,1,2,1,0,4
TGCTGCGTCAGAGTTA-1_V12N28-333_C1,0,2,0,0,0,2
AGAGTTGCAGGCCTCC-1_V12N28-333_C1,0,3,0,0,0,3
ACTGGCGAACCTGCGT-1_V12N28-333_C1,0,3,1,0,0,4
ACTAAGGACGCACACC-1_V12N28-333_C1,0,0,0,0,0,0
CGTCCAGATGGCTCCA-1_V12N28-333_C1,1,5,0,2,0,8
ACTATCGCCGGCTAAA-1_V12N28-333_C1,1,4,0,0,0,5
GATAGCGTACCACGCG-1_V12N28-333_C1,1,3,1,1,0,6
AGGACTTATAGGAGAA-1_V12N28-333_C1,0,4,2,1,0,7
TAGTCGGGATTCTTCG-1_V12N28-333_C1,1,3,0,3,0,7
ACCATTAAGGGTGTCA-1_V12N28-333_C1,0,2,0,4,0,6
TTAATGTGTTTGCAGG-1_V12N28-333_C1,1,2,0,3,0,6
TCCGCAGCCACCTAGC-1_V12N28-333_C1,0,3,0,0,0,3
GAGGAGATCCTCATGC-1_V12N28-333_C1,2,1,0,5,0,8
GGTCCTTCATACGACT-1_V12N28-333_C1,0,1,0,1,0,2
CCCTGTTGGCAAAGAC-1_V12N28-333_C1,1,4,2,1,0,8
GTGCCTAGCTATGCTT-1_V12N28-333_C1,0,1,0,4,0,5
GTCATCTCCTACAGCT-1_V12N28-333_C1,4,2,0,1,0,7
GCGAGAAACGGGAGTT-1_V12N28-333_C1,0,7,0,1,0,8
CGTCGCGGCGGGATTT-1_V12N28-333_C1,1,5,0,3,0,9
CATTGTGTGCTAGATC-1_V12N28-333_C1,0,2,0,0,0,2
CGCGGCAGTATTACGG-1_V12N28-333_C1,0,5,0,2,0,7
GAAATGGGATGTAAAC-1_V12N28-333_C1,1,2,0,2,0,5
CATTCCCTAAGTACAA-1_V12N28-333_C1,0,1,0,1,0,2
AGTTCTGCGTTGTATC-1_V12N28-333_C1,0,3,0,3,0,6
ACCCTATAGGACTGAG-1_V12N28-333_C1,1,0,0,0,0,1
TTAGATAGGTCGATAC-1_V12N28-333_C1,0,2,2,0,0,4
ATTGATAGCAACGAGA-1_V12N28-333_C1,3,4,0,0,0,7
TCTCGGCTCCAGGACT-1_V12N28-333_C1,2,4,0,0,0,6
CTTGAGGTTATCCCGA-1_V12N28-333_C1,0,6,2,2,0,10
AAGAAGGATCAGTTAG-1_V12N28-333_C1,0,1,0,2,0,3
GTACGACGGCGCTGCG-1_V12N28-333_C1,1,3,0,1,0,5
CTTATGTTGACTACCA-1_V12N28-333_C1,1,3,2,0,0,6
CGGCACTCAAGAAAGT-1_V12N28-333_C1,1,2,2,2,0,7
GTCAAAGTTTACATAG-1_V12N28-333_C1,1,6,0,1,0,8
CTCCTAAGTTATGTCT-1_V12N28-333_C1,0,2,0,1,0,3
ACTGTGCTAGTAGATC-1_V12N28-333_C1,0,2,2,2,0,6
GTTTGGCCGCTCAGCG-1_V12N28-333_C1,0,2,1,0,0,3
TTATCCAATCGAACTC-1_V12N28-333_C1,1,1,0,0,0,2
CCGTACCCAAGCGCCA-1_V12N28-333_C1,1,3,0,1,0,5
CATACAAAGCCGAACC-1_V12N28-333_C1,0,3,0,1,0,4
GGTCGGTAATTAGACA-1_V12N28-333_C1,0,1,0,3,0,4
AGCGGGAAGGGTCCAT-1_V12N28-333_C1,0,5,0,1,0,6
GCCCACCAAGGCTGTC-1_V12N28-333_C1,0,2,2,2,0,6
GTAGACGTCGTTACAT-1_V12N28-333_C1,0,4,0,0,0,4
GAGCATCATCCCTGGG-1_V12N28-333_C1,0,2,0,3,0,5
AGGTAACCTCCTATTC-1_V12N28-333_C1,0,2,1,1,0,4
GGTTTGAGTGCTGGAA-1_V12N28-333_C1,0,4,0,2,0,6
GCACTAGTCGCGCTAT-1_V12N28-333_C1,1,1,0,2,0,4
GGTAACTATGTATCTG-1_V12N28-333_C1,0,5,0,3,0,8
GCGGTCCCTAGACGCA-1_V12N28-333_C1,0,6,0,0,0,6
CGAGCGTTGATCAGCC-1_V12N28-333_C1,0,3,1,2,0,6
AATCCAAGGGCCTGAG-1_V12N28-333_C1,1,1,1,2,0,5
CCGTGCCCATGACGGC-1_V12N28-333_C1,0,2,0,3,0,5
GAAATTCACATCGCTG-1_V12N28-333_C1,0,1,1,1,0,3
CTCTGCGAAGCAAGCA-1_V12N28-333_C1,0,3,1,1,0,5
AGTAGGTAACATACAT-1_V12N28-333_C1,1,4,0,0,0,5
ATTGGGAATATCTTGG-1_V12N28-333_C1,0,1,0,3,0,4
TAGAGCTACGAAGAAC-1_V12N28-333_C1,0,1,1,2,0,4
TGCGGCATAGTTCAAC-1_V12N28-333_C1,1,0,1,4,0,6
CCGCCGGTCAACACAC-1_V12N28-333_C1,0,1,1,3,0,5
TCGTATAGTGCAATTA-1_V12N28-333_C1,0,2,0,0,0,2
TAGTTTATTCTTGCTT-1_V12N28-333_C1,2,2,0,4,0,8
GATATCTCATGCAATA-1_V12N28-333_C1,0,2,0,1,0,3
CGTTTAAGCGGAGCAC-1_V12N28-333_C1,0,1,2,2,0,5
CATGCTGGCTCCAATT-1_V12N28-333_C1,1,0,1,1,0,3
GAAACAGCCATGCAGT-1_V12N28-333_C1,1,1,0,4,0,6
AGTTTCGCAGGTCGGA-1_V12N28-333_C1,0,0,0,2,0,2
CTCATGGCTCACAATC-1_V12N28-333_C1,0,2,0,3,0,5
AACCGTTGTGTTTGCT-1_V12N28-333_C1,0,2,1,0,0,3
ACCCTTCATCTGCGAA-1_V12N28-333_C1,0,2,0,1,0,3
TGCGGTGAAATTTCAT-1_V12N28-333_C1,0,3,1,0,0,4
CAAATTGTCAGCAAGC-1_V12N28-333_C1,0,3,1,2,0,6
GAGGTACATCCATCTT-1_V12N28-333_C1,0,2,0,1,0,3
AAATGGCATGTCTTGT-1_V12N28-333_C1,0,2,0,3,0,5
TCATCCCAGAGGGTGG-1_V12N28-333_C1,2,2,0,0,0,4
CGTAGCGAATTGTCAG-1_V12N28-333_C1,1,1,0,0,0,2
CCTAGTTAGTCGCATG-1_V12N28-333_C1,0,1,0,1,0,2
GAAACTCTAATGAAGG-1_V12N28-333_C1,0,1,1,0,0,2
TTCAAGCCGAGCTGAG-1_V12N28-333_C1,0,1,0,0,0,1
TTAAGCCGACAACTTC-1_V12N28-333_C1,0,1,0,0,0,1
GTCTTAGTACAGCCGG-1_V12N28-333_C1,0,0,0,1,0,1
GACCGTCAGGTCGTGA-1_V12N28-333_C1,0,2,2,3,0,7
TAGTTAAGATAGGATA-1_V12N28-333_C1,0,2,2,2,0,6
GAATATTCGGAGTCCC-1_V12N28-333_C1,0,3,2,3,0,8
CAAACTACGATAGAGA-1_V12N28-333_C1,1,4,1,0,0,6
CAGGAAGACTTTATAT-1_V12N28-333_C1,0,1,0,4,1,6
TTCGTAATCCCAGCGG-1_V12N28-333_C1,0,1,0,0,0,1
GTGAGGAGCGGTTGAG-1_V12N28-333_C1,0,0,0,4,0,4
CAATCCCTATACCAGC-1_V12N28-333_C1,0,3,0,0,0,3
AGGGAAACGAGGTACT-1_V12N28-333_C1,0,1,2,3,0,6
TCCTGCCAACTGGAGA-1_V12N28-333_C1,0,3,4,2,0,9
AATTTGGGACATAGTA-1_V12N28-333_C1,0,0,0,1,0,1
AACTCCTAATCCCATG-1_V12N28-333_C1,0,3,0,0,0,3
GCTCATTACTGCATGT-1_V12N28-333_C1,0,1,1,2,0,4
TCTCGAACGAGGTCAC-1_V12N28-333_C1,0,1,1,2,0,4
TCACTACGACCAATGC-1_V12N28-333_C1,1,0,1,2,1,5
GTGATGCACAACATCT-1_V12N28-333_C1,3,2,0,2,0,7
CCGACGTAAACACAAC-1_V12N28-333_C1,0,2,2,1,0,5
TGGGATGCACTCATTC-1_V12N28-333_C1,0,1,0,4,2,7
TTCCATCATGCGGTGA-1_V12N28-333_C1,0,8,0,0,2,10
TGCACAGTGAAGTTAT-1_V12N28-333_C1,1,1,0,1,0,3
CTATTGTGTTTGGTCA-1_V12N28-333_C1,0,0,1,2,0,3
TGCGAGCCCTTCCGCG-1_V12N28-333_C1,0,2,3,1,0,6
TTGAAAGGTGTAAAGG-1_V12N28-333_C1,0,0,1,1,2,4
GGTGCAGAGCCTATCG-1_V12N28-333_C1,0,2,0,4,0,6
ACTATATGCTGTGTTC-1_V12N28-333_C1,0,1,0,1,0,2
TCCTGGCGCTGCCTGG-1_V12N28-333_C1,0,2,0,1,0,3
GAGCCGAGCGTTTATT-1_V12N28-333_C1,0,0,1,0,0,1
AGAATGCGGGTTCGGA-1_V12N28-333_C1,1,0,0,0,1,2
ATGCGACAATTGGTCC-1_V12N28-333_C1,0,2,1,0,0,3
TTCCGGCTCGACTTCT-1_V12N28-333_C1,0,0,0,2,0,2
TGATTATGGCACGCAG-1_V12N28-333_C1,0,0,1,0,0,1
GGTTTGACAAGAAGCT-1_V12N28-333_C1,1,2,1,1,0,5
GCAGCTATGGACAGGT-1_V12N28-333_C1,0,3,0,0,0,3
CACCATGATCGCAAAG-1_V12N28-333_C1,0,2,0,1,0,3
GTCGGAAGGATACCAG-1_V12N28-333_C1,0,0,0,1,1,2
GGCCCAGTTATCAGCA-1_V12N28-333_C1,0,0,0,0,0,0
GGGCCTATTTAAGTAT-1_V12N28-333_C1,0,4,0,0,0,4
GTTGTTACATTGCGCT-1_V12N28-333_C1,0,0,0,1,1,2
CAACTCCGTAACTTGC-1_V12N28-333_C1,0,0,0,1,0,1
GATCTTTGCTCAAAGA-1_V12N28-333_C1,0,2,0,0,0,2
TCGCTTAATTACGAAG-1_V12N28-333_C1,0,3,1,0,0,4
CGATCATTAGAGGCAC-1_V12N28-333_C1,1,2,0,0,0,3
TGTTCTCTACTCCCTA-1_V12N28-333_C1,0,0,0,0,1,1
GCTTAGGGAAGCGGTA-1_V12N28-333_C1,0,6,0,0,0,6
CAGGTTTAGTACTACA-1_V12N28-333_C1,0,4,0,0,0,4
AAGCGGAGTGCGCGCA-1_V12N28-333_C1,0,3,0,0,0,3
TCAGATGGAGACGTAG-1_V12N28-333_C1,0,2,0,0,0,2
TCGCACTAACGTTTGT-1_V12N28-333_C1,2,4,1,1,0,8
CACGTCGGGTTCTAGA-1_V12N28-333_C1,1,1,0,3,0,5
GGAGTACACATGAGCT-1_V12N28-333_C1,1,1,0,0,1,3
GTGTGTCGACGTCGCT-1_V12N28-333_C1,1,5,1,1,0,8
GAAGCTCTTTGCTTAG-1_V12N28-333_C1,0,6,0,1,0,7
ACACCGAGCGCTCTTT-1_V12N28-333_C1,0,2,0,1,0,3
CGTAATAATTACGAGT-1_V12N28-333_C1,2,2,0,1,0,5
CATCAACACCTACTAA-1_V12N28-333_C1,3,3,0,1,0,7
CCAAGTTTCTACAGAT-1_V12N28-333_C1,1,3,0,2,0,6
ACGGGTCATGTGACTT-1_V12N28-333_C1,2,2,0,2,0,6
AGTGTGCTAAGATCGC-1_V12N28-333_C1,1,0,1,2,0,4
GGCGGTTTGCCGGTGC-1_V12N28-333_C1,2,0,1,0,0,3
GTATAATCTCCCGGAT-1_V12N28-333_C1,0,1,0,3,0,4
TAGTCCGTATGCATAA-1_V12N28-333_C1,1,2,0,2,0,5
CACTTCGTCTTATCTC-1_V12N28-333_C1,3,6,1,1,0,11
CATCCGCAGGCCCGAA-1_V12N28-333_C1,2,1,0,3,0,6
CCCTGATGTAACTCGT-1_V12N28-333_C1,0,2,1,3,0,6
CCATAGTCAGTAACCC-1_V12N28-333_C1,0,3,0,3,0,6
CGGGCCATAGCCGCAC-1_V12N28-333_C1,0,4,0,2,0,6
CTCCGGCTTGTAGACA-1_V12N28-333_C1,0,4,1,1,0,6
AACTTGCGTTCTCGCG-1_V12N28-333_C1,1,2,0,4,0,7
AATGAGTTCGCATATG-1_V12N28-333_C1,2,1,0,2,0,5
CGAGGCCAGGCATTGG-1_V12N28-333_C1,0,1,2,0,0,3
TCTGCGTCCGGTTTCT-1_V12N28-333_C1,0,3,0,0,0,3
CAATCCTGCCGTGGAG-1_V12N28-333_C1,0,3,0,2,0,5
CTGAGCAAGTAACAAG-1_V12N28-333_C1,0,2,2,1,0,5
GGGTACCCACGGTCCT-1_V12N28-333_C1,0,0,1,0,0,1
ACGGAATTTAGCAAAT-1_V12N28-333_C1,2,1,0,1,0,4
GGGCGGTCCTATTGTC-1_V12N28-333_C1,0,4,1,0,0,5
ATGTTACGAGCAATAC-1_V12N28-333_C1,0,3,1,1,0,5
AACCATGGGATCGCTA-1_V12N28-333_C1,2,1,1,1,0,5
TCGCATCCCTAAGTGT-1_V12N28-333_C1,1,1,0,0,0,2
ACTTAGTACGACAAGA-1_V12N28-333_C1,0,3,1,0,0,4
GAGCTCTCGGACCTAA-1_V12N28-333_C1,3,4,1,0,0,8
TCTATTACGCTGGCGA-1_V12N28-333_C1,0,4,2,0,0,6
AGATACGACTTCATAT-1_V12N28-333_C1,0,4,0,0,0,4
CGCTATACCGCCCACT-1_V12N28-333_C1,0,4,0,0,0,4
CAGTGTCCGCAGAATG-1_V12N28-333_C1,1,4,0,1,0,6
CCATCCATACCAAGTC-1_V12N28-333_C1,0,4,1,4,0,9
AACCCAGAGACGGAGA-1_V12N28-333_C1,1,1,0,0,0,2
GAAGAACGGTGCAGGT-1_V12N28-333_C1,1,4,0,2,0,7
GATAAATCGGTGGATG-1_V12N28-333_C1,1,0,0,3,0,4
CAGCTCGTGCTTGTGT-1_V12N28-333_C1,0,2,0,0,0,2
GAGTACGGGTATACAA-1_V12N28-333_C1,0,3,1,1,0,5
CATCGCCCGCGGCCAA-1_V12N28-333_C1,0,6,0,2,0,8
TCTTACAGAGGTACCG-1_V12N28-333_C1,2,0,1,1,0,4
TGGAAGACGAACACCA-1_V12N28-333_C1,0,3,0,1,0,4
GTTGTCGTGTTAGTTG-1_V12N28-333_C1,0,2,1,2,0,5
CCAAGGAACAGAGAGG-1_V12N28-333_C1,0,3,1,1,0,5
CTGCACCTGGAACCGC-1_V12N28-333_C1,0,1,1,1,0,3
CGCTTTCATACCGGTG-1_V12N28-333_C1,0,1,1,3,0,5
GTTCTTCCCTCGATGT-1_V12N28-333_C1,0,4,1,1,0,6
ATTTAACTCGTATTAC-1_V12N28-333_C1,0,3,1,0,0,4
AACGATAGAAGGGCCG-1_V12N28-333_C1,0,2,0,4,0,6
TATCCTGCATGGGAAT-1_V12N28-333_C1,1,3,0,1,0,5
AGGCCCATTGTACAGG-1_V12N28-333_C1,1,0,2,0,0,3
CCGGCGCATATTGGAT-1_V12N28-333_C1,0,2,0,4,0,6
ATCTGTAATTGTACCC-1_V12N28-333_C1,0,4,0,2,0,6
GAGCGAGGGAGTACCG-1_V12N28-333_C1,0,2,0,3,0,5
TTATTAGGGAAGCATC-1_V12N28-333_C1,0,3,0,2,0,5
CTTCTTACGTCGTATA-1_V12N28-333_C1,0,2,0,1,0,3
GAAGTGCTGGATAGCT-1_V12N28-333_C1,1,2,1,1,0,5
GTGCAACAAATGTGGC-1_V12N28-333_C1,1,1,2,2,0,6
CATGCGTTAGACAGAA-1_V12N28-333_C1,0,0,0,4,0,4
ACACACTTTCTACACG-1_V12N28-333_C1,1,4,0,1,0,6
AGCCCTAAGCGAAGTT-1_V12N28-333_C1,0,4,1,3,0,8
ATTAATTCGGTCACTC-1_V12N28-333_C1,1,1,0,2,0,4
AACAGGAAATCGAATA-1_V12N28-333_C1,0,0,2,2,0,4
ACGTTTAGTTGTGATC-1_V12N28-333_C1,0,2,0,1,0,3
TCCTTCAGTGGTCGAA-1_V12N28-333_C1,0,3,0,0,0,3
CGAACGCCCAGTGCCG-1_V12N28-333_C1,0,0,0,5,0,5
CCTCGAAGTGGACGGG-1_V12N28-333_C1,0,0,1,5,0,6
CTCTGTTTGAGGATTC-1_V12N28-333_C1,0,1,0,4,0,5
TGGGCACGTTCTATGG-1_V12N28-333_C1,0,0,1,7,0,8
ACTATTCGTCCGTGGT-1_V12N28-333_C1,0,0,2,1,0,3
CCTCTGGCCTAGACGG-1_V12N28-333_C1,0,2,0,3,0,5
CCATAAACAACCCGAC-1_V12N28-333_C1,0,1,0,6,0,7
CATAGTACATTGAGAG-1_V12N28-333_C1,0,1,0,7,0,8
ATTTCATTATTTCGCG-1_V12N28-333_C1,0,1,0,3,0,4
CAACTATATCGAATGC-1_V12N28-333_C1,0,1,1,3,0,5
CTAGTATTCGGAATTA-1_V12N28-333_C1,0,1,1,2,0,4
GTGGAACCTACATGCG-1_V12N28-333_C1,0,0,2,6,0,8
CCTAAAGGCTGACGCT-1_V12N28-333_C1,0,0,1,3,0,4
CGTGACATTGGGTCGT-1_V12N28-333_C1,0,1,2,5,0,8
CCAATCGGTAGATCGA-1_V12N28-333_C1,0,0,0,1,0,1
ATTGTCGCAATACCTT-1_V12N28-333_C1,0,1,1,5,0,7
AAATTACACGACTCTG-1_V12N28-333_C1,0,1,0,2,0,3
CACTCCTCTCGGTCGG-1_V12N28-333_C1,0,3,0,4,0,7
AAATAACCATACGGGA-1_V12N28-333_C1,0,1,2,0,0,3
AGTTACTCTATCGTGG-1_V12N28-333_C1,0,0,1,2,0,3
CGTTAGCTCACAACTG-1_V12N28-333_C1,0,2,2,3,0,7
GAATGTATGGCAGGTC-1_V12N28-333_C1,0,0,1,5,0,6
GCAACCACCAGACCGG-1_V12N28-333_C1,2,2,1,2,0,7
TCACTCGTGCAACGGC-1_V12N28-333_C1,0,1,0,3,0,4
AAACAGAGCGACTCCT-1_V12N28-333_C1,0,0,1,2,0,3
CAGCCTCTCCTCAAGA-1_V12N28-333_C1,1,1,0,1,0,3
TTGCGTGAACGCTTAG-1_V12N28-333_C1,0,0,3,4,1,8
CCGCCTGCGAATTGGT-1_V12N28-333_C1,1,3,2,4,0,10
AGATGAGGGTTGCGAT-1_V12N28-333_C1,0,0,1,3,0,4
CGGTGGGCTCCAGCCT-1_V12N28-333_C1,1,2,1,0,1,5
GGCAGCGGTAATCCTA-1_V12N28-333_C1,0,0,0,4,2,6
GCTAGCAGGGAGTGGG-1_V12N28-333_C1,0,1,4,1,0,6
CTCAAGACATTAGCGC-1_V12N28-333_C1,0,3,1,3,0,7
CACGGCGCGCCAAAGG-1_V12N28-333_C1,0,2,2,0,0,4
TGCAATTTGGGCACGG-1_V12N28-333_C1,0,1,0,2,0,3
ATGCCAATCGCTCTGC-1_V12N28-333_C1,0,2,0,0,2,4
GCTGGACCCAAAGTGG-1_V12N28-333_C1,0,2,0,0,0,2
ATTCCTAAGACGTGGA-1_V12N28-333_C1,0,3,1,3,0,7
TCCGGAGGAAGGGCTG-1_V12N28-333_C1,0,0,1,2,0,3
TCGGTGACCGCTCCGG-1_V12N28-333_C1,0,1,0,0,0,1
TCCGAAGTAGTCACCA-1_V12N28-333_C1,0,0,0,3,0,3
CATGTAGGAGCGCCAA-1_V12N28-333_C1,0,1,1,0,0,2
CACAAGAAAGATATTA-1_V12N28-333_C1,1,0,1,3,2,7
AGGGTCAGTAACCCTA-1_V12N28-333_C1,0,1,0,0,0,1
TAAGCCCTTACGACCA-1_V12N28-333_C1,0,1,1,0,0,2
ATACCGTCATCCATAA-1_V12N28-333_C1,0,2,0,0,0,2
GGACGTCCATAGTTGG-1_V12N28-333_C1,0,0,0,0,1,1
CATCAAACTGGCGCCC-1_V12N28-333_C1,0,2,0,1,2,5
AAACGTGTTCGCCCTA-1_V12N28-333_C1,0,0,0,1,1,2
AAATTGGTGAGAAGCA-1_V12N28-333_C1,0,1,0,3,1,5
GGTCATTGTAGTCATA-1_V12N28-333_C1,0,2,0,0,0,2
TGCAGTGAGGCTCGGG-1_V12N28-333_C1,0,2,0,1,1,4
GAACATTAGTATGTTA-1_V12N28-333_C1,0,0,0,1,1,2
GGTTTGCGAACACGTA-1_V12N28-333_C1,0,4,1,1,0,6
ACACAAATATTCCTAG-1_V12N28-333_C1,0,4,0,1,0,5
TTGGGTTTATTCAGCG-1_V12N28-333_C1,0,1,0,0,1,2
ATTCGCAGAGGACACT-1_V12N28-333_C1,0,4,0,0,0,4
GATTTAGTGCGTACTG-1_V12N28-333_C1,0,2,0,1,2,5
TAGAAACACAATAGTG-1_V12N28-333_C1,1,3,0,0,0,4
CAGTAGATGATGTCCG-1_V12N28-333_C1,1,5,0,1,0,7
TCTTAACTCGGATGTA-1_V12N28-333_C1,0,1,0,5,0,6
TACATCTTGTTTCTTG-1_V12N28-333_C1,1,0,0,2,0,3
TTCATAGGGTGTCCAT-1_V12N28-333_C1,0,2,0,2,0,4
TGAAGTAGCTTACGGA-1_V12N28-333_C1,1,3,0,3,0,7
GCACAAGTGGATCATA-1_V12N28-333_C1,1,4,0,3,0,8
GGGCGAATTTCTCCAC-1_V12N28-333_C1,1,2,0,1,0,4
ATGTTCCTGCCCACCT-1_V12N28-333_C1,0,3,0,2,0,5
GCTCAACCTCTTAGAG-1_V12N28-333_C1,0,5,0,1,0,6
ATAGCTGCTCTTGTTA-1_V12N28-333_C1,0,6,0,0,0,6
CGTCAGCTATTTACTC-1_V12N28-333_C1,1,0,0,3,0,4
ATCTGATAGTGTCTTA-1_V12N28-333_C1,0,2,0,1,0,3
TGCACTATGTGAGTGC-1_V12N28-333_C1,0,4,0,4,0,8
CCGACAAACACATGAG-1_V12N28-333_C1,1,1,0,1,0,3
GCCTTGTATATGCAGT-1_V12N28-333_C1,0,4,2,2,0,8
ATAATACCGTTAGCCG-1_V12N28-333_C1,0,3,1,3,0,7
ACACTCCAATGTCACT-1_V12N28-333_C1,2,2,0,1,0,5
AGTTGCTGACTGATAT-1_V12N28-333_C1,0,5,0,0,0,5
GGCGCTCCTCATCAAT-1_V12N28-333_C1,2,3,2,0,0,7
TGCCTGACATCGGTCA-1_V12N28-333_C1,0,4,1,1,0,6
TTGGCCATCTTGCGCT-1_V12N28-333_C1,0,6,1,2,0,9
CAGTGGTTGCACATGA-1_V12N28-333_C1,0,5,0,1,0,6
AGAATTGTTTGACATA-1_V12N28-333_C1,1,5,0,1,0,7
AAATGCTCGTTACGTT-1_V12N28-333_C1,2,4,0,1,0,7
CACCTAATAGAGTCGT-1_V12N28-333_C1,0,6,1,0,0,7
CATTTCTAGCAGACTA-1_V12N28-333_C1,0,1,1,0,0,2
CCGAAAGTGGTGAGCA-1_V12N28-333_C1,1,8,0,1,0,10
AGTCAGCCACCGCCTG-1_V12N28-333_C1,0,5,1,2,0,8
TCATCACTCGAGCTCG-1_V12N28-333_C1,1,1,1,1,0,4
CTCAGGACTCACCTGT-1_V12N28-333_C1,0,1,0,3,0,4
CGGTGTACTTGATCCC-1_V12N28-333_C1,0,6,0,0,0,6
CCTACGGCTCAGTCGA-1_V12N28-333_C1,0,4,0,2,0,6
GTACTTGGGCACTTCT-1_V12N28-333_C1,0,6,0,2,0,8
TGATTTCCTCCTGACG-1_V12N28-333_C1,0,1,0,3,0,4
CCTCACCAATCTTGAC-1_V12N28-333_C1,2,2,1,0,0,5
GGTGAGATGCAGATAA-1_V12N28-333_C1,0,0,0,3,0,3
GCTAGTTTCATTGAGG-1_V12N28-333_C1,0,2,1,2,0,5
AGGACATCGCACGTCG-1_V12N28-333_C1,0,0,1,0,0,1
GTGGACGTGCTGAGAC-1_V12N28-333_C1,0,4,0,0,0,4
TAAGGAACTTGTGGGA-1_V12N28-333_C1,0,1,0,0,0,1
TCGCTGTGCGTAAATC-1_V12N28-333_C1,0,3,0,0,0,3
GCATCCCTAACTTTGA-1_V12N28-333_C1,0,2,0,1,0,3
CACCCACACGTCACCC-1_V12N28-333_C1,2,4,0,0,0,6
CCCTCATTCTGGAATT-1_V12N28-333_C1,2,2,0,2,0,6
AGGGCGTGATCGGCTA-1_V12N28-333_C1,0,1,0,1,0,2
GGTGCGGATAAGTGGC-1_V12N28-333_C1,0,5,0,1,0,6
TAATATTGAAATTCGC-1_V12N28-333_C1,1,3,0,0,0,4
CTTACACTGGGAAATA-1_V12N28-333_C1,0,0,3,1,0,4
ACCAAGAACGCGTGTC-1_V12N28-333_C1,0,1,0,1,0,2
GCCTTCAGCCCTACCG-1_V12N28-333_C1,4,1,0,4,0,9
GATGCTACAAGCGCCT-1_V12N28-333_C1,0,1,0,0,0,1
CCGGGACCCGCAGAGA-1_V12N28-333_C1,1,2,0,1,0,4
GTTCCAGTCTGACCAT-1_V12N28-333_C1,0,4,0,1,0,5
ATGATCGGGAATAGAC-1_V12N28-333_C1,1,2,0,5,0,8
TTGGATTGGGTACCAC-1_V12N28-333_C1,0,1,0,1,0,2
TACCTCACGCTTGTAC-1_V12N28-333_C1,0,2,0,1,0,3
CATGGCAGGAAGATCG-1_V12N28-333_C1,0,1,2,4,0,7
ATGACGCCGGCTCTAA-1_V12N28-333_C1,0,1,1,1,0,3
AGCGACATCCCATTCA-1_V12N28-333_C1,0,0,3,6,0,9
AGTAATGTCTTGCCGC-1_V12N28-333_C1,0,0,3,4,0,7
TTCTTAGTGGCTCAGA-1_V12N28-333_C1,1,0,7,5,0,13
CGTCTGGAAGGGCCCG-1_V12N28-333_C1,1,0,2,2,0,5
ACGTGCGCCTCGTGCA-1_V12N28-333_C1,1,0,5,7,0,13
AGAGCGGGCTAATCAT-1_V12N28-333_C1,0,0,2,2,0,4
AACTGATATTAGGCCT-1_V12N28-333_C1,0,2,0,1,0,3
GGGTGTTTCAGCTATG-1_V12N28-333_C1,0,2,0,2,0,4
TTAATTTCAGACGCGG-1_V12N28-333_C1,0,0,0,2,0,2
ACTGCCGTCGTAACTC-1_V12N28-333_C1,0,0,2,3,0,5
GTGCACGAAAGTGACT-1_V12N28-333_C1,1,0,0,1,0,2
ATCTCCCTGCAATCTA-1_V12N28-333_C1,0,1,1,2,0,4
ACGCCAGATGATTTCT-1_V12N28-333_C1,0,2,0,1,0,3
AGCTATTTAATCCAAC-1_V12N28-333_C1,0,1,0,4,0,5
CCACGAGAAGAGAATC-1_V12N28-333_C1,0,1,1,2,0,4
GATTCCGCGTTTCCGT-1_V12N28-333_C1,0,0,0,3,0,3
GTCGGATGTAGCGCGC-1_V12N28-333_C1,0,2,0,5,0,7
TATTTATACCGAGTAG-1_V12N28-333_C1,0,1,2,2,0,5
GTAGGTGATCCGTGTA-1_V12N28-333_C1,0,0,0,8,0,8
AGTTAAGCGGTCCCGG-1_V12N28-333_C1,0,3,0,1,0,4
CTGGCGACATAAGTCC-1_V12N28-333_C1,0,1,0,4,0,5
TTGGCCTAGAATTTCG-1_V12N28-333_C1,0,2,1,3,0,6
GGCATATCGGTTCTGC-1_V12N28-333_C1,0,2,0,2,0,4
GGGCGTCCACTGGCTC-1_V12N28-333_C1,0,1,0,7,0,8
TTACCCATTGCCGGGT-1_V12N28-333_C1,0,0,2,3,0,5
TTAGACACGATCGTTG-1_V12N28-333_C1,0,1,1,3,0,5
GCGCTGATCCAGACTC-1_V12N28-333_C1,0,1,0,5,0,6
TTCGGCAACCCGCTGA-1_V12N28-333_C1,0,3,0,2,0,5
GATATTTCCTACATGG-1_V12N28-333_C1,0,0,1,3,0,4
CTGCGTTACGATATAA-1_V12N28-333_C1,0,3,0,0,0,3
TAATAAACAAGGAGAT-1_V12N28-333_C1,1,0,0,4,0,5
AACCTTTACGACGTCT-1_V12N28-333_C1,0,4,3,0,0,7
AGTCCCGCCTTTAATT-1_V12N28-333_C1,1,0,0,2,0,3
TGAGATTAGGCCCTAA-1_V12N28-333_C1,0,3,0,4,1,8
AGTGTATTGCGCATTG-1_V12N28-333_C1,0,4,1,1,0,6
GTTGGATTCAGTGGCT-1_V12N28-333_C1,0,1,0,1,0,2
TAAAGCTGCAATAGGG-1_V12N28-333_C1,0,2,1,4,0,7
AGTAGGAAGGAAGTTG-1_V12N28-333_C1,0,1,0,1,0,2
TATCACTTCGAGTAAC-1_V12N28-333_C1,0,1,0,1,1,3
TGATCTACGCTGATCT-1_V12N28-333_C1,1,1,0,2,0,4
GGATCATCCCGTACGC-1_V12N28-333_C1,0,0,0,0,0,0
TGACACTTCTCTTTGC-1_V12N28-333_C1,0,1,0,0,0,1
AGCCCTTCTAATCCGA-1_V12N28-333_C1,0,3,1,1,0,5
CACCGCGTCCACTCTA-1_V12N28-333_C1,0,0,0,1,0,1
TAATTGGAATCGGGAA-1_V12N28-333_C1,0,0,0,2,3,5
TCGTAAGCTCCGAGGA-1_V12N28-333_C1,1,1,2,0,0,4
TATATTACAAATGTCG-1_V12N28-333_C1,0,1,1,2,0,4
CGCGAGAGGGACTTGT-1_V12N28-333_C1,0,2,2,0,0,4
GGACCTACGGTAACGT-1_V12N28-333_C1,0,1,0,1,0,2
GAAATATGCTTGAATG-1_V12N28-333_C1,0,1,1,1,0,3
CCGTATTAGCGCAGTT-1_V12N28-333_C1,0,0,0,1,0,1
AGGCGTCTATGGACGG-1_V12N28-333_C1,1,1,0,0,0,2
AACATCGATACGTCTA-1_V12N28-333_C1,1,1,0,2,0,4
TGAATATGCTATAAAC-1_V12N28-333_C1,0,2,0,0,0,2
ACCAAACACCCAGCGA-1_V12N28-333_C1,0,2,0,1,0,3
TGGCTTGTACAAGCTT-1_V12N28-333_C1,0,2,0,1,0,3
GAATGAAGGTCTTCAG-1_V12N28-333_C1,0,1,2,1,1,5
AGATACCAGCACTTCA-1_V12N28-333_C1,0,5,1,0,0,6
GCGGTCCCGGTGAAGG-1_V12N28-333_C1,1,5,0,0,1,7
GAGGCATTTGCAGCAG-1_V12N28-333_C1,0,1,2,0,0,3
GGCAAGCCAGGGATAG-1_V12N28-333_C1,0,1,1,0,1,3
TCTACGGGCTCAGTTG-1_V12N28-333_C1,0,1,0,2,0,3
TCTGCGAATCGTTCGC-1_V12N28-333_C1,0,2,0,0,1,3
AGCTCGTTGATGGAAA-1_V12N28-333_C1,0,1,0,1,0,2
TGAATGAGATACAGCA-1_V12N28-333_C1,0,4,0,0,0,4
ACCCTTGCCTGGGTCG-1_V12N28-333_C1,0,5,0,0,0,5
GGCGAACCGTTCTGAT-1_V12N28-333_C1,0,2,0,0,0,2
GCGATGTCTGTGCTTG-1_V12N28-333_C1,1,4,0,2,0,7
ATTAACACCTGAGATA-1_V12N28-333_C1,1,3,0,1,0,5
GAAATCTGACCAAGTT-1_V12N28-333_C1,0,2,0,2,0,4
CCTGACAAACTCGCGC-1_V12N28-333_C1,0,3,0,3,0,6
ATGTCATTTCCCATTG-1_V12N28-333_C1,0,0,0,1,0,1
GCGGTGCGGAGCATCG-1_V12N28-333_C1,1,4,0,2,0,7
CGGAAAGCAAATGTGC-1_V12N28-333_C1,0,1,0,1,0,2
GCTGAGCAACGGTTCT-1_V12N28-333_C1,0,1,1,1,0,3
TCACTCTTCGTCTGTC-1_V12N28-333_C1,0,1,1,0,0,2
GATCTTCATTGTCCTC-1_V12N28-333_C1,1,2,0,9,0,12
ACTCGATGTATTTCAT-1_V12N28-333_C1,0,5,0,1,0,6
TGAAGAGCGGTCCTAG-1_V12N28-333_C1,0,2,0,5,0,7
TAAACGTCGTCAATGA-1_V12N28-333_C1,0,2,0,5,0,7
ACGTTATTGGTCACTC-1_V12N28-333_C1,1,7,0,1,0,9
ATAGCCTCAGTACCCA-1_V12N28-333_C1,2,1,0,2,0,5
CGGGAGTATACCGCCG-1_V12N28-333_C1,1,3,0,7,0,11
GTCCTACAGGCGGCTC-1_V12N28-333_C1,0,3,0,2,0,5
CGGATAAGCGGACATG-1_V12N28-333_C1,1,3,0,1,0,5
AACTTCTGCGTCTATC-1_V12N28-333_C1,0,3,0,2,0,5
GGGTTCAGACGAACAA-1_V12N28-333_C1,0,2,1,3,0,6
AGTCTGGACATCCTTG-1_V12N28-333_C1,0,5,3,1,0,9
TTGAACGAATCCTTTG-1_V12N28-333_C1,2,2,0,4,0,8
GAAATACTAAACGTTT-1_V12N28-333_C1,0,5,0,2,0,7
CCCGCGCAATGCACCC-1_V12N28-333_C1,1,1,0,3,0,5
TTCGGCTAGAGATGGT-1_V12N28-333_C1,0,9,0,2,0,11
GACACGAGTTAGAGGA-1_V12N28-333_C1,1,3,0,1,0,5
GAGGTCCCAAAGATCT-1_V12N28-333_C1,0,2,0,1,0,3
TAACTCCATGGAGGCT-1_V12N28-333_C1,0,5,0,2,0,7
CTTGTTTATGTAGCCA-1_V12N28-333_C1,0,2,0,1,0,3
GATGGCGCACACATTA-1_V12N28-333_C1,0,2,0,2,0,4
ATAATAGTGTAGGGAC-1_V12N28-333_C1,1,4,0,3,0,8
CGCTATTCAATGTATG-1_V12N28-333_C1,0,5,0,0,0,5
ATATTGCTGTCAAAGT-1_V12N28-333_C1,0,2,0,0,0,2
GGATTCAGTACGGTGG-1_V12N28-333_C1,0,2,0,1,0,3
TTCTTAGTGAACGGTG-1_V12N28-333_C1,0,2,0,1,0,3
AATGGTTCTCACAAGC-1_V12N28-333_C1,2,2,1,0,0,5
TATACACGCAAAGTAT-1_V12N28-333_C1,0,2,0,0,0,2
CTTCATAGCTCAAGAA-1_V12N28-333_C1,1,1,1,0,0,3
CAACGGTTCTTGATAC-1_V12N28-333_C1,0,2,0,0,0,2
ACACCCGAGAAATCCG-1_V12N28-333_C1,3,3,0,6,0,12
TCTATCATGCAGTTAC-1_V12N28-333_C1,0,5,0,1,0,6
CCCGCCATGCTCCCGT-1_V12N28-333_C1,0,4,1,1,0,6
CGCTTCCACTGAAATC-1_V12N28-333_C1,0,3,0,2,0,5
CACTGTCCAAGTGAGA-1_V12N28-333_C1,0,2,0,1,0,3
ATTACTAGCCTCTTGC-1_V12N28-333_C1,0,3,0,1,0,4
CATAGTAGCATAGTAG-1_V12N28-333_C1,0,1,0,0,0,1
CAACTCCTTGATCCCG-1_V12N28-333_C1,1,3,0,4,0,8
AAGTAGAAGACCGGGT-1_V12N28-333_C1,0,0,0,0,0,0
GCGGGAACCAGGCCCT-1_V12N28-333_C1,0,3,1,4,0,8
ATTAGATTGATAGCGG-1_V12N28-333_C1,0,3,0,1,0,4
CTCGGTCCGTAGCCTG-1_V12N28-333_C1,0,1,0,1,0,2
TGGCTTTGGGTAGACA-1_V12N28-333_C1,1,2,0,2,0,5
TATCCATATCATGCGA-1_V12N28-333_C1,0,2,0,0,0,2
GGAGTGCCGCCCTGGA-1_V12N28-333_C1,0,1,0,0,0,1
TGAGAATGCTTTACCG-1_V12N28-333_C1,0,3,2,3,0,8
TTAACCAACCCTCCCT-1_V12N28-333_C1,2,2,0,2,0,6
TGTTTCGGTACTTCTC-1_V12N28-333_C1,0,1,0,4,0,5
TTGCTGAAGGAACCAC-1_V12N28-333_C1,0,1,0,0,0,1
TATTTAGTCTAGATCG-1_V12N28-333_C1,0,3,0,0,0,3
CTCCGGCCTAATATGC-1_V12N28-333_C1,0,1,1,3,0,5
TTGTGGCCCTGACAGT-1_V12N28-333_C1,0,3,1,1,0,5
TCGCCGGTCGATCCGT-1_V12N28-333_C1,2,2,2,4,0,10
CCATAGGTTGGCGTGG-1_V12N28-333_C1,0,4,0,2,0,6
GAACGACCGAATGATA-1_V12N28-333_C1,1,1,0,1,0,3
TCCGATAATTGCCATA-1_V12N28-333_C1,0,1,0,1,0,2
CATTACGTCGGCCCGT-1_V12N28-333_C1,1,3,0,7,0,11
CAAGCACCAAATGCCT-1_V12N28-333_C1,0,1,0,0,0,1
TGCATGGATCGGATCT-1_V12N28-333_C1,0,1,0,2,0,3
CACCTCGATGGTGGAC-1_V12N28-333_C1,0,2,0,1,0,3
ATTTGTTCCAGGGCTC-1_V12N28-333_C1,0,0,0,0,0,0
TGGGCCACAAGAGCGC-1_V12N28-333_C1,0,4,0,1,0,5
CCTTCTTGATCCAGTG-1_V12N28-333_C1,0,0,0,1,0,1
CCTCGCCAGCAAATTA-1_V12N28-333_C1,1,3,2,3,0,9
TTCATGGCGCAACAGG-1_V12N28-333_C1,0,1,0,3,0,4
TTAATCAGTACGTCAG-1_V12N28-333_C1,0,1,0,2,0,3
CCTATCTATATCGGAA-1_V12N28-333_C1,2,5,1,3,0,11
ATTATACTTTGCTCGT-1_V12N28-333_C1,0,1,0,2,0,3
ATGGATCCGGCGTCCG-1_V12N28-333_C1,0,1,0,3,0,4
CGCCCGCTTCCGTACA-1_V12N28-333_C1,1,4,0,2,0,7
GGATTCCGCTATACCC-1_V12N28-333_C1,0,1,0,5,0,6
CGGTCTATCAACCCGT-1_V12N28-333_C1,0,5,0,3,0,8
ATGCCGGTTGATGGGA-1_V12N28-333_C1,1,1,1,3,0,6
TCATGCAGGTTCTCAT-1_V12N28-333_C1,0,2,0,5,0,7
TGAGCTTTAATGACGC-1_V12N28-333_C1,0,3,0,4,0,7
TCCCTTAGATTACTCG-1_V12N28-333_C1,1,1,0,1,0,3
ATATCTCCCTCGTTAA-1_V12N28-333_C1,1,3,0,2,0,6
AGCTCTTCCCAGTGCA-1_V12N28-333_C1,0,4,0,5,0,9
TCGCTAAACCGCTATC-1_V12N28-333_C1,0,3,3,1,0,7
CACATTCTTTCGATGG-1_V12N28-333_C1,0,0,0,1,0,1
GATATGCGGTAGCCAA-1_V12N28-333_C1,0,3,0,2,0,5
CGTTTCACTTCGGGCG-1_V12N28-333_C1,1,3,0,4,0,8
CCAATTACGGGTCGAG-1_V12N28-333_C1,0,2,0,0,0,2
GCAGGTAGAGTATGGT-1_V12N28-333_C1,0,0,1,9,0,10
GTCGTATTGGCGTACA-1_V12N28-333_C1,0,2,0,2,0,4
GAAATTAGCACGGATA-1_V12N28-333_C1,0,1,0,3,0,4
AATGCACCAAGCAATG-1_V12N28-333_C1,0,0,0,4,0,4
AGGACGCTCGATGTTG-1_V12N28-333_C1,0,3,0,2,0,5
GGCTAAAGGGCGGGTC-1_V12N28-333_C1,0,1,1,1,0,3
CATCTATCCCGTGTCT-1_V12N28-333_C1,0,1,0,2,0,3
CAGTAACTATTTATTG-1_V12N28-333_C1,0,3,0,0,0,3
CATATACTACTGATAA-1_V12N28-333_C1,0,1,0,1,0,2
GCGTTCGGAGACCGGG-1_V12N28-333_C1,0,1,2,2,0,5
AAGTTCAGTCTGCGTA-1_V12N28-333_C1,0,2,1,1,0,4
CGAAGCTATAAATTCA-1_V12N28-333_C1,0,1,0,0,0,1
CGCGGTCACAAACCAA-1_V12N28-333_C1,0,0,1,1,0,2
GGGAATGAGCCCTCAC-1_V12N28-333_C1,0,1,1,2,0,4
ACGGAGCGCAAATTAC-1_V12N28-333_C1,0,1,0,2,1,4
CGTTCTTCGCACACCT-1_V12N28-333_C1,0,1,1,1,0,3
GAATAGCCCTGCGGTC-1_V12N28-333_C1,0,2,1,0,0,3
AATAGCTACCGCGTGC-1_V12N28-333_C1,0,1,0,1,0,2
CCGAGCTGTGCTTGTC-1_V12N28-333_C1,0,3,1,0,0,4
GATGACGATGATCGCG-1_V12N28-333_C1,0,0,0,1,0,1
GCCTATGCTGGGCCTT-1_V12N28-333_C1,0,5,0,3,0,8
TTACTGTCTAGAGCTC-1_V12N28-333_C1,1,2,1,0,1,5
AGCGGTTGCCGCTCTG-1_V12N28-333_C1,0,0,1,0,0,1
GCTTGCAGCACAATTG-1_V12N28-333_C1,0,0,1,1,0,2
CCGGAGGTCTTATGGT-1_V12N28-333_C1,0,1,0,1,0,2
ACAGTATACCGTGGGA-1_V12N28-333_C1,0,2,0,1,1,4
GGGATCCCAATACAAA-1_V12N28-333_C1,0,1,0,0,0,1
ATTACGACTCCACAGT-1_V12N28-333_C1,0,2,0,0,1,3
CTCACACGCAAGCCTA-1_V12N28-333_C1,0,0,0,0,1,1
CCAGATGTAAATGGGT-1_V12N28-333_C1,0,1,0,0,0,1
GAACTTGTGCACGGGA-1_V12N28-333_C1,0,2,0,0,1,3
AAGCCGCTTTACCTTG-1_V12N28-333_C1,0,2,0,0,0,2
TCCATTCCCACTAGAG-1_V12N28-333_C1,0,0,0,0,4,4
AGAGCGCTTGTAACGG-1_V12N28-333_C1,0,2,0,1,1,4
TGGGTTCCCGGACGGA-1_V12N28-333_C1,1,2,0,3,0,6
GCTGCGCCTCCCACGT-1_V12N28-333_C1,1,4,0,1,0,6
CTGTTGGCTCTTCTGA-1_V12N28-333_C1,1,4,0,2,0,7
TTGTTCTAGATACGCT-1_V12N28-333_C1,0,4,3,1,0,8
CCCTCAAGCTCTTAGT-1_V12N28-333_C1,0,1,2,6,0,9
TGGTCTAGCTTACATG-1_V12N28-333_C1,2,3,1,2,0,8
ATGCACCTTCCTTAAT-1_V12N28-333_C1,0,2,0,3,0,5
GGGATACGGTAATAAT-1_V12N28-333_C1,1,1,0,1,0,3
AGTTCACCGGTTGGAC-1_V12N28-333_C1,0,1,0,2,0,3
GACATACTGTCGCAGA-1_V12N28-333_C1,1,5,0,3,0,9
TGGACACCGTTGCTTG-1_V12N28-333_C1,0,0,0,6,0,6
TGCGATGCTAATGGCT-1_V12N28-333_C1,0,1,2,2,0,5
TTCTGTTTCCTGTCGC-1_V12N28-333_C1,1,3,0,3,0,7
CGTTGTAAACGTCAGG-1_V12N28-333_C1,1,4,0,2,0,7
GATCGGCGATAAGTCG-1_V12N28-333_C1,1,2,0,0,0,3
AGCCTTAAAGCGGAAG-1_V12N28-333_C1,1,4,1,5,0,11
TCCGTAACCACAATCC-1_V12N28-333_C1,0,6,1,1,0,8
GAATGCCGAAATGACC-1_V12N28-333_C1,3,1,1,1,0,6
TATACTCATGCGGCAA-1_V12N28-333_C1,2,2,0,2,0,6
TAGTGTCAGAAACGGC-1_V12N28-333_C1,0,1,2,1,0,4
CGTCATACCATATCCA-1_V12N28-333_C1,1,3,0,0,0,4
TAGTACCTTAGTGGTC-1_V12N28-333_C1,0,2,0,2,0,4
CTGGCGGGAATAAGTA-1_V12N28-333_C1,2,2,3,0,0,7
AGTGTGGTCTATTGTG-1_V12N28-333_C1,0,6,1,0,0,7
GCTATCGCGGCGCAAC-1_V12N28-333_C1,0,1,3,0,0,4
CAGTAATCCCTCCCAG-1_V12N28-333_C1,0,3,1,3,0,7
GTATTAAGGCGTCTAA-1_V12N28-333_C1,0,5,0,0,0,5
CTAATTTCAACAACAC-1_V12N28-333_C1,1,4,0,0,0,5
TTAGCAACATGGATGT-1_V12N28-333_C1,0,1,2,0,0,3
ATGCTCAGTGTTGCAT-1_V12N28-333_C1,2,4,1,0,0,7
GATGTTTGTGCGAGAT-1_V12N28-333_C1,0,4,1,1,0,6
CACTTCGCCACAGGCT-1_V12N28-333_C1,0,4,0,0,0,4
CTGTATGGTGTAGAAA-1_V12N28-333_C1,1,5,0,4,0,10
TACGTGCACTATGCTG-1_V12N28-333_C1,0,1,0,0,0,1
GTATCAGCTTGGGTTC-1_V12N28-333_C1,0,2,1,2,0,5
TAACAAAGGGAGAAGC-1_V12N28-333_C1,0,4,1,0,0,5
TTACATCGTGGCCTGG-1_V12N28-333_C1,1,3,0,1,0,5
TCTGAACCGGTCGGCT-1_V12N28-333_C1,0,0,0,0,0,0
GGCTCGTGCCACCAGC-1_V12N28-333_C1,2,2,0,0,0,4
TATAAGTGAGGATAGC-1_V12N28-333_C1,0,2,0,1,0,3
GCCCGCGCGTTTGACA-1_V12N28-333_C1,3,0,0,2,0,5
TGCTGGTTGGACAATT-1_V12N28-333_C1,0,0,0,0,0,0
GCCTAGCGATCTGACC-1_V12N28-333_C1,0,0,0,0,0,0
TTCCTCGAGGGTGTCT-1_V12N28-333_C1,0,1,0,0,0,1
CAACGACCCGTTTACA-1_V12N28-333_C1,0,5,1,0,0,6
CTTGTACTTGTTGACT-1_V12N28-333_C1,0,5,0,1,0,6
TCTCTAATAGCTGGTA-1_V12N28-333_C1,0,0,1,2,0,3
ATTATGCCATAGGGAG-1_V12N28-333_C1,0,0,0,0,0,0
GACAACGCAGCTTACG-1_V12N28-333_C1,0,3,0,1,0,4
AGATGACTCGCCCACG-1_V12N28-333_C1,1,1,0,2,0,4
GTGCGGGTCTCCAAAT-1_V12N28-333_C1,0,1,1,0,0,2
GTACGAGATTGCGACA-1_V12N28-333_C1,0,1,0,3,0,4
GTATAGGACTCAGTAG-1_V12N28-333_C1,1,1,0,1,0,3
TTGCACGGAGCAGCAC-1_V12N28-333_C1,0,3,0,7,0,10
CACAGCTAGGGAGTGA-1_V12N28-333_C1,0,2,0,2,0,4
ATACTAGCATGACCCT-1_V12N28-333_C1,2,1,0,0,0,3
CCAAGACTTCTGCGAA-1_V12N28-333_C1,0,0,0,2,0,2
ACATAATAAGGCGGTG-1_V12N28-333_C1,0,2,0,4,0,6
TAATACACAGTAGTAT-1_V12N28-333_C1,0,1,2,4,0,7
TCTTGGTAACACCAAA-1_V12N28-333_C1,0,3,0,2,0,5
AACTGGGTCCCGACGT-1_V12N28-333_C1,2,2,0,3,0,7
ATCACTTCATCCTCGC-1_V12N28-333_C1,0,1,1,4,0,6
TGGAAGGATAAAGATG-1_V12N28-333_C1,0,1,0,0,0,1
CATGATGCACAATTCT-1_V12N28-333_C1,0,2,0,1,0,3
ATAGGGATATCCTTGA-1_V12N28-333_C1,1,1,0,3,0,5
CACCTAATCAGTTTAC-1_V12N28-333_C1,0,0,0,1,0,1
TGTGACTACGCCAGTC-1_V12N28-333_C1,0,1,3,1,0,5
CCCGACCATAGTCCGC-1_V12N28-333_C1,0,2,1,2,0,5
CGCGCCCGACTTAATA-1_V12N28-333_C1,2,1,2,0,0,5
TGCCACCTGGCGAAAC-1_V12N28-333_C1,0,1,0,5,0,6
CTGCCAAGGTTGGAAG-1_V12N28-333_C1,0,0,0,4,0,4
TCTCCAACGTAGGTTA-1_V12N28-333_C1,1,2,1,0,0,4
TTCTTGGAGTAATGAG-1_V12N28-333_C1,0,3,1,2,0,6
GTCTCGATCTGCTTTC-1_V12N28-333_C1,0,2,0,2,0,4
TACTCTCCGAACAAAT-1_V12N28-333_C1,1,1,0,1,0,3
ATCACATTAGAATATC-1_V12N28-333_C1,0,2,0,5,0,7
TACGGGATGCTAGCAG-1_V12N28-333_C1,1,1,0,7,0,9
AGCTGAAGTAAACCAA-1_V12N28-333_C1,0,2,0,2,0,4
CATGGGTCGGGTGTGG-1_V12N28-333_C1,1,1,0,1,0,3
CACCCACGAGGCAATT-1_V12N28-333_C1,0,0,0,3,0,3
TGCCATTACTAAAGAA-1_V12N28-333_C1,1,1,0,7,0,9
CCGTTACGTTAGAACA-1_V12N28-333_C1,1,3,0,4,0,8
GCCAGGAGTAACCGAT-1_V12N28-333_C1,0,1,0,1,0,2
GGAAAGTGCCCATGCC-1_V12N28-333_C1,0,2,0,5,0,7
TCTTACCGGAACTCGT-1_V12N28-333_C1,0,2,0,5,0,7
TATGTCAAGACCGACT-1_V12N28-333_C1,1,0,0,3,0,4
CCTAACTAAGGCTCTA-1_V12N28-333_C1,0,2,0,3,0,5
GCGGTGAACTGCGCTC-1_V12N28-333_C1,1,0,0,3,0,4
CCTCGCGCGATATAGG-1_V12N28-333_C1,0,2,2,2,0,6
ATCGGCAAGCAGTCCA-1_V12N28-333_C1,2,1,0,3,0,6
AGATCGTGCATAAGAT-1_V12N28-333_C1,0,0,1,4,0,5
ATTCAGGACCTATTTC-1_V12N28-333_C1,2,0,1,3,0,6
AGCTAGAAGCAGAAGT-1_V12N28-333_C1,1,5,0,3,0,9
TTCGCTATCTGACGTG-1_V12N28-333_C1,0,2,0,2,0,4
TTCCGCAGAGAAATAT-1_V12N28-333_C1,0,3,2,6,0,11
CAGTACATTCTCTAAA-1_V12N28-333_C1,0,3,0,1,0,4
GTGAAGATTTCAAGTG-1_V12N28-333_C1,0,0,0,2,1,3
AACGCATGATCTGGGT-1_V12N28-333_C1,0,2,1,2,0,5
CCCAGAGGAGGGCGTA-1_V12N28-333_C1,0,0,1,2,0,3
GGAAACCTTGTTGAAT-1_V12N28-333_C1,0,2,0,0,0,2
GTGAAGCCGTATAGTC-1_V12N28-333_C1,0,1,1,0,0,2
GAGCTGTCGTCTCGGA-1_V12N28-333_C1,0,0,1,1,3,5
TGTCATTTGTTGGGAA-1_V12N28-333_C1,0,2,0,4,1,7
ACCAACACCACACACT-1_V12N28-333_C1,0,0,1,0,0,1
AAATGATTCGATCAGC-1_V12N28-333_C1,1,0,0,0,0,1
CTGCTTTATGTCCGCG-1_V12N28-333_C1,0,0,0,1,0,1
GCGAGAGGCCATGTAA-1_V12N28-333_C1,0,0,0,2,0,2
ATTGACCGGCGATGAC-1_V12N28-333_C1,1,2,1,1,0,5
ACCCTGGTAACGCCCT-1_V12N28-333_C1,0,3,0,0,1,4
GTTGGACCGCATCAGG-1_V12N28-333_C1,0,1,0,0,0,1
CGTTTACAAGGCAGCT-1_V12N28-333_C1,0,2,0,0,2,4
CGGTCCATGAGACTCC-1_V12N28-333_C1,1,0,0,0,0,1
GTTCGTCTGGGTCCCT-1_V12N28-333_C1,0,1,0,3,0,4
TGTACTACTCTCACGG-1_V12N28-333_C1,0,1,0,2,1,4
AGTGAAGATGGTGTCC-1_V12N28-333_C1,0,0,0,0,0,0
GAGGGCCATAATATTA-1_V12N28-333_C1,0,1,0,0,0,1
ACTCCCGTAGACTAGG-1_V12N28-333_C1,0,1,0,0,1,2
CGTCAAATGGTCGCAG-1_V12N28-333_C1,0,2,0,0,0,2
AAGTCTAGTAGCTGCC-1_V12N28-333_C1,0,2,0,2,0,4
AAGAAATCACCAGATT-1_V12N28-333_C1,0,2,0,1,0,3
GAGTGCACGGACAACA-1_V12N28-333_C1,0,2,0,0,1,3
GTTCAAATCAGATGTC-1_V12N28-333_C1,0,5,0,1,0,6
CATGGCTCCCTATGTC-1_V12N28-333_C1,1,0,0,2,0,3
GGCCACACGAAAGCCT-1_V12N28-333_C1,2,2,0,1,0,5
GAAGCCGGGTAAGCTC-1_V12N28-333_C1,0,4,0,6,0,10
TTGCGCTCTCTCGCTT-1_V12N28-333_C1,2,3,0,2,0,7
TACATGACCTTATCCG-1_V12N28-333_C1,0,0,1,2,0,3
GTCCTTCTACAACCCA-1_V12N28-333_C1,0,4,0,3,0,7
TATATGCTGGGTTGCC-1_V12N28-333_C1,0,2,0,1,0,3
GTTTATGGGATTTAGA-1_V12N28-333_C1,3,2,1,0,0,6
GGAACCCGAACAAGAA-1_V12N28-333_C1,0,0,1,6,0,7
AACGTTATCAGCACCT-1_V12N28-333_C1,0,1,0,3,0,4
CATCGTCCGGTTACTA-1_V12N28-333_C1,1,2,0,2,0,5
AGACAGCTCAGAATCC-1_V12N28-333_C1,0,0,1,2,0,3
GCAGATCCTCGCAAAT-1_V12N28-333_C1,0,2,0,2,0,4
GGGTCATGCGTACCAT-1_V12N28-333_C1,1,5,0,1,0,7
CTGGTCATTCCAATCC-1_V12N28-333_C1,0,0,0,2,0,2
TCAGGGCGCAAACTCG-1_V12N28-333_C1,1,0,2,2,0,5
GATGCCAGCAGAAGGC-1_V12N28-333_C1,0,3,0,0,0,3
GTTATTAACGTGGGAG-1_V12N28-333_C1,1,3,1,4,0,9
AATACAATGTTTCAGG-1_V12N28-333_C1,1,1,0,0,0,2
TTGCTGCACCTATCCA-1_V12N28-333_C1,2,3,1,2,0,8
CCAGAGACAAAGCCGG-1_V12N28-333_C1,0,2,1,1,0,4
CCGAAGTATATTGTTC-1_V12N28-333_C1,0,2,1,1,0,4
GCTAAACCTGAGGTGA-1_V12N28-333_C1,2,0,1,1,0,4
TCATACTTACAGATCC-1_V12N28-333_C1,0,1,1,0,0,2
CGAGCACTTCAAGTTT-1_V12N28-333_C1,1,1,0,1,0,3
TAGCAACCTGTCACAA-1_V12N28-333_C1,0,3,0,3,0,6
TGGGAAATGCCTTTCC-1_V12N28-333_C1,0,3,1,0,0,4
AGACCATGGGATACAA-1_V12N28-333_C1,0,6,0,0,0,6
TAAATGAATCCGTTTC-1_V12N28-333_C1,1,2,1,1,0,5
ACAACGGTCCCTGCGA-1_V12N28-333_C1,0,2,1,2,0,5
GTCACTCTCCAAATCT-1_V12N28-333_C1,2,3,0,0,0,5
TTCTACTTGCGAGGGC-1_V12N28-333_C1,0,3,0,1,0,4
CGCAATTACTTTCGGT-1_V12N28-333_C1,1,0,0,0,0,1
CTGTTCATCTCACGGG-1_V12N28-333_C1,0,0,0,0,0,0
TTCTTGTAACCTAATG-1_V12N28-333_C1,0,1,0,1,0,2
GCTTGATGATAATCAG-1_V12N28-333_C1,0,2,0,0,0,2
TTGGCTCGCATGAGAC-1_V12N28-333_C1,0,1,0,5,0,6
GCCCAGTTGGTATGCC-1_V12N28-333_C1,0,6,0,1,0,7
ATTCCTCCGCCAGTGC-1_V12N28-333_C1,0,0,1,1,0,2
TCGTCCGCTGGCGTCT-1_V12N28-333_C1,0,3,0,1,0,4
GGAGAAGTCATTGGCA-1_V12N28-333_C1,0,2,0,2,0,4
TTGTTAGCAAATTCGA-1_V12N28-333_C1,0,1,1,3,0,5
TCTAGCATCTTCGATG-1_V12N28-333_C1,1,0,0,1,0,2
AATGACTGTCAGCCGG-1_V12N28-333_C1,0,0,0,0,0,0
CCAAACAGAACCCTCG-1_V12N28-333_C1,0,1,0,4,0,5
TATCGATGATTAAACG-1_V12N28-333_C1,0,2,0,1,0,3
GAACACACATCAACCA-1_V12N28-333_C1,0,2,1,1,0,4
CCCGTCAGCGTCTGAC-1_V12N28-333_C1,2,1,0,3,0,6
AGCATCGTCGATAATT-1_V12N28-333_C1,1,3,0,0,0,4
GACTAAGATCATGCAC-1_V12N28-333_C1,0,3,0,2,0,5
TAGGGTGTTTCAAGAG-1_V12N28-333_C1,0,1,0,3,0,4
TGGTTCGTAGCAAAGG-1_V12N28-333_C1,0,2,1,1,0,4
CTGTTCACTGCCTGTG-1_V12N28-333_C1,1,2,0,3,0,6
ATGTGCATCCGACGCA-1_V12N28-333_C1,0,4,0,4,0,8
TTGTCGTTCAGTTACC-1_V12N28-333_C1,1,2,0,3,0,6
CGGGATCAATGTAAGA-1_V12N28-333_C1,1,2,0,0,0,3
TTATCTGTATCATAAC-1_V12N28-333_C1,1,0,2,5,0,8
ATCGACTCTTTCCGTT-1_V12N28-333_C1,0,4,0,3,0,7
CTCATTTGATGGGCGG-1_V12N28-333_C1,2,3,1,4,0,10
GTAAGCGGGCAGTCAG-1_V12N28-333_C1,1,4,0,3,0,8
TCTATCGGTCGCAACA-1_V12N28-333_C1,2,1,2,0,0,5
AACGCGGTCTCCAGCC-1_V12N28-333_C1,0,2,1,6,0,9
ATTAATACTACGCGGG-1_V12N28-333_C1,0,1,0,3,0,4
CTTTAACTTTCAAAGG-1_V12N28-333_C1,0,4,0,3,0,7
CGTACCTGATAGGCCT-1_V12N28-333_C1,0,0,0,3,0,3
GAATGTTGGGTAATCT-1_V12N28-333_C1,0,1,0,1,0,2
TGCGGAGTAAAGGTGC-1_V12N28-333_C1,0,0,0,7,0,7
CCTGAATATTTACATA-1_V12N28-333_C1,0,1,1,1,0,3
TTGCTCCCATACCGGA-1_V12N28-333_C1,0,1,0,7,0,8
CCTCTAATCTGCCAAG-1_V12N28-333_C1,0,1,0,5,0,6
AGGTTGAGGCACGCTT-1_V12N28-333_C1,0,2,3,5,0,10
TCCCGTCAGTCCCGCA-1_V12N28-333_C1,1,3,0,2,0,6
TCCGATGACTGAGCTC-1_V12N28-333_C1,0,1,1,3,0,5
CAGCCTCCTGCAGAGG-1_V12N28-333_C1,0,0,1,2,0,3
CTTAGCCTTCCACATG-1_V12N28-333_C1,0,2,0,3,0,5
ATTAATGAACCAGTCG-1_V12N28-333_C1,1,3,0,0,0,4
ACGATACATAGAACTA-1_V12N28-333_C1,1,3,0,3,0,7
AGCCACTCCCGTGCTT-1_V12N28-333_C1,0,1,1,3,0,5
ATACGGGTTTCGATTG-1_V12N28-333_C1,0,0,2,1,0,3
CTGTCAAATGGCTCGG-1_V12N28-333_C1,0,0,0,0,0,0
GCTCGGAATTTAAAGC-1_V12N28-333_C1,0,1,0,1,0,2
TAGGCATGTTACGCCA-1_V12N28-333_C1,1,0,0,3,0,4
TGGCAACTCGCGCGCC-1_V12N28-333_C1,1,2,1,0,0,4
ATCAGTAGGCAGGGAT-1_V12N28-333_C1,0,2,1,6,0,9
TATCGATCTATGCATA-1_V12N28-333_C1,0,3,0,4,0,7
CGACTCAGGATGTTAT-1_V12N28-333_C1,1,2,1,4,0,8
GCCATATTGCACACAG-1_V12N28-333_C1,0,1,1,3,1,6
AATTCATAAGGGATCT-1_V12N28-333_C1,0,2,0,0,0,2
CGGTAGAGGTGCAGGT-1_V12N28-333_C1,1,1,0,3,0,5
AATGATGATACGCTAT-1_V12N28-333_C1,1,1,0,2,0,4
CTTGTGCTCACCGATT-1_V12N28-333_C1,0,1,0,2,0,3
TTCCAATCAGAGCTAG-1_V12N28-333_C1,1,1,0,3,0,5
CGATGGACCCTACGCC-1_V12N28-333_C1,0,2,0,1,0,3
GGTCGGATAAACGGCG-1_V12N28-333_C1,0,3,0,2,0,5
TTAGCTAATACGATCT-1_V12N28-333_C1,0,0,1,3,0,4
CTCGATATTTGCGAGC-1_V12N28-333_C1,0,3,4,1,0,8
ATTACTTACTGGGCAT-1_V12N28-333_C1,0,0,0,1,0,1
CTAGCCGATGTTATGA-1_V12N28-333_C1,2,0,0,3,0,5
TACTGCAATCAATTAC-1_V12N28-333_C1,0,0,1,2,0,3
TAGTCTGTGACGTTGC-1_V12N28-333_C1,0,0,1,0,0,1
CTCGTTTCTAATGTTT-1_V12N28-333_C1,0,0,1,2,1,4
TTCGTTCAACGAAGTT-1_V12N28-333_C1,0,3,0,0,0,3
CTGAATTTATTGCCAG-1_V12N28-333_C1,1,1,1,4,0,7
TGGAATATCCTTGACC-1_V12N28-333_C1,0,1,0,3,0,4
CAGATCATTTAAAGTC-1_V12N28-333_C1,1,1,0,0,0,2
CTCCTTTACGCAAGTC-1_V12N28-333_C1,0,2,0,2,0,4
TCCCAAACAGACAACG-1_V12N28-333_C1,2,0,0,1,0,3
ATCGCTGCGTGCAGCA-1_V12N28-333_C1,0,0,0,1,0,1
TTAGTTCAAGTGTTCG-1_V12N28-333_C1,0,1,0,0,0,1
AAACTCGTGATATAAG-1_V12N28-333_C1,0,0,0,2,0,2
TTAACGAACAAGCAGT-1_V12N28-333_C1,0,2,0,0,0,2
GTTATATCAGGAGCCA-1_V12N28-333_C1,0,0,0,0,0,0
CAAATTGGATTATGCC-1_V12N28-333_C1,0,3,0,0,0,3
CGAGGAGCTTCCATAT-1_V12N28-333_C1,0,0,0,1,1,2
GGAGACCAATGTGCTT-1_V12N28-333_C1,0,2,0,0,1,3
CATTGATGAACACGCC-1_V12N28-333_C1,1,1,0,0,0,2
GTCAATGCTATAATTT-1_V12N28-333_C1,0,2,0,1,0,3
ACCACCCTCTCTTCTA-1_V12N28-333_C1,1,1,0,0,5,7
TGGAGGGAAACACCTC-1_V12N28-333_C1,0,2,0,0,0,2
CACGGACGTGGATGGC-1_V12N28-333_C1,0,2,0,1,0,3
AACTTTCTCGATCATG-1_V12N28-333_C1,0,1,0,1,1,3
CGTATTGTTTCCTAAT-1_V12N28-333_C1,0,2,0,1,0,3
CCTACTGCGGCGGCCA-1_V12N28-333_C1,0,4,0,0,0,4
CTTAGGTCCCAATCGT-1_V12N28-333_C1,0,2,0,1,0,3
CGCAATCGATCATTAG-1_V12N28-333_C1,2,1,1,0,0,4
TGGTTATGCTTGCGGT-1_V12N28-333_C1,1,4,0,0,0,5
GGCTTGGCTCTCACCT-1_V12N28-333_C1,0,4,0,0,0,4
ATTGGTAGGATCCGCT-1_V12N28-333_C1,2,3,0,4,0,9
TCAGGGCGACTTCCTT-1_V12N28-333_C1,1,4,0,2,0,7
TCTGCAGATTCGAGTC-1_V12N28-333_C1,1,3,0,2,0,6
CTCTCGCTGTACTATG-1_V12N28-333_C1,1,4,0,2,0,7
AATAGTCGCGAGTCGG-1_V12N28-333_C1,1,4,0,2,0,7
AGTTACCCTTAAGACT-1_V12N28-333_C1,1,2,0,4,0,7
CTTAAATAAGACCCAT-1_V12N28-333_C1,0,2,0,4,0,6
GGTTGTGCTCTTGTCC-1_V12N28-333_C1,1,3,0,1,0,5
GTGAGTCTAAGACGGA-1_V12N28-333_C1,1,2,0,4,0,7
CGCGACACTGCGCAGC-1_V12N28-333_C1,3,3,0,3,0,9
GCTCGCGGTTCCGCTC-1_V12N28-333_C1,0,1,1,1,0,3
TTAACTCACGCGTGGA-1_V12N28-333_C1,0,4,0,2,0,6
GGAACGGCCTGCAGCC-1_V12N28-333_C1,1,1,0,5,0,7
GTAGAAACGGGTGGAG-1_V12N28-333_C1,0,4,0,2,0,6
TAATGAAAGACCCTTG-1_V12N28-333_C1,1,2,0,3,0,6
AGGCTTGCTAGACACC-1_V12N28-333_C1,0,3,0,3,0,6
TTGCGTAGTTTGAGGA-1_V12N28-333_C1,0,2,0,1,0,3
CGCCCTTGAAGGCTGA-1_V12N28-333_C1,0,1,0,2,0,3
CCCGGTGGAAGAACCT-1_V12N28-333_C1,0,0,3,2,0,5
TTAACACCTCGAACAT-1_V12N28-333_C1,1,2,0,2,0,5
GATTCCTATACGGCGC-1_V12N28-333_C1,1,1,0,2,0,4
TTACCCTAACAGTCCT-1_V12N28-333_C1,2,4,0,1,0,7
ACCCACCTACATGCTC-1_V12N28-333_C1,2,1,0,3,0,6
AAAGGGCAGCTTGAAT-1_V12N28-333_C1,1,1,0,1,0,3
CACACAGGGATAGATT-1_V12N28-333_C1,1,1,4,0,0,6
AGAGCGTACAAGCTCG-1_V12N28-333_C1,0,1,0,1,0,2
TCTTACGGCATCCGAC-1_V12N28-333_C1,0,1,0,1,0,2
GCCTATTCCGATATAG-1_V12N28-333_C1,0,4,1,0,0,5
GAAAGTGACTAACTGC-1_V12N28-333_C1,0,2,0,1,0,3
CCGGAATGGTTTCAGT-1_V12N28-333_C1,0,3,0,2,0,5
AGTATAATACTAGGCA-1_V12N28-333_C1,0,2,0,1,0,3
TAACTATCGAAGGTCC-1_V12N28-333_C1,0,1,0,1,0,2
ATGAGGAGTGTTAATC-1_V12N28-333_C1,0,1,0,1,0,2
TGTGTCGCGAGTTGCA-1_V12N28-333_C1,0,1,0,0,0,1
ATCCAACGCAGTCATA-1_V12N28-333_C1,0,1,1,1,0,3
AAGGCGCGTAAAGCTT-1_V12N28-333_C1,0,3,0,0,0,3
AGTCGGCCCAAACGAC-1_V12N28-333_C1,1,1,0,0,0,2
AACGTCAGACTAGTGG-1_V12N28-333_C1,0,3,0,4,0,7
ACTACCAGCTCTCTGG-1_V12N28-333_C1,0,1,1,0,0,2
GCAAGTGCACAGAGAA-1_V12N28-333_C1,0,0,0,4,0,4
ACACCTTAAGTAGGGC-1_V12N28-333_C1,2,3,1,2,0,8
TTCGACGGGAAGGGCG-1_V12N28-333_C1,0,0,1,3,0,4
TTCGCACTCGCGTGCT-1_V12N28-333_C1,0,0,1,1,0,2
TATTTGTTACCCTTTA-1_V12N28-333_C1,3,1,2,0,0,6
CGCTGTGACGCCGCAC-1_V12N28-333_C1,1,2,0,1,0,4
GTTGCACGGAGTTTCG-1_V12N28-333_C1,2,0,1,2,0,5
GTTTCCTGGAGGGTGA-1_V12N28-333_C1,2,3,0,2,0,7
ACACCCAGCATGCAGC-1_V12N28-333_C1,0,2,0,1,0,3
TCAACCATGTTCGGGC-1_V12N28-333_C1,0,2,0,2,0,4
TTACAACTACGCATCC-1_V12N28-333_C1,0,3,0,0,0,3
TCCGATGGTGCGACAT-1_V12N28-333_C1,0,0,0,1,0,1
GGGCGTACATTTATAT-1_V12N28-333_C1,1,2,0,2,0,5
AGCGACCAACGATATT-1_V12N28-333_C1,0,3,1,3,0,7
ACACAAAGACGGGTGG-1_V12N28-333_C1,0,2,0,0,0,2
ATCGCACGCCGGGAGA-1_V12N28-333_C1,1,0,0,2,0,3
GCTCTAAACCCTGACG-1_V12N28-333_C1,1,1,0,1,1,4
AATGCAACCGGGTACC-1_V12N28-333_C1,0,1,0,4,0,5
TCAAACAACCGCGTCG-1_V12N28-333_C1,0,1,0,4,0,5
TATGCTCCCTACTTAC-1_V12N28-333_C1,0,2,1,2,0,5
AAAGGGATGTAGCAAG-1_V12N28-333_C1,0,1,0,3,0,4
ACGATCATACATAGAG-1_V12N28-333_C1,1,1,1,5,0,8
TTGTTCAGTGTGCTAC-1_V12N28-333_C1,0,3,1,6,0,10
ATGCATGATCCAGGAT-1_V12N28-333_C1,0,0,2,0,0,2
AGTCTTCTCCTCAAAT-1_V12N28-333_C1,0,1,0,5,0,6
GATTCCCTTGTCGCAG-1_V12N28-333_C1,0,2,2,3,0,7
CTCGCACCTATATAGT-1_V12N28-333_C1,1,5,0,2,0,8
ACTCAATAAAGGCACG-1_V12N28-333_C1,2,0,0,7,0,9
AACCGAGCTTGGTCAT-1_V12N28-333_C1,2,0,0,3,0,5
TAAGGCAACATAAGAT-1_V12N28-333_C1,2,1,0,3,0,6
CACGCACAGCGCAGCT-1_V12N28-333_C1,0,2,1,5,0,8
GGTTTACAATCTCAAT-1_V12N28-333_C1,0,0,1,1,0,2
TGCAGGATCGGCAAAG-1_V12N28-333_C1,1,1,0,1,0,3
ATAACGGAGTCCAACG-1_V12N28-333_C1,0,1,0,5,0,6
AACGATATGTCAACTG-1_V12N28-333_C1,1,1,1,1,0,4
GACAACGACCATTGAA-1_V12N28-333_C1,3,0,0,2,0,5
TTGACCATGTTCTCCG-1_V12N28-333_C1,0,1,0,3,0,4
AGTACGGGCACCTGGC-1_V12N28-333_C1,0,0,2,5,0,7
CGCCATCCGATTATGA-1_V12N28-333_C1,0,3,0,2,0,5
AAGGTATCCTAATATA-1_V12N28-333_C1,1,0,0,1,0,2
TGTTGTCAAGAAGTCT-1_V12N28-333_C1,0,3,0,4,0,7
CAGTGAATAAATGACT-1_V12N28-333_C1,3,2,1,3,0,9
CACCTTGCGAAACTCG-1_V12N28-333_C1,0,1,0,3,0,4
CATTTAGCGGACCATG-1_V12N28-333_C1,0,0,1,3,0,4
CCAGTCTAGACGGCGC-1_V12N28-333_C1,0,1,0,3,0,4
TCGCTTTAAACGTTTG-1_V12N28-333_C1,1,0,0,3,0,4
GTGAAACGGCGCCACC-1_V12N28-333_C1,0,1,0,1,0,2
GGGCTCATCGAACCCA-1_V12N28-333_C1,0,2,0,5,0,7
TTGATGTGTAGTCCCG-1_V12N28-333_C1,0,2,0,3,0,5
CAGTAGCCCACGCGGT-1_V12N28-333_C1,0,1,1,2,0,4
AGCGCGGGTGCCAATG-1_V12N28-333_C1,0,1,2,7,0,10
TAATCGATCCGTACGT-1_V12N28-333_C1,0,2,0,2,0,4
AGTGGCGGCAATTTGA-1_V12N28-333_C1,1,0,0,4,0,5
CCTTTCAATGAAGAAA-1_V12N28-333_C1,0,0,0,1,0,1
CTCAGTCACGACAAAT-1_V12N28-333_C1,0,3,0,6,1,10
ATAGGCTAGCTTCGCA-1_V12N28-333_C1,0,0,0,4,0,4
CGGTTCAAGTAGGTGT-1_V12N28-333_C1,0,1,1,3,0,5
CAGTCGAGGATGCAAT-1_V12N28-333_C1,0,3,2,0,0,5
TATCACCCAACCGACC-1_V12N28-333_C1,1,0,0,3,0,4
AATGATGCGACTCCTG-1_V12N28-333_C1,0,4,1,3,0,8
TGGAACCACTGACACA-1_V12N28-333_C1,2,2,1,2,1,8
GCCAATAGGGCATCTC-1_V12N28-333_C1,0,2,1,4,0,7
TTCTTTGGTCGCGACG-1_V12N28-333_C1,0,3,0,0,0,3
ATTAGATTCCTCAGCA-1_V12N28-333_C1,0,1,1,0,1,3
CCGTGGAACGATCCAA-1_V12N28-333_C1,0,0,1,0,0,1
GGGTCGTGGCAAGTGT-1_V12N28-333_C1,0,1,1,2,1,5
TCGCTCGGCACCAGCG-1_V12N28-333_C1,0,0,1,1,0,2
ACGCAATCACTACAGC-1_V12N28-333_C1,0,1,0,0,0,1
CTCTAATGCATTGATC-1_V12N28-333_C1,1,0,3,1,0,5
GTCTCGACTAAGTTTG-1_V12N28-333_C1,0,4,0,1,0,5
TGGTTTAAACGTGGGT-1_V12N28-333_C1,0,0,0,2,0,2
CGCAGATCTTCACCCG-1_V12N28-333_C1,0,1,0,0,0,1
TCCAGATGTACGCCAA-1_V12N28-333_C1,0,2,1,0,0,3
CATTGCGGGTCAATTC-1_V12N28-333_C1,0,2,0,0,3,5
GACGTTCGTAAATACA-1_V12N28-333_C1,0,2,0,0,0,2
TACACCGTCGTTAGTC-1_V12N28-333_C1,1,0,0,1,0,2
ACGGGCGTATGCGACA-1_V12N28-333_C1,0,2,0,0,0,2
GAAGGCTACCATTGTT-1_V12N28-333_C1,0,0,0,0,2,2
TAAATCTTTACACCTC-1_V12N28-333_C1,0,1,0,0,0,1
AGTTTATGTAAAGACA-1_V12N28-333_C1,0,2,0,0,0,2
AGGAGACATCCACAGT-1_V12N28-333_C1,0,2,0,0,0,2
CAACCTGAACCTGCCA-1_V12N28-333_C1,0,2,0,0,0,2
AGTCCCTCGCAGAAAG-1_V12N28-333_C1,0,3,0,0,0,3
TGTATACGGATGATGA-1_V12N28-333_C1,0,2,0,2,0,4
TTGTGGTATAGGTATG-1_V12N28-333_C1,0,1,0,1,1,3
TCTGCACCATTAGTAA-1_V12N28-333_C1,0,0,0,0,0,0
AAATGTATCTTATCCC-1_V12N28-333_C1,2,1,0,0,0,3
ACTCTAAACCTGGGAT-1_V12N28-333_C1,1,2,0,5,0,8
GCTGGCAGGTGCCGTG-1_V12N28-333_C1,0,3,0,2,0,5
CTCATTCGTGAACATC-1_V12N28-333_C1,1,4,0,0,0,5
TCGCCGGATGGGCAAG-1_V12N28-333_C1,1,2,0,2,0,5
GGACTAAGTCAGGAGT-1_V12N28-333_C1,2,1,0,1,0,4
TATCAAAGGTCTGTAA-1_V12N28-333_C1,3,5,2,2,0,12
TTCAGTTTGTGGCAGC-1_V12N28-333_C1,0,2,1,2,0,5
TGTTCATAAATGTGCT-1_V12N28-333_C1,1,1,0,4,0,6
CTTAGCCCGGATAGTG-1_V12N28-333_C1,1,2,1,0,0,4
GATGCGAATGGTATTA-1_V12N28-333_C1,1,4,0,1,0,6
TCTAACTGTATGTAAA-1_V12N28-333_C1,1,1,1,1,0,4
TTAAACCTGGTTCCTT-1_V12N28-333_C1,2,2,0,3,0,7
GCTAAGTAAAGGCGAT-1_V12N28-333_C1,0,3,0,0,0,3
AGTTACCGCACATGGT-1_V12N28-333_C1,1,2,1,2,0,6
GACTGCGGCACGTGTA-1_V12N28-333_C1,0,4,0,1,0,5
TGGTGATCGTATTTGT-1_V12N28-333_C1,2,1,1,0,0,4
TTATCGCCTGCGAAGC-1_V12N28-333_C1,1,1,0,5,0,7
TGGAATTAGACGCTTT-1_V12N28-333_C1,0,1,0,3,0,4
TCGTCACACTGTTAGC-1_V12N28-333_C1,0,2,2,0,0,4
TTATGTTTGCGATAGA-1_V12N28-333_C1,1,1,0,1,0,3
GGTGCTGATCACAAAG-1_V12N28-333_C1,1,2,0,3,0,6
CATAGCCGCCCGGGAT-1_V12N28-333_C1,0,2,2,4,0,8
GGTTAGTTACGGCGCC-1_V12N28-333_C1,0,3,0,3,0,6
ATTCCCACATAAACAA-1_V12N28-333_C1,0,3,0,1,0,4
ATTCAGTAGCAGGGTC-1_V12N28-333_C1,0,6,0,1,0,7
CAGTTCCGCGGGTCGA-1_V12N28-333_C1,1,0,1,0,0,2
AAGAGATGAATCGGTA-1_V12N28-333_C1,0,0,1,1,0,2
CGCAATTCTACAATAA-1_V12N28-333_C1,0,2,0,0,0,2
TAACGCTTTGAGAGCG-1_V12N28-333_C1,0,1,0,1,0,2
AGGCTATGGTTAGCTT-1_V12N28-333_C1,0,2,0,0,0,2
GAGGAATGGAGAGGTT-1_V12N28-333_C1,1,4,1,3,0,9
TCCTCTACGAGATGGC-1_V12N28-333_C1,1,1,1,3,0,6
TTGATTATGCAGATGA-1_V12N28-333_C1,0,1,0,4,0,5
TCAGTACTGACCCGCG-1_V12N28-333_C1,1,2,0,1,0,4
TTATGACAAACTGGAT-1_V12N28-333_C1,1,0,0,2,0,3
GTAAGTAGGGTATACC-1_V12N28-333_C1,0,2,1,0,0,3
CGCAAACACGAGTTAC-1_V12N28-333_C1,1,2,0,1,0,4
TGGCCGTATATTGACC-1_V12N28-333_C1,0,1,0,1,0,2
ACTGTAGCACTTTGGA-1_V12N28-333_C1,0,2,0,2,0,4
GCTCTATGTTACGTGC-1_V12N28-333_C1,0,1,0,1,0,2
TGCGCGATTAACGGAG-1_V12N28-333_C1,0,0,0,3,0,3
GAATCGACATGGTCAC-1_V12N28-333_C1,0,1,0,2,0,3
GACTAAGTAGGCTCAC-1_V12N28-333_C1,0,4,0,1,0,5
ATCTTGACCTGCAACG-1_V12N28-333_C1,2,1,0,1,0,4
ATGCACTACCGCATTG-1_V12N28-333_C1,0,0,0,0,0,0
CAGATACTAACATAGT-1_V12N28-333_C1,2,2,1,2,0,7
GATCGACACTATCTGA-1_V12N28-333_C1,0,1,0,2,0,3
ATAGAGTACTGGGACA-1_V12N28-333_C1,0,1,3,1,0,5
CCTACTGCTTACACTT-1_V12N28-333_C1,0,0,0,2,0,2
CCTGCTATTTGAGAAG-1_V12N28-333_C1,0,3,0,3,0,6
CGCGTTCATGAAATAC-1_V12N28-333_C1,1,0,0,4,0,5
CATTATGCTTGTTGTG-1_V12N28-333_C1,2,0,2,2,0,6
CCAGGGACGTGGCCTC-1_V12N28-333_C1,0,3,1,1,0,5
TATGGATGTGCTACGC-1_V12N28-333_C1,0,2,3,2,0,7
GTACTAAGATTTGGAG-1_V12N28-333_C1,0,0,0,4,0,4
AGACCCGCCCTCCTCG-1_V12N28-333_C1,1,5,0,1,0,7
CGCATTAGCTAATAGG-1_V12N28-333_C1,0,1,0,3,0,4
GCTCTCGGGTACCGAA-1_V12N28-333_C1,1,2,1,1,0,5
CACCGCCAGAAGGTTT-1_V12N28-333_C1,1,1,3,0,0,5
TCCCAAAGACGAAGGA-1_V12N28-333_C1,0,0,1,5,0,6
ATGGATTGACCAAACG-1_V12N28-333_C1,0,1,2,1,0,4
GTCATGGACATGACTA-1_V12N28-333_C1,0,2,1,3,0,6
CTACTGCCACCTGACC-1_V12N28-333_C1,0,0,0,4,0,4
TTATATTTGGCAATCC-1_V12N28-333_C1,0,0,1,6,0,7
AGCACCAGTACTCACG-1_V12N28-333_C1,2,0,2,1,0,5
CATGGTCTAGATACCG-1_V12N28-333_C1,0,1,0,5,0,6
TCTACCGTCCACAAGC-1_V12N28-333_C1,1,2,1,1,0,5
CTAGTTGGGCCCGGTA-1_V12N28-333_C1,2,1,1,3,0,7
TCCCGCGTACTCCTGG-1_V12N28-333_C1,1,3,0,2,0,6
CAGAGCATGAGCTTGC-1_V12N28-333_C1,0,1,0,1,0,2
ACACGGGAACTTAGGG-1_V12N28-333_C1,0,1,1,1,0,3
GGCTCTGCTCCAACGC-1_V12N28-333_C1,0,0,1,3,0,4
AGAACGTGGTACATTC-1_V12N28-333_C1,0,1,0,3,0,4
CAATAAACCTTGGCCC-1_V12N28-333_C1,0,0,0,4,0,4
ACTTCGCCATACGCAC-1_V12N28-333_C1,0,1,1,2,0,4
ATCTGGTTAAGACTGT-1_V12N28-333_C1,1,1,1,3,0,6
TCGTAAGACGACATTG-1_V12N28-333_C1,0,3,0,1,0,4
GTGTACCTTGGCTACG-1_V12N28-333_C1,2,3,1,4,0,10
GCCCGTAATACCTTCT-1_V12N28-333_C1,1,1,0,2,0,4
CGGTCAAGTGGGAACC-1_V12N28-333_C1,1,1,1,2,0,5
TTGTAAGGCCAGTTGG-1_V12N28-333_C1,0,1,1,1,0,3
GGAGCACCAAGAACTA-1_V12N28-333_C1,0,2,2,2,0,6
TAATAGTGACGACCAG-1_V12N28-333_C1,0,0,0,0,1,1
CTAAATCCTATTCCGG-1_V12N28-333_C1,0,2,0,3,0,5
CGAGTTCTGTCCCACC-1_V12N28-333_C1,0,0,0,0,0,0
AGGCAGATGCGTAAAC-1_V12N28-333_C1,1,0,2,1,0,4
AAGGATGAGGGACCTC-1_V12N28-333_C1,0,0,1,1,0,2
AGAGAACCGTCTAGGA-1_V12N28-333_C1,0,2,0,0,0,2
GAGGGCGCAGCTCTGC-1_V12N28-333_C1,1,1,0,3,1,6
AAGATTGGCGGAACGT-1_V12N28-333_C1,1,3,1,1,0,6
CCAGTAGTCTGATCCA-1_V12N28-333_C1,1,0,0,2,0,3
AAGGGACAGATTCTGT-1_V12N28-333_C1,0,2,0,4,0,6
ATAGAGTTATCAACTT-1_V12N28-333_C1,1,2,0,3,0,6
AAATTACCTATCGATG-1_V12N28-333_C1,1,2,1,1,0,5
GATCCTAAATCGGGAC-1_V12N28-333_C1,1,3,0,0,0,4
TTACAGACCTAAATGA-1_V12N28-333_C1,0,1,1,4,0,6
CCTCACCTTAGCATCG-1_V12N28-333_C1,0,2,0,3,0,5
CATGCGACCAGTTTAA-1_V12N28-333_C1,0,0,0,1,0,1
AACATATCAACTGGTG-1_V12N28-333_C1,1,2,1,2,1,7
CTATAAGAGCCAATCG-1_V12N28-333_C1,1,2,0,3,0,6
AATATCGAGGGTTCTC-1_V12N28-333_C1,0,1,2,1,0,4
GTACTCCTGGGTATGC-1_V12N28-333_C1,0,0,1,1,0,2
ATAAGTAGGATTCAGA-1_V12N28-333_C1,0,2,1,1,0,4
AGGTCGCGGAGTTACT-1_V12N28-333_C1,0,0,0,1,0,1
CTAATTCTCAGATATT-1_V12N28-333_C1,1,2,0,1,0,4
GCCAACCATTTCCGGA-1_V12N28-333_C1,1,2,1,0,0,4
TGATCCCAGCATTAGT-1_V12N28-333_C1,0,1,0,0,1,2
CGTTGTAAGATTGATT-1_V12N28-333_C1,0,2,1,2,0,5
GAAACCATGGTGCGCT-1_V12N28-333_C1,0,2,0,2,1,5
AATCTATGCCGGAGCC-1_V12N28-333_C1,0,1,0,1,0,2
GACTCCCAGAATAAGG-1_V12N28-333_C1,0,0,0,2,0,2
TATGATCCGGCACGCC-1_V12N28-333_C1,0,2,0,1,1,4
CCGCTTGCTGACATGG-1_V12N28-333_C1,0,3,0,1,1,5
TGGTTAAGGGCGCTGG-1_V12N28-333_C1,0,2,0,1,1,4
TTGATAGTCAATACAT-1_V12N28-333_C1,0,1,0,1,0,2
GGTTTAATTGAGCAGG-1_V12N28-333_C1,0,1,0,0,1,2
CATTACATAGATTGTG-1_V12N28-333_C1,0,5,0,0,0,5
GGTACACCAGATTTAT-1_V12N28-333_C1,0,1,0,1,2,4
GGCCCGTATACCATGC-1_V12N28-333_C1,1,3,0,1,0,5
ATCTTTCGTATAACCA-1_V12N28-333_C1,0,1,0,0,0,1
GAGATGACAATCCTTA-1_V12N28-333_C1,0,3,0,1,0,4
AAAGCTTGCCTACATA-1_V12N28-333_C1,0,4,0,0,0,4
GAACGATAAGTTAAAG-1_V12N28-333_C1,0,4,0,0,0,4
TAATAGCTAAATGATG-1_V12N28-333_C1,0,2,0,0,0,2
TATGGCTAGGCTAATT-1_V12N28-333_C1,0,2,0,0,0,2
AGGAGAGTCTGGCTAC-1_V12N28-333_C1,0,1,0,0,0,1
TGCTCTGCCGGTTCAC-1_V12N28-333_C1,0,2,0,0,0,2
CCAATAGATTTCATCT-1_V12N28-333_C1,0,3,0,1,0,4
GGGCACGAATTGGCCG-1_V12N28-333_C1,0,3,0,2,0,5
TCGTTGACAGGGTCCC-1_V12N28-333_C1,0,3,0,3,0,6
ATCGTATTCCGAGAAC-1_V12N28-333_C1,2,0,0,3,0,5
GGGAATTCTGTCCAGT-1_V12N28-333_C1,3,2,1,2,0,8
ACGCGTTTCTTAAGAG-1_V12N28-333_C1,1,2,0,3,0,6
GAGAGCGCAGTCCCTG-1_V12N28-333_C1,0,5,1,4,0,10
GTCCTATTGTTGTGGT-1_V12N28-333_C1,2,2,1,1,0,6
CATCTGCAGGATCATT-1_V12N28-333_C1,2,3,0,2,0,7
GAGTCGACAGACCCTC-1_V12N28-333_C1,1,2,0,2,0,5
AAGTGCAAAGGTAGAC-1_V12N28-333_C1,0,7,0,2,0,9
AGGGTGGATAGTGCAT-1_V12N28-333_C1,3,1,1,4,0,9
TGATAGCGGGATTCTA-1_V12N28-333_C1,0,2,0,0,0,2
GTCAGTTTGGTAGTCG-1_V12N28-333_C1,2,2,0,2,0,6
GCATTCGAAATGAACA-1_V12N28-333_C1,0,2,0,1,0,3
AAAGACTGGGCGCTTT-1_V12N28-333_C1,0,2,0,1,0,3
TAACAATATTTGTTGC-1_V12N28-333_C1,1,1,0,5,0,7
CCAGCTTCCGCCCGCA-1_V12N28-333_C1,0,0,1,1,0,2
GATATGGATTACGCGG-1_V12N28-333_C1,2,3,1,3,0,9
AGAGCAGTTATGAGAC-1_V12N28-333_C1,1,4,1,3,0,9
TCACATCTTATCTGAT-1_V12N28-333_C1,1,1,0,1,0,3
TATGAAGACAGGTGCG-1_V12N28-333_C1,4,1,1,0,0,6
TACCTGCTGCACTGTG-1_V12N28-333_C1,0,3,2,1,0,6
TAGGTCCAAGTAAGGA-1_V12N28-333_C1,0,2,1,2,0,5
GAAACTCGTGCGATGC-1_V12N28-333_C1,0,1,0,0,0,1
AACAATTACTCTACGC-1_V12N28-333_C1,1,2,0,1,0,4
CCGCACGTGACCTCGG-1_V12N28-333_C1,0,5,0,1,0,6
AACTTGCCCGTATGCA-1_V12N28-333_C1,0,1,0,2,0,3
GGGTATGTATGCACTT-1_V12N28-333_C1,2,1,0,0,0,3
TTCGTACTCCAGAACG-1_V12N28-333_C1,2,1,0,4,0,7
GAATTTCTCGCTGCAG-1_V12N28-333_C1,0,0,0,3,0,3
AACAGGATGGGCCGCG-1_V12N28-333_C1,0,1,1,5,0,7
GACGTGTAGGGATTAT-1_V12N28-333_C1,0,2,0,1,0,3
TAGGTGAGCCCTACTC-1_V12N28-333_C1,0,2,0,2,0,4
CTAATTCGCACGCGCT-1_V12N28-333_C1,0,2,0,5,0,7
GAAGCTTGCTGACCGC-1_V12N28-333_C1,0,1,0,3,0,4
GGTTAGGCTTGGAGAA-1_V12N28-333_C1,0,1,0,4,0,5
ACAAGGACAAGAGGTT-1_V12N28-333_C1,0,2,0,1,0,3
AGGCCACCCGTTATGA-1_V12N28-333_C1,0,0,1,0,0,1
GTGGGCTTAGACACAC-1_V12N28-333_C1,0,3,0,1,0,4
CGTGTCCCATTCGCGA-1_V12N28-333_C1,0,2,0,5,0,7
TGGAGTGATGCGATGA-1_V12N28-333_C1,0,1,1,1,0,3
AACAACTGGTAGTTGC-1_V12N28-333_C1,2,0,0,3,0,5
CCTGGCTAGACCCGCC-1_V12N28-333_C1,0,1,0,1,0,2
CGCAATTAGGGTAATA-1_V12N28-333_C1,0,3,0,4,0,7
TCGAAATTTAGGACCA-1_V12N28-333_C1,0,1,4,2,0,7
AGACTAGCCTTCCAGA-1_V12N28-333_C1,0,0,0,2,0,2
TTGATCTAACTTTGTC-1_V12N28-333_C1,2,0,0,1,0,3
AAGGAGCGGTTGGTGC-1_V12N28-333_C1,0,1,0,3,0,4
ACTTGGGACCCGGTGG-1_V12N28-333_C1,0,1,0,3,0,4
TGATCTCCGGCGCCAG-1_V12N28-333_C1,0,1,3,1,0,5
CAGTTCAAATTGACAC-1_V12N28-333_C1,0,1,0,0,0,1
GTCCGGCTGAATTGCG-1_V12N28-333_C1,0,3,1,1,0,5
CTGGAAATGGATGCTT-1_V12N28-333_C1,0,1,0,1,0,2
TGATCGGTTTGACCCT-1_V12N28-333_C1,0,0,2,3,0,5
TAGAGTCTAAGCGAAC-1_V12N28-333_C1,0,1,0,1,0,2
GAGACTGATGGGTAGA-1_V12N28-333_C1,0,2,1,0,0,3
TAGCTAAGTCCGGGAG-1_V12N28-333_C1,0,0,2,3,0,5
GGGCGATATGTGTGAA-1_V12N28-333_C1,1,1,0,2,0,4
CTCGAGGTCGAACAGT-1_V12N28-333_C1,0,1,3,3,0,7
GATCCCTTTATACTGC-1_V12N28-333_C1,0,1,0,0,0,1
GTCATGCACCTCCGTT-1_V12N28-333_C1,0,0,2,3,1,6
ACTTTCCTATAGCTTC-1_V12N28-333_C1,0,0,0,4,0,4
TCGCTCGATATATTCC-1_V12N28-333_C1,0,0,1,2,0,3
ATAGGTTGGGCAGATG-1_V12N28-333_C1,1,0,2,4,0,7
CAATTAAGGGTGATGA-1_V12N28-333_C1,0,1,3,1,0,5
ACCGACTGAGTCCCAC-1_V12N28-333_C1,0,1,0,1,0,2
CCTGTCACCCGGGCTC-1_V12N28-333_C1,0,1,0,1,0,2
GATCGGTGGCCATAAC-1_V12N28-333_C1,0,0,2,5,0,7
CCTATGGGTTACCGTC-1_V12N28-333_C1,1,1,0,1,0,3
TTGGGACACTGCCCGC-1_V12N28-333_C1,2,1,0,2,0,5
CGAGGCTAAATATGGC-1_V12N28-333_C1,0,2,0,2,0,4
TCAGGGTGTAACGTAA-1_V12N28-333_C1,0,4,0,4,0,8
CGAGAGATGTGAACCT-1_V12N28-333_C1,0,0,0,2,0,2
TCGCTGGGCGGATTGT-1_V12N28-333_C1,0,1,1,0,0,2
AGATCTCAGGTGTGAT-1_V12N28-333_C1,1,1,0,1,0,3
TGGCCAAACTGAAGTA-1_V12N28-333_C1,0,0,1,0,0,1
GCTTCCGTCCCTAGAC-1_V12N28-333_C1,0,0,0,1,0,1
CAGCAGCCCGTTCCTT-1_V12N28-333_C1,0,1,1,2,0,4
TGTATAACAGATCCTG-1_V12N28-333_C1,0,1,0,4,1,6
CGCGGGAATTAGGCAG-1_V12N28-333_C1,0,2,0,4,0,6
TGCATGTGGTAATCTA-1_V12N28-333_C1,1,0,2,2,0,5
ACAATTTGAGCAGTGG-1_V12N28-333_C1,0,1,0,2,0,3
GAGCTAAGGGCATATC-1_V12N28-333_C1,0,1,1,0,1,3
CCAGATAGTTGAGTGA-1_V12N28-333_C1,1,3,0,5,0,9
CCACAATGTACGTCTT-1_V12N28-333_C1,0,1,0,6,0,7
CAATGGATCTCTACCA-1_V12N28-333_C1,0,0,0,1,0,1
TAAAGCGTTAGGAGAA-1_V12N28-333_C1,1,0,1,1,0,3
TCCGTTTAGCCTTGAA-1_V12N28-333_C1,0,0,0,1,0,1
CAGCTCGACAAGTTAA-1_V12N28-333_C1,1,0,2,4,0,7
GCCTATAGTGTCAGGG-1_V12N28-333_C1,1,1,1,1,0,4
ATAGACAACGGGACCT-1_V12N28-333_C1,0,1,1,2,0,4
CTACTATCTTTCAGAG-1_V12N28-333_C1,0,2,0,2,0,4
GCGCTGCTTTGCATTT-1_V12N28-333_C1,1,1,0,0,0,2
GCGCATCCAGTCAGCA-1_V12N28-333_C1,0,0,1,0,0,1
GACTCGCGGGAATGAC-1_V12N28-333_C1,0,3,2,1,0,6
CTGGTAACGAGCTCTT-1_V12N28-333_C1,0,2,0,0,1,3
TCCGGCCTAGCGTACA-1_V12N28-333_C1,0,0,0,3,0,3
TCTAGGTGGCGACGCT-1_V12N28-333_C1,0,0,1,0,0,1
ACGCTAGTGATACACT-1_V12N28-333_C1,0,2,0,1,0,3
ATCTGCACCTCTGCGA-1_V12N28-333_C1,1,0,1,0,0,2
CCTCACCTGAGGGAGC-1_V12N28-333_C1,0,0,0,2,0,2
AGTGAGCCTCGCCGCC-1_V12N28-333_C1,0,1,1,4,1,7
ACGAGTACGGATGCCC-1_V12N28-333_C1,1,1,2,1,0,5
GGTACCATTAAGACGG-1_V12N28-333_C1,0,1,0,1,0,2
TTCTGCTAGACTCCAA-1_V12N28-333_C1,0,0,1,1,0,2
TAACTATTACGCCAAA-1_V12N28-333_C1,0,2,0,1,0,3
GCATTCAAGGCAACGC-1_V12N28-333_C1,0,1,1,2,0,4
AGTACATCATTTATCA-1_V12N28-333_C1,0,3,1,2,0,6
GTCGTGTCTGGTCATC-1_V12N28-333_C1,0,1,1,2,0,4
AGTCTAAAGTATACTC-1_V12N28-333_C1,0,2,0,1,0,3
CGGCCCAACCTGTAGT-1_V12N28-333_C1,0,4,0,0,0,4
AGGGAGACATACTTCG-1_V12N28-333_C1,0,0,2,0,0,2
TCCCTAGATCAATAGG-1_V12N28-333_C1,0,3,0,0,0,3
TCCCGTCGCGTCATAG-1_V12N28-333_C1,0,1,0,0,1,2
CGCATCCATCAGCCAG-1_V12N28-333_C1,0,1,0,0,1,2
CTGCACCTAGTCCACA-1_V12N28-333_C1,0,1,0,0,1,2
CGAGGATCGGGAACGA-1_V12N28-333_C1,0,2,0,2,1,5
CAATGAGGTTCGACTA-1_V12N28-333_C1,2,0,0,0,1,3
TCTGACGGGCTAACCC-1_V12N28-333_C1,0,1,0,1,0,2
TTCTATGCCTTTCGCA-1_V12N28-333_C1,0,3,0,0,0,3
AGAGTATAGTGTTACG-1_V12N28-333_C1,0,2,0,0,0,2
CCATTGTTTCCTCCAT-1_V12N28-333_C1,0,2,0,0,0,2
CTCATCACTTAGTGAT-1_V12N28-333_C1,0,7,0,2,0,9
CCGAAGGGCGTACCGC-1_V12N28-333_C1,0,3,0,0,0,3
TCAAGCTGCCTTGAAA-1_V12N28-333_C1,0,4,0,0,0,4
CTCATTAACGTTGCCC-1_V12N28-333_C1,0,0,0,0,0,0
GTCTTCCTCACCTAAG-1_V12N28-333_C1,0,1,0,3,0,4
GGTGATGAAGGAAGTG-1_V12N28-333_C1,0,4,1,4,0,9
TCAATACAATTGCTGC-1_V12N28-333_C1,3,4,0,2,0,9
GCAACCCAAGTTGTTT-1_V12N28-333_C1,1,4,0,1,0,6
ATGAAGTGGACCCAGC-1_V12N28-333_C1,1,3,0,3,0,7
GAGAATCTCACGATCA-1_V12N28-333_C1,3,4,0,1,0,8
TATATCATTGATCAGT-1_V12N28-333_C1,1,2,0,4,0,7
AACTTTACGGGAGCTT-1_V12N28-333_C1,1,3,0,2,0,6
TTCTTGTGTCCATCAG-1_V12N28-333_C1,2,2,0,1,0,5
ACAATTTAGGAGGCTC-1_V12N28-333_C1,2,1,0,3,0,6
ATACTTGTTCTCGAGC-1_V12N28-333_C1,0,1,0,8,0,9
CACGGGATTGAGGGTT-1_V12N28-333_C1,0,5,0,0,0,5
GTTAATGTCTATCTTA-1_V12N28-333_C1,0,1,0,1,0,2
GCGTTATATTTGGAAC-1_V12N28-333_C1,1,1,1,0,0,3
CGTCAAGGCTATAAAT-1_V12N28-333_C1,0,2,0,1,0,3
TTAGCTCTGTAATCCG-1_V12N28-333_C1,1,2,2,1,0,6
AATGGTCCACCGTTCA-1_V12N28-333_C1,0,2,1,4,0,7
GTCATTGCATTGACCC-1_V12N28-333_C1,1,2,0,2,0,5
TGTCCGTGGCGCCTTT-1_V12N28-333_C1,0,2,0,2,0,4
TCAACTAACGTATAAC-1_V12N28-333_C1,0,0,1,1,0,2
TCCTCTCCAGTTGTCC-1_V12N28-333_C1,1,0,0,1,0,2
TGTGTTCGTATCCAAG-1_V12N28-333_C1,0,3,0,2,0,5
CCGCGTAGGTAAGGGC-1_V12N28-333_C1,1,5,0,1,0,7
CTGCGGGTGAAATGTT-1_V12N28-333_C1,0,2,0,1,0,3
TATCTACAGAGGTAAT-1_V12N28-333_C1,2,1,0,2,0,5
CTACTCTAGGCCCGGC-1_V12N28-333_C1,1,0,0,2,0,3
ACAAGCAGTGCCTAGC-1_V12N28-333_C1,1,5,0,1,0,7
TACAAGTCTCGTGCAT-1_V12N28-333_C1,0,4,0,2,0,6
TCGGAATGCGCTCTGA-1_V12N28-333_C1,1,2,0,1,0,4
TCGCGTCCAGAAGGTC-1_V12N28-333_C1,1,1,1,0,0,3
TATGGCCCGGCCTCGC-1_V12N28-333_C1,0,1,1,0,0,2
GCTGGCATATTCACCT-1_V12N28-333_C1,1,0,1,2,0,4
GTCAGAATAGTCTATG-1_V12N28-333_C1,0,2,1,1,0,4
GGCGTCCTATCCGCTG-1_V12N28-333_C1,0,0,2,4,0,6
CGGAGTTTGAGAGACA-1_V12N28-333_C1,1,1,1,2,0,5
AGCACTTAAGGACGCC-1_V12N28-333_C1,1,1,0,3,0,5
TCCACAATGGTTTACG-1_V12N28-333_C1,0,0,0,0,0,0
CCAACGATGCACTGAT-1_V12N28-333_C1,0,0,2,2,0,4
ATTTACAGTTTACTGG-1_V12N28-333_C1,0,0,2,1,0,3
CCCTGAAATGAGTTGA-1_V12N28-333_C1,0,3,0,4,0,7
CAAACGGTCGCACTTT-1_V12N28-333_C1,0,1,1,4,0,6
TGATTCGTCTATCACT-1_V12N28-333_C1,0,0,1,3,0,4
TCAGGTTCTTTGAGAA-1_V12N28-333_C1,0,0,1,1,0,2
CACGCAGCGAGGCTTT-1_V12N28-333_C1,0,0,1,2,0,3
TTAAGCGCCTGACCCA-1_V12N28-333_C1,0,0,2,3,0,5
CTTACACGGTATTCCA-1_V12N28-333_C1,0,2,0,2,0,4
AAGGCTGTGCTCATCG-1_V12N28-333_C1,0,1,0,1,0,2
GACCAGAGCCCTGTAG-1_V12N28-333_C1,0,0,1,0,0,1
TCCCAGGCTTAGCTAA-1_V12N28-333_C1,0,1,0,0,1,2
ATTGAAGATCTTAGTG-1_V12N28-333_C1,1,0,0,1,0,2
AGTTCCTACAGAATTA-1_V12N28-333_C1,1,1,0,1,0,3
GGGCTGGTTAGTCGCG-1_V12N28-333_C1,0,1,0,1,0,2
GAAATGGCGGTGTTAG-1_V12N28-333_C1,0,0,2,1,0,3
TACGAACACGACTTCA-1_V12N28-333_C1,0,0,0,1,0,1
ACCACAAGTTTCTATC-1_V12N28-333_C1,0,0,0,1,0,1
ATATTTAACCCTCAAG-1_V12N28-333_C1,0,0,0,2,0,2
GATCATTCCAAACATT-1_V12N28-333_C1,0,0,1,4,0,5
TCCAGGCGAGTACGGT-1_V12N28-333_C1,0,0,0,0,0,0
GTTTGACCAAATCCTA-1_V12N28-333_C1,0,0,0,2,0,2
CACAGCACCCACGGCA-1_V12N28-333_C1,0,1,1,1,0,3
TGCAAGAATGACGTAA-1_V12N28-333_C1,0,3,0,0,0,3
GCGAAGCCATACCCGT-1_V12N28-333_C1,1,0,2,1,0,4
TCCTTTCTTACGCTTA-1_V12N28-333_C1,0,0,1,1,1,3
GCTGCTCTCCGGACAC-1_V12N28-333_C1,0,1,1,0,1,3
ACTGTCTTCTTTAGAA-1_V12N28-333_C1,0,4,2,2,0,8
TCAAACTTAGATTGTT-1_V12N28-333_C1,1,1,1,0,0,3
CTATGTCACTAGCCCA-1_V12N28-333_C1,0,0,0,0,0,0
TGCGCAAAGCATTTGG-1_V12N28-333_C1,0,2,3,0,1,6
TTAATGTAGACCAGGT-1_V12N28-333_C1,1,1,1,0,0,3
GGCGGTAGGATCATTG-1_V12N28-333_C1,0,0,0,1,0,1
GGCAATAGTCAATGAG-1_V12N28-333_C1,0,0,0,2,0,2
ACACGAGACTCCTTCT-1_V12N28-333_C1,0,3,0,0,0,3
GACACAAGGGAAGAAA-1_V12N28-333_C1,0,0,1,1,0,2
TCAGCAAATGCATCTC-1_V12N28-333_C1,1,0,1,1,0,3
GAGATCTGTCACTCCG-1_V12N28-333_C1,0,0,0,5,2,7
ATGCCGGTCTTGCATA-1_V12N28-333_C1,0,0,0,2,0,2
TTGGGCGGCGGTTGCC-1_V12N28-333_C1,0,0,1,3,0,4
TTGTTGTGTGTCAAGA-1_V12N28-333_C1,0,0,2,1,0,3
ACTGTACGATACACAT-1_V12N28-333_C1,0,1,1,0,0,2
TCCACTTTATCTAGGT-1_V12N28-333_C1,0,1,1,1,0,3
GGTCTGAGAATCTGGA-1_V12N28-333_C1,0,2,0,4,0,6
TAGAAAGGTGGCGCTA-1_V12N28-333_C1,0,3,1,0,0,4
TATGTCTCATTGTGCC-1_V12N28-333_C1,0,0,0,0,0,0
GGATTTCACTTCTATA-1_V12N28-333_C1,1,2,3,0,1,7
TGAGTGGTCCGTGACG-1_V12N28-333_C1,1,2,0,3,0,6
CGCTTTCTTGCATTCG-1_V12N28-333_C1,0,0,1,1,0,2
ACCCAACGCCCGTGGC-1_V12N28-333_C1,0,1,1,2,0,4
GAACGTCTCATGGTCG-1_V12N28-333_C1,1,0,0,3,0,4
AGGGTTCCCTTTGGTT-1_V12N28-333_C1,0,1,0,0,0,1
GTAGCTTCCTCTTGTT-1_V12N28-333_C1,0,1,1,0,0,2
CTACCCTAAGGTCATA-1_V12N28-333_C1,0,2,0,1,0,3
TCACCGCTCGGCACTC-1_V12N28-333_C1,0,1,1,3,0,5
GGCTCGCGTTGAGGTA-1_V12N28-333_C1,0,1,0,3,1,5
CTAACGAAACTTGCTG-1_V12N28-333_C1,0,1,0,2,0,3
TTAAACTCGAATTCAT-1_V12N28-333_C1,0,0,0,4,0,4
TACTTTACTGAGCCGG-1_V12N28-333_C1,1,3,0,1,0,5
GCTTGGATCGATTAGG-1_V12N28-333_C1,2,0,1,0,0,3
CGGTTATCCAACAGTG-1_V12N28-333_C1,0,0,1,3,0,4
CAGACCTGTAAGTGTT-1_V12N28-333_C1,0,0,0,1,0,1
GACGGTCAATAGAAGC-1_V12N28-333_C1,0,0,0,3,0,3
CTGACTGCGCAGCTCG-1_V12N28-333_C1,0,1,0,1,1,3
CCATACCTTTACTTGT-1_V12N28-333_C1,0,2,1,1,0,4
GTAATAAAGGGCTCCC-1_V12N28-333_C1,0,3,0,0,0,3
GTGAACTCCCATTCGA-1_V12N28-333_C1,0,2,0,3,0,5
GTGGTTACTTCTTTCG-1_V12N28-333_C1,0,2,0,1,2,5
TCAGAACCTCCACAGG-1_V12N28-333_C1,0,1,0,2,1,4
TCCCACTCTCTTCCGG-1_V12N28-333_C1,0,2,0,1,0,3
ATCTTGACTTGTCCAA-1_V12N28-333_C1,0,0,0,1,0,1
TCGGGAACGTGCCTAG-1_V12N28-333_C1,0,1,0,0,0,1
GTTAGCCGTAAATCAA-1_V12N28-333_C1,0,1,0,0,1,2
ATTTACTAAGTCCATT-1_V12N28-333_C1,0,5,0,0,1,6
GGGTGCATATGAAAGC-1_V12N28-333_C1,0,1,1,1,0,3
TCCGAATGGTCCTGAG-1_V12N28-333_C1,0,1,0,0,1,2
TGATGGCTGTTTCTGA-1_V12N28-333_C1,0,2,0,2,0,4
AAATAAGGTAGTGCCC-1_V12N28-333_C1,0,1,0,0,0,1
CCACTATCCGGGTCAC-1_V12N28-333_C1,0,3,0,0,1,4
ACACCACATAATTAGC-1_V12N28-333_C1,0,1,0,0,0,1
CGCGGTAAGTCTAGCT-1_V12N28-333_C1,2,3,0,0,0,5
GCGGGCATTACGATGC-1_V12N28-333_C1,0,1,0,0,0,1
AGGATTGCTTACGACA-1_V12N28-333_C1,0,0,0,0,2,2
CTCGGGATAACACCTA-1_V12N28-333_C1,0,0,0,0,1,1
GTCGTCTGGTTGGCTA-1_V12N28-333_C1,0,2,0,1,0,3
GCAATTAGTCGCACCG-1_V12N28-333_C1,0,2,0,0,0,2
GTGACCTAAAGAATAA-1_V12N28-333_C1,0,0,0,0,1,1
CTGAGCGAGACTTATT-1_V12N28-333_C1,0,4,0,0,0,4
CAAGACTCAGAAGCGC-1_V12N28-333_C1,0,0,0,2,0,2
ACTTCGCTAGCGAGTG-1_V12N28-333_C1,0,0,0,1,0,1
CCATACTCGCCTCTCC-1_V12N28-333_C1,2,2,0,2,0,6
ACGATACCTATCCTGA-1_V12N28-333_C1,0,2,0,4,0,6
CTCACCAGTACAAGTG-1_V12N28-333_C1,2,0,0,2,0,4
CGAAGACGGTGAGTGC-1_V12N28-333_C1,0,2,0,1,0,3
AAATTAATAAGCGCGA-1_V12N28-333_C1,1,3,0,2,0,6
GGGCCCTTATCTATAC-1_V12N28-333_C1,0,2,0,1,0,3
CTGCCCACGAAGCGTT-1_V12N28-333_C1,2,2,2,2,0,8
GGACAAGTTGCAGTGA-1_V12N28-333_C1,0,0,1,0,0,1
GTCCGAGAGCAATCAT-1_V12N28-333_C1,2,1,0,2,0,5
ATGGCAGCCGAGAAAC-1_V12N28-333_C1,0,3,0,3,0,6
CCTCGGATGCTACCTG-1_V12N28-333_C1,0,2,0,3,0,5
ATACGGTGAAGATGCA-1_V12N28-333_C1,0,1,3,4,0,8
ACATCAGCTGGGACGC-1_V12N28-333_C1,0,1,1,3,0,5
GGTTGTGTAGCCTGGC-1_V12N28-333_C1,0,1,0,4,0,5
CCTGCGTTCTACGCTT-1_V12N28-333_C1,1,2,1,1,0,5
GAACGTTAGGAAGACG-1_V12N28-333_C1,0,0,0,0,0,0
CTGATAGTGTATCTCA-1_V12N28-333_C1,0,2,0,0,0,2
TTCTGCGAGCGCCCTT-1_V12N28-333_C1,1,0,0,3,0,4
CTTTGGCGCTTTATAC-1_V12N28-333_C1,0,0,2,3,0,5
TCCGAACTTGGCTTAC-1_V12N28-333_C1,0,1,2,0,0,3
TAGATTCCTGGTTATT-1_V12N28-333_C1,1,1,1,1,0,4
CCGACAAAGGGAGTGC-1_V12N28-333_C1,0,2,2,4,0,8
CCATGGCCCTTGTACC-1_V12N28-333_C1,1,0,2,2,0,5
GAAATATCACCATCAG-1_V12N28-333_C1,1,2,1,2,0,6
ACGAAATGGGCGGCAC-1_V12N28-333_C1,1,1,1,2,0,5
GTGAGCGTGCTGCACT-1_V12N28-333_C1,0,0,4,2,0,6
CCGCGGGTACGAAGAA-1_V12N28-333_C1,0,3,0,1,0,4
TCCCTGGCTCGCTGGA-1_V12N28-333_C1,1,2,2,0,0,5
CAGCTTAGTAGGTAGC-1_V12N28-333_C1,1,2,0,5,0,8
CACGAAAGTTAGTCCC-1_V12N28-333_C1,1,0,3,2,0,6
ACCTAATCGACTTCCT-1_V12N28-333_C1,1,1,0,1,0,3
AAGTAGTGACGCGAGG-1_V12N28-333_C1,0,2,1,0,0,3
TCCGATTACATTGCCG-1_V12N28-333_C1,0,2,0,3,0,5
CCTCCGACAATTCAAG-1_V12N28-333_C1,0,0,1,3,0,4
GTTCACAGGAGTCTAG-1_V12N28-333_C1,0,0,0,2,0,2
CGAAGTTGCTCTGTGT-1_V12N28-333_C1,0,0,1,0,0,1
GTCGGATATCTCAGAC-1_V12N28-333_C1,0,0,0,1,0,1
CGCTCTCCGTAGATTA-1_V12N28-333_C1,0,2,4,0,0,6
CAAGCAACGTCGGAGT-1_V12N28-333_C1,0,1,3,2,0,6
CCATTCCCTGCCCACA-1_V12N28-333_C1,0,0,1,0,0,1
CTTTGGCTTTAGTAAA-1_V12N28-333_C1,1,0,3,5,0,9
GGCTATTAAGTTGTAT-1_V12N28-333_C1,0,1,0,4,0,5
CCATTAGCGATAATCC-1_V12N28-333_C1,0,1,0,1,0,2
TGTTCTTCCATTGACT-1_V12N28-333_C1,0,0,0,1,1,2
AGATAACTTCAGGGCC-1_V12N28-333_C1,0,3,1,1,1,6
ATAGACGAAGAGAAAG-1_V12N28-333_C1,0,1,0,0,1,2
GGCGGAGTAATATTAG-1_V12N28-333_C1,0,1,1,0,0,2
TGACCCACGTTAGACA-1_V12N28-333_C1,0,2,0,0,1,3
TCACAGGTTATTGGGC-1_V12N28-333_C1,0,1,0,1,0,2
TCACGCATTGTAGATC-1_V12N28-333_C1,1,1,0,1,1,4
TTGAAGAATTCCCAGG-1_V12N28-333_C1,0,0,0,0,0,0
AAATGGTCAATGTGCC-1_V12N28-333_C1,0,3,0,0,0,3
TAGTGCCCTCCAGAGT-1_V12N28-333_C1,1,1,0,2,1,5
GGTATTGCCGAGTTTA-1_V12N28-333_C1,0,0,1,0,1,2
CGTATTAAGAGATCTA-1_V12N28-333_C1,0,2,1,1,0,4
ACTGTCCAGGATTATA-1_V12N28-333_C1,0,3,2,0,1,6
CGGGCAGCTAAACCGC-1_V12N28-333_C1,2,1,0,1,2,6
TTGCTGATCATGTTCG-1_V12N28-333_C1,0,1,0,0,0,1
TATGGGTACGTATCGT-1_V12N28-333_C1,0,1,1,0,0,2
CAGCTCACTGAGACAT-1_V12N28-333_C1,0,1,0,0,0,1
GGGACTGCATAGATAG-1_V12N28-333_C1,0,2,0,2,1,5
ACGCATTCGTGAGTAC-1_V12N28-333_C1,0,3,0,0,2,5
CTCTGGACGCCTGGTG-1_V12N28-333_C1,0,2,0,0,2,4
AGGGTTTAGTTCGGGA-1_V12N28-333_C1,0,3,1,3,1,8
GGGAGAACTCACAGTA-1_V12N28-333_C1,0,1,0,4,0,5
ATCAATCTGGGCTGCA-1_V12N28-333_C1,0,1,0,0,1,2
TCTTCGATACCAATAA-1_V12N28-333_C1,0,1,1,1,0,3
ACGTAGATTGCTGATG-1_V12N28-333_C1,0,0,0,0,1,1
TCTTGATGCGTAGCGA-1_V12N28-333_C1,0,3,0,0,1,4
GGGCTGCCTAGGGCGA-1_V12N28-333_C1,0,2,2,1,0,5
CTCTCACAATCGATGA-1_V12N28-333_C1,0,2,0,1,1,4
CCAAGCGTAACTCGTA-1_V12N28-333_C1,0,2,1,0,2,5
ACAACAGCATGAGCTA-1_V12N28-333_C1,0,1,0,2,0,3
GTCCCAACGTAAAGTA-1_V12N28-333_C1,1,1,1,0,1,4
TCGGAGTACATGAGTA-1_V12N28-333_C1,0,3,0,1,0,4
GGGAGTTAATGAGGCG-1_V12N28-333_C1,0,1,1,0,0,2
CCGGGCGGTCTCGTCA-1_V12N28-333_C1,1,0,1,1,0,3
CCGTAAGTTGGTCCCA-1_V12N28-333_C1,0,3,0,0,1,4
GGAGGGCTTGGTTGGC-1_V12N28-333_C1,0,2,1,0,0,3
TCGGACGCCCAGCCCA-1_V12N28-333_C1,0,1,0,2,1,4
TCTGTGCCATCATAGT-1_V12N28-333_C1,0,1,1,1,1,4
GTACTGGAGTTAGACC-1_V12N28-333_C1,0,1,1,1,0,3
GGAATGCGCTAGCGTG-1_V12N28-333_C1,0,1,3,0,0,4
GTGTGAATAACTTAGG-1_V12N28-333_C1,0,1,2,0,1,4
GGTCGGCCAGGAGCTT-1_V12N28-333_C1,0,0,0,1,1,2
TAGCCGGCGGTCAGCG-1_V12N28-333_C1,0,0,0,1,3,4
CGGGTGTACCCATTTA-1_V12N28-333_C1,0,0,0,2,0,2
AGTGATTCAAGCAGGA-1_V12N28-333_C1,0,1,0,2,0,3
GTTGGATTGAGAACAC-1_V12N28-333_C1,0,2,1,1,0,4
CACACGCGCTGTCTTA-1_V12N28-333_C1,0,1,0,2,0,3
TAGACGCCCGTACCGG-1_V12N28-333_C1,0,0,0,1,0,1
GGTTTCAATCGGTCAG-1_V12N28-333_C1,0,0,0,0,0,0
AATCTGCGTTGGGACG-1_V12N28-333_C1,0,3,0,4,0,7
TTACGGATGGTTCGAG-1_V12N28-333_C1,0,1,0,2,0,3
CGGCAGGGTCGGGTTG-1_V12N28-333_C1,0,1,0,2,0,3
GCTTTCAGAGGAGGTG-1_V12N28-333_C1,1,2,1,1,0,5
TCTTCCCATGGGCACA-1_V12N28-333_C1,0,2,0,1,0,3
TACCGCGGACTTGCAG-1_V12N28-333_C1,1,1,1,0,0,3
AGAATTATGGATTCGA-1_V12N28-333_C1,0,2,1,0,0,3
ATTGATGAGTCCTAAC-1_V12N28-333_C1,0,0,0,3,0,3
TAGGTCGCCGGAACTG-1_V12N28-333_C1,0,2,1,5,0,8
TAACCTACCGTCCGAG-1_V12N28-333_C1,0,0,0,0,0,0
CTTAGTAGGCCTACAG-1_V12N28-333_C1,0,3,0,1,1,5
CTAGATGTGAGTGTAA-1_V12N28-333_C1,0,2,0,1,0,3
ACTCCCGAATTCGTTT-1_V12N28-333_C1,1,1,0,2,1,5
GTTCATCGTTTGGCTG-1_V12N28-333_C1,0,0,1,0,0,1
ACTTTACCCTCATGAA-1_V12N28-333_C1,0,6,0,0,0,6
GCGAGAGTTGCGTCCA-1_V12N28-333_C1,0,2,0,1,0,3
GTTCGGGCGTACCATT-1_V12N28-333_C1,0,0,2,1,0,3
CGACTTTGTATAGCCT-1_V12N28-333_C1,1,0,0,1,0,2
GCCATCGATGCTGCAT-1_V12N28-333_C1,0,2,0,0,1,3
GCATTTCCAAGGCTCC-1_V12N28-333_C1,0,1,0,1,0,2
ATGTAAGGCTGCTCTT-1_V12N28-333_C1,0,2,0,1,1,4
ACGTTCGCAATCAATT-1_V12N28-333_C1,0,1,0,0,0,1
GTGACGAGGGTGACCC-1_V12N28-333_C1,0,2,0,0,1,3
ATTATAGCTACTTTAC-1_V12N28-333_C1,0,1,0,1,0,2
CGTGTGTTAAACCCTG-1_V12N28-333_C1,1,0,0,0,3,4
TTGGTATGGCTTGTGT-1_V12N28-333_C1,0,1,0,0,0,1
CATTCCCATTCCGTCG-1_V12N28-333_C1,0,1,0,1,0,2
TGCCGAAAGCGTATTC-1_V12N28-333_C1,0,2,0,1,0,3
CAACACATCTCCTGCC-1_V12N28-333_C1,0,1,0,2,0,3
CTGCCTCATATGCAAC-1_V12N28-333_C1,0,3,0,1,1,5
TCCCGCCTATGTGCGT-1_V12N28-333_C1,0,3,0,0,0,3
GGTTACCCGACACTTT-1_V12N28-333_C1,0,1,0,3,1,5
CCAGCGGGATCACCAG-1_V12N28-333_C1,0,1,0,0,0,1
ATGTTTCGGCCCGGAG-1_V12N28-333_C1,0,0,0,0,1,1
GCGTCTAACCTCCTAA-1_V12N28-333_C1,0,2,0,1,0,3
ATCAGGTAGCTGACAG-1_V12N28-333_C1,0,0,0,0,1,1
GGTATGAAAGAACTGA-1_V12N28-333_C1,2,3,0,2,0,7
GTGGCCTAATATCATT-1_V12N28-333_C1,1,3,0,3,0,7
CCTGTGAAACCGTAAC-1_V12N28-333_C1,1,1,0,3,0,5
GGCAGAGAGATCGGGA-1_V12N28-333_C1,1,2,0,1,0,4
TAGCGTCGAATATTGA-1_V12N28-333_C1,0,4,1,2,0,7
CGCCGACTATTCGCTA-1_V12N28-333_C1,1,0,1,1,0,3
TCTGGCGCAAGCCGGG-1_V12N28-333_C1,0,1,1,2,0,4
AGTGGTTGCGTATAGG-1_V12N28-333_C1,0,2,0,2,0,4
ATCGGTTACCTAGTAA-1_V12N28-333_C1,2,1,3,1,0,7
CCTGCCCGTTGTCTAG-1_V12N28-333_C1,0,2,3,6,0,11
GCACACGCCCATGGTC-1_V12N28-333_C1,0,3,0,2,0,5
AGTACGGCCCGTATCG-1_V12N28-333_C1,1,2,0,4,0,7
TATCTAGCCTAAAGGA-1_V12N28-333_C1,0,1,2,1,0,4
CACTCGGTTAGGAGGA-1_V12N28-333_C1,1,0,1,3,0,5
ATGTTCGTCGACCCAC-1_V12N28-333_C1,0,3,0,2,0,5
TTCCTCTGCCCGAATA-1_V12N28-333_C1,0,1,0,1,0,2
TTACTATCGGCTTCTC-1_V12N28-333_C1,2,3,1,3,0,9
GCCGCATTAGTCCGGC-1_V12N28-333_C1,2,0,1,3,0,6
TAAGGGCTGGGAGAGG-1_V12N28-333_C1,1,0,0,5,0,6
TAAGCAGGCGACACGC-1_V12N28-333_C1,1,1,3,2,0,7
AGCACTACCGGCCTGT-1_V12N28-333_C1,1,0,2,1,0,4
GAAAGCCCTTTGGACC-1_V12N28-333_C1,1,1,1,1,0,4
GACCGACTGAAGCGTC-1_V12N28-333_C1,0,0,2,1,0,3
CGGTGAAGACTAAAGT-1_V12N28-333_C1,1,2,2,0,0,5
CCCTGCGCTACGCATA-1_V12N28-333_C1,1,3,1,0,0,5
TACTGGACAGCTCGGC-1_V12N28-333_C1,0,0,1,1,0,2
TTAGTAGGGCGGCGGG-1_V12N28-333_C1,0,0,1,4,0,5
GAGGCTATCAAAGTCG-1_V12N28-333_C1,0,0,2,0,0,2
TTACCATTGATTACCC-1_V12N28-333_C1,0,2,1,4,0,7
ATACCACGGGCAACTT-1_V12N28-333_C1,0,3,0,2,0,5
TGTCCTAAGTCACCGC-1_V12N28-333_C1,1,0,0,2,0,3
AGGTAGGTACAAAGCT-1_V12N28-333_C1,1,1,1,1,0,4
GGCATACAGGTAGCGG-1_V12N28-333_C1,0,1,1,1,0,3
TGTAGTGATCTATAAT-1_V12N28-333_C1,0,1,0,0,0,1
TCCCGGGTGTGCTGCT-1_V12N28-333_C1,0,0,0,6,0,6
TACGATGTTGATCATC-1_V12N28-333_C1,0,0,0,1,0,1
CCTCTCTCCCATCTAG-1_V12N28-333_C1,0,1,1,2,0,4
GCAGGACTATAGAATA-1_V12N28-333_C1,0,0,0,0,1,1
CTAGTGAAGGACAGGA-1_V12N28-333_C1,0,2,0,2,0,4
TACGAGAACTTCACGT-1_V12N28-333_C1,0,1,0,1,1,3
CGTTGTTTCAATTCCC-1_V12N28-333_C1,1,1,1,2,0,5
GCAAATATTACGCTTT-1_V12N28-333_C1,0,4,0,0,0,4
CCAATAGTGCCGTCGA-1_V12N28-333_C1,0,1,0,3,1,5
ATTGCTGCTCCTCCAT-1_V12N28-333_C1,0,2,0,2,0,4
GAGATCTGCTTGGCAT-1_V12N28-333_C1,0,2,0,0,0,2
GCCGAAATTCCTACGT-1_V12N28-333_C1,0,2,0,0,1,3
GGCACTCCACTGGGCA-1_V12N28-333_C1,1,1,0,0,0,2
GGGTCACCGTGACGGT-1_V12N28-333_C1,0,2,0,1,0,3
CACTTAATCAGACGGA-1_V12N28-333_C1,0,4,0,1,2,7
CGTTTCGCTCATTACA-1_V12N28-333_C1,0,0,0,1,1,2
ATAAAGGCTCGGTCGT-1_V12N28-333_C1,0,1,0,0,0,1
CACTAAAGTTGCCTAT-1_V12N28-333_C1,0,4,0,0,0,4
GTGCTCAAGTACTGTC-1_V12N28-333_C1,0,1,0,0,0,1
CCATGCCTGTTTAGTA-1_V12N28-333_C1,0,1,0,0,0,1
TCTAGTTATCAGAAGA-1_V12N28-333_C1,0,2,0,1,0,3
TTGTAATCCGTACTCG-1_V12N28-333_C1,0,0,0,0,1,1
TCCCAGCTTTAGTCTG-1_V12N28-333_C1,0,1,0,0,0,1
CTACGCACGGAGTACC-1_V12N28-333_C1,0,1,0,2,2,5
AAATTAACGGGTAGCT-1_V12N28-333_C1,0,1,0,2,1,4
CGGCCACGCACAAAGT-1_V12N28-333_C1,0,1,0,0,0,1
GAAGCGTGAGGAATTT-1_V12N28-333_C1,1,2,0,1,0,4
ATATCTTAGGGCCTTC-1_V12N28-333_C1,0,2,0,5,0,7
ACGCGGGCCAAGGACA-1_V12N28-333_C1,0,3,0,1,0,4
GCGAGTTCTGCAAAGA-1_V12N28-333_C1,0,3,0,1,1,5
TATTCGTGCCAGAATA-1_V12N28-333_C1,0,0,0,2,0,2
AGGGCTGCAGTTACAG-1_V12N28-333_C1,0,1,0,1,0,2
CTAGCATAGTATAATG-1_V12N28-333_C1,1,1,2,0,1,5
TAGGTTCGAGTTCGTC-1_V12N28-333_C1,0,1,0,0,1,2
GAATTATAGTGAAAGG-1_V12N28-333_C1,0,3,0,0,0,3
CTATCGGGTCTCAACA-1_V12N28-333_C1,0,0,0,0,0,0
GCGCTAATTGAATAGA-1_V12N28-333_C1,1,1,0,2,1,5
ATGCGACAGTCCCATT-1_V12N28-333_C1,0,2,0,1,0,3
GGTAGTGCTCGCACCA-1_V12N28-333_C1,0,2,0,0,0,2
AAGCTCGTGCCAAGTC-1_V12N28-333_C1,0,4,0,0,1,5
TATTCAATTCTAATCC-1_V12N28-333_C1,0,0,1,2,1,4
TTCAAAGTCTCTAGCC-1_V12N28-333_C1,0,1,0,1,0,2
TTGAATATGGACTTTC-1_V12N28-333_C1,0,1,1,0,0,2
AAGAGCTCTTTATCGG-1_V12N28-333_C1,0,3,0,2,0,5
TTACTCCGGCCGGGAA-1_V12N28-333_C1,0,1,0,0,0,1
AAACGAGACGGTTGAT-1_V12N28-333_C1,0,2,0,0,0,2
GCTAAGTAGTTTCTCT-1_V12N28-333_C1,1,2,0,0,1,4
ATAACGCCGGAGGGTC-1_V12N28-333_C1,1,2,1,0,1,5
GGATCCGGAATATACT-1_V12N28-333_C1,0,0,0,0,0,0
TGAAAGGACCTGACTC-1_V12N28-333_C1,0,1,0,0,0,1
TCCGCGGCAGCATCTG-1_V12N28-333_C1,0,0,0,0,0,0
TGCATATGTCTGTCAC-1_V12N28-333_C1,0,2,0,0,1,3
TGTAGGAGAAATTTCC-1_V12N28-333_C1,0,2,0,1,1,4
AGTGAGACTTCCAGTA-1_V12N28-333_C1,0,0,1,1,0,2
CCCAAACATGCTGCTC-1_V12N28-333_C1,1,1,0,1,0,3
GCTTATGAAGCAGGAA-1_V12N28-333_C1,0,1,0,0,0,1
TTCTAACCGAAGCTTA-1_V12N28-333_C1,0,0,0,1,0,1
GGATGTCCTTACCGCA-1_V12N28-333_C1,0,2,1,1,0,4
AGGGTGCTCTCGAGGG-1_V12N28-333_C1,0,0,0,0,0,0
AACTCTCAATAGAGCG-1_V12N28-333_C1,0,0,0,0,0,0
TCTGAATTCCGTACAA-1_V12N28-333_C1,0,1,1,1,0,3
GCGTGGTACTGGGTTA-1_V12N28-333_C1,0,2,0,0,0,2
CGTCGGATAGTGTTGA-1_V12N28-333_C1,0,0,0,0,0,0
ATATGTCTCCCTAGCC-1_V12N28-333_C1,0,2,0,0,0,2
TCTTTAAGACTATGAA-1_V12N28-333_C1,0,2,1,3,0,6
TCATTTAAGTCTCCGA-1_V12N28-333_C1,0,2,0,0,1,3
GATATTGAGATTGGCG-1_V12N28-333_C1,0,3,1,0,1,5
TGACATCGAGCGGACC-1_V12N28-333_C1,0,2,0,0,1,3
GCGTAAATGGCCATAA-1_V12N28-333_C1,0,2,1,0,0,3
ATTGTACAACTCGGCT-1_V12N28-333_C1,0,2,1,1,0,4
TACGCTATAGAAACCT-1_V12N28-333_C1,0,3,0,2,1,6
CACCCAAATCTTATGT-1_V12N28-333_C1,0,3,0,1,0,4
AGATGATGGAGTCTGG-1_V12N28-333_C1,0,0,0,0,0,0
CCACGGTGCCCGGTAG-1_V12N28-333_C1,0,0,0,1,0,1
TCAAGAAATACTAGCT-1_V12N28-333_C1,0,1,0,0,0,1
CAAGGTCCTATAGGCT-1_V12N28-333_C1,0,5,0,0,0,5
CCGGCACGACCGTTTC-1_V12N28-333_C1,0,2,0,0,0,2
ACCTCCGTTATTCACC-1_V12N28-333_C1,0,4,0,1,0,5
GCAGCCTATATCACAT-1_V12N28-333_C1,0,2,0,1,0,3
GGTATAGTGACACATA-1_V12N28-333_C1,0,0,0,0,1,1
AAATTCCAGGTCCAAA-1_V12N28-333_C1,0,2,0,0,1,3
TCTTTAGCAGGCGAAC-1_V12N28-333_C1,0,1,0,2,2,5
TATTGACATTTCTGCC-1_V12N28-333_C1,0,2,0,0,0,2
TCTGATCGGGTGCTAG-1_V12N28-333_C1,0,1,0,0,0,1
GGCCCGGAGCATGTCT-1_V12N28-333_C1,0,3,0,1,1,5
GGGCGCAGCGTTACTC-1_V12N28-333_C1,0,0,0,0,0,0
TTGGCGATCCGAATAT-1_V12N28-333_C1,0,2,0,0,0,2
CCACGTAAATTAGACT-1_V12N28-333_C1,0,2,0,0,0,2
TCTGATTGGAAATGGA-1_V12N28-333_C1,0,0,0,0,0,0
ATGGCGGAATAGTCGC-1_V12N28-333_C1,0,0,0,1,0,1
ATCGCTTTACGTCTCA-1_V12N28-333_C1,0,2,0,0,0,2
TACGTGCAAGGTTCCT-1_V12N28-333_C1,0,1,0,2,0,3
CAGGACAGCTGCCCTT-1_V12N28-333_C1,0,3,0,0,0,3
CAAACCAGGTCTGCAT-1_V12N28-333_C1,2,0,1,3,0,6
ACAAGCTATATGGAAG-1_V12N28-333_C1,0,1,0,3,0,4
TCGCCCACTGCGAGAG-1_V12N28-333_C1,2,2,0,0,0,4
AGCCGCAAATTCAAAT-1_V12N28-333_C1,0,0,0,0,0,0
TTAACGTTAAAGCCTG-1_V12N28-333_C1,2,3,0,2,0,7
CAGCGCCAACACGATA-1_V12N28-333_C1,0,1,0,5,0,6
ATCCAATGGTACCGAA-1_V12N28-333_C1,0,1,0,7,0,8
GTGCTGCAGATAAGGA-1_V12N28-333_C1,0,2,0,1,0,3
GGCCTTTGCAACTGGC-1_V12N28-333_C1,1,4,1,3,0,9
GTCGTACCTACGATTG-1_V12N28-333_C1,0,4,1,3,0,8
TAGAAATTCACGTATA-1_V12N28-333_C1,2,0,0,2,0,4
AGAATAAATCTTCAGG-1_V12N28-333_C1,0,3,1,4,0,8
CATTGCGAAATGGGCG-1_V12N28-333_C1,0,0,1,4,0,5
GTCTACTCAATTACAA-1_V12N28-333_C1,0,3,1,2,0,6
TGTAATGACCACAATA-1_V12N28-333_C1,0,1,2,2,0,5
AAAGTCGACCCTCAGT-1_V12N28-333_C1,1,0,2,1,0,4
TACTCGGCACGCCGGG-1_V12N28-333_C1,1,3,1,2,0,7
AGGTGTATCGCCATGA-1_V12N28-333_C1,0,0,2,1,0,3
TGTGCTTTACGTAAGA-1_V12N28-333_C1,0,2,1,2,0,5
AAACCTCATGAAGTTG-1_V12N28-333_C1,2,0,0,3,0,5
TATAGGGTACTCATGA-1_V12N28-333_C1,0,0,4,2,0,6
CCAGCTGATGGTACTT-1_V12N28-333_C1,0,1,2,1,0,4
AATATTGGAGTATTGA-1_V12N28-333_C1,0,0,3,4,0,7
GGCCCTCACCCACTTA-1_V12N28-333_C1,0,0,1,3,0,4
AACCAAGACTTCTCTG-1_V12N28-333_C1,0,0,3,1,0,4
TCGTATTACCCATTGC-1_V12N28-333_C1,0,0,2,3,0,5
ATTCGACGCCGGGCCT-1_V12N28-333_C1,1,0,3,0,0,4
GGCGCAGGACATCTTC-1_V12N28-333_C1,0,0,1,2,0,3
GTACTCCCTTATCGCT-1_V12N28-333_C1,0,0,2,1,0,3
TGGTCTGTTGGGCGTA-1_V12N28-333_C1,0,1,0,2,2,5
AATAACAACGCTCGGC-1_V12N28-333_C1,0,1,1,2,1,5
CATACCCGTACCCAGT-1_V12N28-333_C1,0,1,0,3,1,5
ACAATCCATTTAAACC-1_V12N28-333_C1,0,1,1,0,0,2
GTTACAATTGGTGACG-1_V12N28-333_C1,0,2,0,0,0,2
TTGCCCTGATCACGGG-1_V12N28-333_C1,0,0,0,0,0,0
CTAACCGCGCGCCCGT-1_V12N28-333_C1,0,2,0,1,0,3
CTAAAGAATGCCTACT-1_V12N28-333_C1,0,3,0,0,1,4
ACCCATCTTGAGGGTA-1_V12N28-333_C1,0,3,0,0,0,3
GATCTTTGCAGGGTAT-1_V12N28-333_C1,0,4,0,1,0,5
GGGTACTTCATGAACT-1_V12N28-333_C1,0,2,0,0,0,2
GCCGCTTGTGAGAAAC-1_V12N28-333_C1,0,0,0,1,1,2
CCTGTAAGACATGATA-1_V12N28-333_C1,0,2,0,0,0,2
CGACAGTTCGCGTTAT-1_V12N28-333_C1,0,6,0,0,0,6
ACGATGCATATGTTAT-1_V12N28-333_C1,0,0,0,0,0,0
TGTTCCGCTTCCATGA-1_V12N28-333_C1,0,1,0,1,0,2
GGATGACGCGAGTTTA-1_V12N28-333_C1,0,3,0,0,0,3
GAAGTTTCCACTCAAT-1_V12N28-333_C1,0,2,0,1,0,3
GCGAGGCCCGAGCAGA-1_V12N28-333_C1,0,3,0,0,0,3
CATACTATGTAATTGT-1_V12N28-333_C1,0,6,0,1,0,7
CCAATGTCACAGCAAG-1_V12N28-333_C1,2,3,0,2,0,7
GTTGGATTTGCGTTGG-1_V12N28-333_C1,0,0,0,1,2,3
GGGAGGATGCCCGAAA-1_V12N28-333_C1,0,1,0,1,0,2
GATCGCGGGCTCTCCA-1_V12N28-333_C1,1,1,0,0,0,2
GTTCGCCATAAGTGCC-1_V12N28-333_C1,1,2,0,0,1,4
AGATTATAGGACGTTT-1_V12N28-333_C1,0,4,0,1,0,5
TCGAGACCAACACCGT-1_V12N28-333_C1,1,1,0,0,0,2
TATGGGACCGAGCAGG-1_V12N28-333_C1,0,0,0,0,1,1
GATGCGTCCTGCATTC-1_V12N28-333_C1,0,0,0,0,1,1
TATGGTCTGAGTAACA-1_V12N28-333_C1,0,2,0,0,0,2
GCATAGAGCACTCAGG-1_V12N28-333_C1,0,3,0,2,0,5
CTTCATTGTCAGTGGA-1_V12N28-333_C1,0,4,0,1,0,5
GCAGATTAGGGATATC-1_V12N28-333_C1,0,1,1,0,0,2
CCTGTCGCCCGTAAAT-1_V12N28-333_C1,0,4,0,2,0,6
CAATTTCGTATAAGGG-1_V12N28-333_C1,1,2,0,1,0,4
GTACACTTACCTGAAG-1_V12N28-333_C1,0,4,0,0,1,5
CCAGCCTGGACCAATA-1_V12N28-333_C1,0,1,0,1,0,2
ATGGAGCAGGCCGTGA-1_V12N28-333_C1,1,2,0,0,0,3
GTCATTAGAGCGAACG-1_V12N28-333_C1,0,3,0,0,0,3
AAGACTGCAAGCTACT-1_V12N28-333_C1,0,1,0,0,1,2
CTAGTCACGTCTTAAG-1_V12N28-333_C1,0,7,1,0,0,8
ACTCTTGTATAGTAAC-1_V12N28-333_C1,0,0,1,0,0,1
ATTAGGCGATGCTTTC-1_V12N28-333_C1,0,2,0,0,0,2
TTCGGGACTAATCGCG-1_V12N28-333_C1,0,1,0,2,0,3
TGGACTGTTCGCTCAA-1_V12N28-333_C1,0,3,0,2,1,6
AACGTGCGAAAGTCTC-1_V12N28-333_C1,0,3,0,2,0,5
CCACCCAAGGAAAGTG-1_V12N28-333_C1,0,2,0,1,0,3
CCGCACAAAGACCAAC-1_V12N28-333_C1,0,0,1,0,1,2
GCGATTGTTAACGTTA-1_V12N28-333_C1,0,2,0,0,0,2
ACTCGTCAGTAATCCC-1_V12N28-333_C1,0,1,1,0,0,2
GGTGATAAGGAGCAGT-1_V12N28-333_C1,0,2,0,3,0,5
AAGAGGCATGGATCGC-1_V12N28-333_C1,1,1,0,0,0,2
CACGTTCGTGCTCTAG-1_V12N28-333_C1,0,1,0,1,1,3
CTATTTGGTTACGGAT-1_V12N28-333_C1,0,1,1,2,0,4
GTACAGAGGCAAGGGT-1_V12N28-333_C1,0,6,1,0,0,7
GGGCCGGCCGAAGTAC-1_V12N28-333_C1,0,2,0,2,0,4
CCTGAACGATATATTC-1_V12N28-333_C1,0,3,0,3,1,7
CCGGGCTGCTCCATAC-1_V12N28-333_C1,0,0,0,0,0,0
TACTTGTTAGTAGTCC-1_V12N28-333_C1,0,1,0,1,0,2
CCTAGGCGTAGCGATC-1_V12N28-333_C1,0,1,0,0,0,1
CTGGCGCACAGGTCTG-1_V12N28-333_C1,3,3,0,1,0,7
ACTTATACTTACCCGG-1_V12N28-333_C1,0,0,0,1,0,1
GAAGTCTCCCTAGCGA-1_V12N28-333_C1,1,4,0,1,0,6
ACCGATGGTAGCATCG-1_V12N28-333_C1,0,2,0,1,1,4
CGAGTTTATCGGACTG-1_V12N28-333_C1,0,1,0,1,0,2
CATAACGGACAGTCGT-1_V12N28-333_C1,0,0,0,1,0,1
TGACGATGCACTAGAA-1_V12N28-333_C1,0,0,0,0,0,0
TAGGGAGCTTGGGATG-1_V12N28-333_C1,0,1,0,1,0,2
AGGGTCGATGCGAACT-1_V12N28-333_C1,0,0,0,1,1,2
TATATCCCTGGGAGGA-1_V12N28-333_C1,0,2,0,0,2,4
CATCTTACACCACCTC-1_V12N28-333_C1,0,1,0,1,1,3
GTGCGACAGGGAGTGT-1_V12N28-333_C1,0,1,0,0,0,1
CCGATCTCAACCTTAT-1_V12N28-333_C1,0,3,0,0,0,3
ACGATCATCTTGTAAA-1_V12N28-333_C1,0,2,0,2,0,4
GAAAGAACAGCGTTAT-1_V12N28-333_C1,0,1,0,3,0,4
CTAGGTCTGAAGGAAT-1_V12N28-333_C1,0,2,0,1,0,3
ATATCAACCTACAGAG-1_V12N28-333_C1,1,0,0,1,0,2
AAATAGCTTAGACTTT-1_V12N28-333_C1,0,4,0,1,0,5
GCGACATGTAAACATC-1_V12N28-333_C1,1,0,0,1,0,2
ATAAGTAGGGCGACTC-1_V12N28-333_C1,0,0,0,0,0,0
GCGAGCGCATGCTCCC-1_V12N28-333_C1,0,2,0,1,0,3
AGGGACCGGCTGCGTT-1_V12N28-333_C1,0,0,0,1,0,1
CCTATGAAGTGGTGCC-1_V12N28-333_C1,0,3,0,0,0,3
GCTTACGTAGTTAGTA-1_V12N28-333_C1,0,2,0,0,1,3
CATACTTAGGCAATAC-1_V12N28-333_C1,0,1,0,1,1,3
CCTGTCCCTCACGTTA-1_V12N28-333_C1,0,2,0,1,0,3
CAATGTGCCAACCCTT-1_V12N28-333_C1,0,2,0,1,1,4
GTTAAGTTAGAGTGGG-1_V12N28-333_C1,0,4,0,0,0,4
CTGGGATACGCTACCC-1_V12N28-333_C1,0,0,0,0,0,0
AACCTGTCACGGAATT-1_V12N28-333_C1,0,2,0,3,1,6
ACTGCGGACACACCGT-1_V12N28-333_C1,0,3,0,0,0,3
CCGTGAGGCATTCATG-1_V12N28-333_C1,0,0,0,0,0,0
GCCCAGATGCTGGAGA-1_V12N28-333_C1,0,1,0,0,0,1
TCTGGCCGTTCAAGTT-1_V12N28-333_C1,0,2,0,1,0,3
ATACGAAGGCTTTCCA-1_V12N28-333_C1,0,2,0,1,3,6
GATCCGAATATAAGTG-1_V12N28-333_C1,0,4,0,0,0,4
GTGGAGCATGTCGGCC-1_V12N28-333_C1,0,2,0,0,0,2
ACTCTTCAGCTCCCGC-1_V12N28-333_C1,1,3,0,0,2,6
CCCGATAGCCTCGCCT-1_V12N28-333_C1,0,2,1,0,0,3
ACAGGTGTGTTGTTGC-1_V12N28-333_C1,2,0,0,3,0,5
TGAACTGCTATGACTT-1_V12N28-333_C1,0,2,0,0,0,2
TGACATATATGACGAT-1_V12N28-333_C1,0,0,0,1,0,1
AAGTCTTCTGTGGCCT-1_V12N28-333_C1,0,1,1,2,0,4
ACCAGACCATAACAAC-1_V12N28-333_C1,2,1,2,1,0,6
TGAGACGTACCTCTCA-1_V12N28-333_C1,2,2,1,0,0,5
GACCGTTACATGCGAC-1_V12N28-333_C1,0,0,3,1,0,4
GGTTCGGATTATACTA-1_V12N28-333_C1,1,3,0,1,0,5
CCTCCTGAGCCCACAT-1_V12N28-333_C1,1,0,2,1,0,4
CCGCGATTTGGTAGGT-1_V12N28-333_C1,0,3,0,5,0,8
AATCTCTACTGTGGTT-1_V12N28-333_C1,0,1,0,2,0,3
ACTTTGACTGCATCCT-1_V12N28-333_C1,1,1,2,1,0,5
CCCTGACTAACAAATT-1_V12N28-333_C1,2,1,1,3,0,7
ACGCTGTGAGGCGTAG-1_V12N28-333_C1,0,2,2,3,0,7
GCATACGAGGTCTTTA-1_V12N28-333_C1,1,0,1,3,0,5
TCGGGATTCAAACATA-1_V12N28-333_C1,0,0,2,3,0,5
GGGCCCTACGAAAGGG-1_V12N28-333_C1,1,2,4,3,0,10
CGCCAAGAAGCCGAGT-1_V12N28-333_C1,0,0,2,9,0,11
GGTACATCTGGGACGA-1_V12N28-333_C1,0,0,3,5,0,8
GGATGCTGGCGTTCCT-1_V12N28-333_C1,0,2,0,3,0,5
CCGATTCGAGGGACCC-1_V12N28-333_C1,1,0,2,4,0,7
CCACTGGTGGCTGGTT-1_V12N28-333_C1,0,0,0,1,0,1
GACAGGCACACACTAT-1_V12N28-333_C1,0,0,3,1,0,4
TCAACGCGACCGGCAG-1_V12N28-333_C1,1,0,3,1,0,5
CTACGACTAGCTATAA-1_V12N28-333_C1,0,0,1,1,0,2
CGGTTGACCTGGCATA-1_V12N28-333_C1,1,1,0,1,1,4
ATCCTGAATCGCTGCG-1_V12N28-333_C1,0,1,0,2,0,3
GTTTCATATCGTCGCT-1_V12N28-333_C1,0,2,0,1,1,4
ATAAATATTAGCAGCT-1_V12N28-333_C1,0,2,1,1,1,5
AAGAGGATGTACGCGA-1_V12N28-333_C1,0,2,0,0,0,2
TCCTGCGTTGATACTC-1_V12N28-333_C1,0,5,0,2,1,8
CGTGCATTGTCGACGC-1_V12N28-333_C1,0,2,1,2,0,5
CCGGGTTCGAGGTTAC-1_V12N28-333_C1,0,1,0,0,1,2
CCCAATTTCACAACTT-1_V12N28-333_C1,0,0,0,1,2,3
TGATTTATTAGCTGTG-1_V12N28-333_C1,0,0,0,1,2,3
TGGAAGAAGGGAACGT-1_V12N28-333_C1,0,1,0,0,1,2
GACGCTTGCTTCTAAA-1_V12N28-333_C1,0,2,0,0,0,2
GGGAACGGGAGGTTAG-1_V12N28-333_C1,0,1,0,0,1,2
GCGGCTCTGACGTACC-1_V12N28-333_C1,0,1,0,0,0,1
ACGTTAGATTTGCCCG-1_V12N28-333_C1,0,0,0,0,0,0
GAGAGGGCGCGAGGTT-1_V12N28-333_C1,0,3,0,0,0,3
GCGTCTCTGCATTGGG-1_V12N28-333_C1,0,2,0,0,0,2
GCAGCACACAGCCCAG-1_V12N28-333_C1,0,1,0,0,1,2
CAGGCCGTTTGGGTGT-1_V12N28-333_C1,0,1,0,1,1,3
AACTCAAGTTAATTGC-1_V12N28-333_C1,0,1,0,0,0,1
CTTCGTAGATAGGTGA-1_V12N28-333_C1,0,0,0,0,0,0
TGCAGAGTACCGAGCA-1_V12N28-333_C1,0,1,0,0,0,1
GAAGTGATTTATCGTG-1_V12N28-333_C1,0,3,0,0,0,3
CGCTACGGGACATTTA-1_V12N28-333_C1,3,6,0,1,0,10
CCACACTGAGATATTA-1_V12N28-333_C1,1,4,0,0,1,6
CGATCCGACCCAGTGC-1_V12N28-333_C1,0,2,0,1,0,3
CTGTACTTCTTAGCAT-1_V12N28-333_C1,0,1,0,0,0,1
ACTTATTAGGATCGGT-1_V12N28-333_C1,0,2,0,0,0,2
TAGTCCGCAGAGAATG-1_V12N28-333_C1,0,0,0,0,1,1
TTCACGAAAGGATCAC-1_V12N28-333_C1,0,1,0,1,0,2
TACATTTCTAACGTGC-1_V12N28-333_C1,1,1,0,0,0,2
ACCATATCCGCAATAA-1_V12N28-333_C1,0,0,0,1,0,1
CACTCAAGAGCTATGG-1_V12N28-333_C1,0,3,0,0,0,3
TGTACGAACAAATCCG-1_V12N28-333_C1,0,3,1,1,2,7
ATCATCCAATATTTGT-1_V12N28-333_C1,0,3,0,1,0,4
CGCTATTCTTAGGCTC-1_V12N28-333_C1,1,0,0,0,0,1
TGGCAGCAGTAATAGT-1_V12N28-333_C1,0,1,0,2,1,4
TCACGTGCCCGATTCA-1_V12N28-333_C1,0,1,0,0,0,1
CATACGGCGTCTGGGC-1_V12N28-333_C1,0,4,0,0,0,4
CACATGATTCAGCAAC-1_V12N28-333_C1,0,1,0,0,0,1
GCTAGTAGAGCTTGTA-1_V12N28-333_C1,0,0,0,1,0,1
TGCTGTTGAAGAACTC-1_V12N28-333_C1,0,0,0,0,0,0
CGGAGCATGGCGATCC-1_V12N28-333_C1,0,0,0,0,0,0
TAGCGTTGGGTCTTAC-1_V12N28-333_C1,0,2,0,2,0,4
GTAGCGGCTATACACT-1_V12N28-333_C1,0,3,0,1,0,4
TAACATACAATGTGGG-1_V12N28-333_C1,1,1,0,0,1,3
TCTTCGAATAGACGTT-1_V12N28-333_C1,0,1,1,0,0,2
GATCGTGACTGATATC-1_V12N28-333_C1,0,3,0,1,0,4
GATCCGGGAATTAACA-1_V12N28-333_C1,0,2,0,0,0,2
TTATATACGCTGTCAC-1_V12N28-333_C1,0,1,0,1,0,2
GTCGCGTAACCCGTTG-1_V12N28-333_C1,0,2,0,0,0,2
AGCTCTAGACGTTCCA-1_V12N28-333_C1,0,1,0,1,0,2
GTCAAGCGGACTCGGG-1_V12N28-333_C1,0,4,0,0,1,5
CGAGGGACTGCGGTCG-1_V12N28-333_C1,0,2,0,2,0,4
AATCGCCTCAGCGCCA-1_V12N28-333_C1,1,3,1,1,0,6
CTTGTTGCTGAGTCAA-1_V12N28-333_C1,0,5,0,0,0,5
GATATGAGACACTAAC-1_V12N28-333_C1,0,1,0,0,1,2
TTATGATCTTAACGAA-1_V12N28-333_C1,0,3,0,0,0,3
CGCCGCCCATGCCTGT-1_V12N28-333_C1,0,1,0,1,0,2
CTGGGATAAATAATGG-1_V12N28-333_C1,0,3,0,0,0,3
GTGCCCGTTCGGATTC-1_V12N28-333_C1,0,1,0,0,0,1
TTCAATACTCTGAATC-1_V12N28-333_C1,0,2,0,0,0,2
CGCACATGTCCACTAC-1_V12N28-333_C1,0,1,2,1,1,5
AGAAGAGCGCCGTTCC-1_V12N28-333_C1,0,3,0,0,1,4
GATAACTCGCACTGTG-1_V12N28-333_C1,0,3,0,0,1,4
AGTCGACGGTCTCAAG-1_V12N28-333_C1,0,1,0,1,2,4
GTGACCGCACACTACG-1_V12N28-333_C1,0,0,0,1,0,1
GTATGTGGGTCTAGTT-1_V12N28-333_C1,0,4,0,0,0,4
CTTGAGTTAGGGTAAT-1_V12N28-333_C1,0,8,0,0,0,8
TTAGCTGATTTGCCGT-1_V12N28-333_C1,0,1,0,0,0,1
GCTGTTGCTACCGAAC-1_V12N28-333_C1,0,1,0,0,0,1
TATTACCATCCTGCTT-1_V12N28-333_C1,0,3,0,1,1,5
TTGAATTCACGTGAGG-1_V12N28-333_C1,0,3,0,3,0,6
CCATCTCACCAGTGAA-1_V12N28-333_C1,0,0,0,1,0,1
CGCACGTGCGCTATCA-1_V12N28-333_C1,0,1,0,2,0,3
ACCCGGATGACGCATC-1_V12N28-333_C1,0,3,0,0,0,3
CGCTAGAGACCGCTGC-1_V12N28-333_C1,0,0,0,1,0,1
ATAGTTCCACCCACTC-1_V12N28-333_C1,0,2,0,0,0,2
GCAGACCCAGCACGTA-1_V12N28-333_C1,0,1,0,2,1,4
TAGACTACCTAGCGTT-1_V12N28-333_C1,0,2,0,0,0,2
GGTTCTACTCGTCTGA-1_V12N28-333_C1,0,1,0,0,0,1
GACTCACCCACGTGAG-1_V12N28-333_C1,0,2,0,0,0,2
AGCTCTTCGTAACCTT-1_V12N28-333_C1,0,2,0,0,0,2
ACTATCCAGGGCATGG-1_V12N28-333_C1,0,0,0,1,1,2
AAGGATCGATCGCTTG-1_V12N28-333_C1,0,2,0,0,0,2
ATATCGGTAGGGAGAT-1_V12N28-333_C1,0,0,0,0,1,1
TTCCAGACGAGATTTA-1_V12N28-333_C1,0,3,0,0,0,3
GACCGACGTGAAAGCA-1_V12N28-333_C1,0,4,0,0,0,4
CCTGGAAACGTTCTGC-1_V12N28-333_C1,0,2,0,0,0,2
CCGGTAATGGCTAGTC-1_V12N28-333_C1,0,2,0,0,0,2
GCCGTGGAAGAAATGT-1_V12N28-333_C1,0,3,0,0,0,3
GTCTTGAGGAGCAGTG-1_V12N28-333_C1,0,2,0,0,0,2
TCCCAAAGCCCTAAAT-1_V12N28-333_C1,0,2,1,0,0,3
TTGAGCGCCACGTGAT-1_V12N28-333_C1,0,1,0,1,0,2
TTGAGTCCCGCTGCTG-1_V12N28-333_C1,0,3,0,0,0,3
ATGGAACCTTTGCACA-1_V12N28-333_C1,0,0,0,0,0,0
GCTAGCACCTGGGCCA-1_V12N28-333_C1,0,3,0,1,0,4
CGCCGTCTACCCATCG-1_V12N28-333_C1,0,3,0,1,0,4
GATAGGTGTCCCGGGC-1_V12N28-333_C1,0,0,0,0,0,0
AGGTATGCGGACATTA-1_V12N28-333_C1,0,0,0,0,0,0
TTGGTTCGCTCAAAGG-1_V12N28-333_C1,0,2,0,0,0,2
TCTGGAGCGTAAGAGT-1_V12N28-333_C1,0,3,0,1,0,4
TGCCTAAATTTAATAG-1_V12N28-333_C1,0,2,0,2,1,5
TAATTTCCGTCCAGTA-1_V12N28-333_C1,2,0,2,1,0,5
TCCTTCAATCCCTACG-1_V12N28-333_C1,0,2,0,2,0,4
TACCTATCCCTAGAGG-1_V12N28-333_C1,2,1,0,2,0,5
GCATGGGTACTGACGC-1_V12N28-333_C1,1,4,2,5,0,12
GTCGGGAACATGGTAG-1_V12N28-333_C1,2,1,1,3,0,7
GCAAATGAGGACACTT-1_V12N28-333_C1,0,2,1,2,0,5
GAATGGGCTTATCGAC-1_V12N28-333_C1,0,1,1,2,0,4
TGGTCGTGCAAGGCAA-1_V12N28-333_C1,0,1,0,1,0,2
CACCACGCCACACAGA-1_V12N28-333_C1,0,4,0,1,0,5
GAACCTCGACCTACAC-1_V12N28-333_C1,0,0,0,3,0,3
CAATACGCTCTGAGGC-1_V12N28-333_C1,1,0,2,5,0,8
TGGTAAGCAGGATTGA-1_V12N28-333_C1,3,0,2,3,0,8
AGTGGCTCCGTCGGCC-1_V12N28-333_C1,0,1,2,2,0,5
GATCGGATAGAACCAT-1_V12N28-333_C1,1,0,0,6,1,8
GCTACAGTACGGACCG-1_V12N28-333_C1,1,0,1,4,0,6
TCTATTACTAGAGGAT-1_V12N28-333_C1,1,1,1,5,0,8
TTCAGGCGTCAAAGCC-1_V12N28-333_C1,0,2,0,0,0,2
AGACCGGGAAACCCTG-1_V12N28-333_C1,0,1,0,1,1,3
AGAGATCTCTAAAGCG-1_V12N28-333_C1,0,0,1,0,1,2
CCCTGCCCAATCCGCT-1_V12N28-333_C1,0,2,1,2,0,5
GTGGCGGTCCCAGCGT-1_V12N28-333_C1,0,0,4,0,1,5
GCATTGTAATTCATAT-1_V12N28-333_C1,2,2,0,0,0,4
CCGTTCCGAATCTCGG-1_V12N28-333_C1,0,0,0,3,0,3
AGCTTGATCTTAACTT-1_V12N28-333_C1,0,1,2,0,0,3
CCTGTACTCACGCCCA-1_V12N28-333_C1,0,1,1,2,0,4
AAGTGACGACCGAATT-1_V12N28-333_C1,0,0,0,1,0,1
CTCACTTGGCTGGTAA-1_V12N28-333_C1,0,1,0,0,0,1
CGCCTGGCCTACGTAA-1_V12N28-333_C1,0,5,0,0,0,5
CCCGTAAGTCTAGGCC-1_V12N28-333_C1,0,4,0,1,1,6
TTGGACATGTGGCTTA-1_V12N28-333_C1,1,0,0,0,0,1
ATTACGCGCTGGCAGG-1_V12N28-333_C1,0,2,0,0,1,3
ACGCGCTACACAGGGT-1_V12N28-333_C1,0,5,0,1,0,6
TACGTTTACCGGCAAT-1_V12N28-333_C1,0,2,0,0,0,2
CGAAACGCAATTCATG-1_V12N28-333_C1,2,2,0,0,0,4
TAGTCTAACAACGAGA-1_V12N28-333_C1,0,4,0,1,0,5
TTGCATGCTGATCACG-1_V12N28-333_C1,0,1,0,0,1,2
TCTGGGTAGCGCTCAT-1_V12N28-333_C1,0,3,0,0,2,5
ACATCGGTCAGCCGCG-1_V12N28-333_C1,1,1,0,1,0,3
AGATACCGGTGTTCAC-1_V12N28-333_C1,0,4,0,0,1,5
GATTACTGAATTTGGG-1_V12N28-333_C1,0,1,0,1,0,2
TCCAACTTTAAATTCT-1_V12N28-333_C1,0,1,0,1,2,4
TCCTAGCAAAGAAGCT-1_V12N28-333_C1,0,2,0,1,0,3
GTCTATCTGAGTTTCT-1_V12N28-333_C1,0,1,0,0,0,1
GATGTTCAATCCACGA-1_V12N28-333_C1,0,0,0,0,1,1
AGTTAAACACTTGCGA-1_V12N28-333_C1,0,1,0,1,0,2
AGCTCTTTACTCAGTT-1_V12N28-333_C1,0,1,0,0,1,2
ATCCAGGATTCGTGAA-1_V12N28-333_C1,2,3,0,0,0,5
AGTCAACACCACCATC-1_V12N28-333_C1,1,2,0,0,0,3
CGATACCTCGCGGACA-1_V12N28-333_C1,0,4,0,0,1,5
TACAACGCACAACTCA-1_V12N28-333_C1,1,2,0,0,1,4
AATTAAAGGTCGGCGT-1_V12N28-333_C1,0,2,0,1,1,4
TACGCAGTTCTTTCCT-1_V12N28-333_C1,0,0,0,0,1,1
GACCGTGCTGACGGTG-1_V12N28-333_C1,0,0,0,0,0,0
GGCAAATTACTTTACT-1_V12N28-333_C1,0,2,0,0,1,3
GGTACAAACATGCTAT-1_V12N28-333_C1,0,2,0,0,0,2
CGGGCCTTCTTTGTAA-1_V12N28-333_C1,0,4,0,0,0,4
CGTGAAGTTAATTCAC-1_V12N28-333_C1,0,0,0,0,0,0
ATAGTGAAGCGTTCTC-1_V12N28-333_C1,0,1,0,0,1,2
TACGCCATATTCTAAT-1_V12N28-333_C1,0,2,0,0,1,3
GCCGGGTTAGGGTCGC-1_V12N28-333_C1,0,2,0,0,0,2
TACATAGGCATACACC-1_V12N28-333_C1,0,2,0,0,2,4
GCCGATTGGCCAAGCT-1_V12N28-333_C1,0,2,0,0,0,2
CTGCCATGCATCACAT-1_V12N28-333_C1,1,1,0,1,2,5
TTATGAATGAAAGGGA-1_V12N28-333_C1,0,1,0,4,0,5
GCTGAGGCGTGAGTAT-1_V12N28-333_C1,0,2,0,2,0,4
GCGCCGTTCCACGATA-1_V12N28-333_C1,0,2,0,0,1,3
CGCATGGTGCGATGCT-1_V12N28-333_C1,0,5,0,3,0,8
AGGTTTCACACACCTT-1_V12N28-333_C1,0,2,0,0,1,3
CAAGGATCGCATGTTC-1_V12N28-333_C1,0,0,1,0,0,1
ACGTTAATGTCGAAGA-1_V12N28-333_C1,0,0,0,0,0,0
TCCAGAGCACCGGTTC-1_V12N28-333_C1,0,2,0,1,0,3
GATTCGACGGTTCACG-1_V12N28-333_C1,0,4,0,3,0,7
GTTTCTGCAGTCTCCC-1_V12N28-333_C1,0,3,0,2,0,5
GCTGCACGGTTTCTTA-1_V12N28-333_C1,0,2,0,0,0,2
CGTGCAGACTGGGACA-1_V12N28-333_C1,0,2,0,0,0,2
GTGTTACTATGCGTCC-1_V12N28-333_C1,0,3,0,1,0,4
TCCTCGGGCTGGGCTT-1_V12N28-333_C1,0,0,0,0,0,0
GTGAGGACACTTAAGG-1_V12N28-333_C1,0,2,0,1,2,5
ATACGCCGGCGAAACC-1_V12N28-333_C1,0,2,0,0,0,2
TCTGCCAGAAACTGCA-1_V12N28-333_C1,0,3,0,0,1,4
TTCTGCGGGTTAGCGG-1_V12N28-333_C1,0,3,0,2,0,5
CTCGGTACCACTGCTC-1_V12N28-333_C1,0,2,0,0,0,2
GTAAGTAACAGTCTGG-1_V12N28-333_C1,0,1,0,0,0,1
GTGCGTGTATATGAGC-1_V12N28-333_C1,0,2,0,4,0,6
ATTTGTCTTGGGAGCT-1_V12N28-333_C1,0,3,0,0,0,3
CCTCGGACCGGGATAG-1_V12N28-333_C1,1,2,0,2,0,5
TAGGTGCTCGCCTAGC-1_V12N28-333_C1,0,4,0,1,0,5
CTTTAGGAACACTGTT-1_V12N28-333_C1,0,1,0,1,0,2
TCGGGCCGTCGTGGTA-1_V12N28-333_C1,0,3,0,0,0,3
AGTGCTTGCACGAATA-1_V12N28-333_C1,0,1,0,0,0,1
TGCAGTTTCCTCCCAT-1_V12N28-333_C1,0,3,0,1,0,4
TGAGAGATTTACCACG-1_V12N28-333_C1,0,6,0,0,0,6
GAAACAGATGACCACC-1_V12N28-333_C1,0,2,0,1,0,3
AGCAACATATCTTATT-1_V12N28-333_C1,0,1,0,0,0,1
CAAGTGTGGTTGCAAA-1_V12N28-333_C1,0,2,0,0,0,2
GCCTCATCTGGAAATA-1_V12N28-333_C1,0,4,0,2,0,6
AACCCTACTGTCAATA-1_V12N28-333_C1,1,2,0,2,0,5
ACGTATTACTCCGATC-1_V12N28-333_C1,0,4,0,0,0,4
TCTGGGAACCTTTGAA-1_V12N28-333_C1,0,4,0,0,0,4
GCTCGCTCATGTCCAA-1_V12N28-333_C1,0,3,0,1,0,4
GCGCAAGAGCGCGCTG-1_V12N28-333_C1,0,3,0,0,0,3
TTGACGCTCCATGAGC-1_V12N28-333_C1,0,2,0,1,0,3
TATAGATGGTCGCAGT-1_V12N28-333_C1,1,0,0,0,0,1
TTACATGCCACAACTA-1_V12N28-333_C1,0,2,0,3,0,5
ACATGGCGCCAAAGTA-1_V12N28-333_C1,0,0,0,0,0,0
TATGGTTAGTGGGAGA-1_V12N28-333_C1,0,2,0,0,0,2
CATGACTTCGCTGAAT-1_V12N28-333_C1,0,4,0,0,0,4
ACCACCAATGTAACAA-1_V12N28-333_C1,0,1,0,1,3,5
TCTTAGAGCTCCAATT-1_V12N28-333_C1,0,0,0,0,0,0
CCACGAATTTAACCTC-1_V12N28-333_C1,0,1,0,0,0,1
TTCTTGCTAGCATCTC-1_V12N28-333_C1,1,2,0,0,0,3
ACACCTTACTACTTGC-1_V12N28-333_C1,0,2,0,0,0,2
AGTCGGTTGCGTGAGA-1_V12N28-333_C1,0,1,0,0,1,2
ACCTACAGTATGTGGT-1_V12N28-333_C1,0,0,0,0,0,0
GAGGATAAACAGTGCT-1_V12N28-333_C1,0,2,0,0,0,2
TTCCGGTATCTGTGTC-1_V12N28-333_C1,0,3,0,1,0,4
GGAGGCCGAAGTCGTC-1_V12N28-333_C1,0,3,0,0,0,3
TTCGCTAGGAAGTTGT-1_V12N28-333_C1,0,2,0,3,0,5
TAAAGACAACCCTTTA-1_V12N28-333_C1,1,0,0,0,0,1
GTTGCGCTAACATTAC-1_V12N28-333_C1,0,6,0,1,0,7
GCTGAACTCTCCAGGG-1_V12N28-333_C1,0,2,0,0,0,2
AGCCCTGTCGCACCGT-1_V12N28-333_C1,0,2,0,0,1,3
AGCGCTAGAGCGATGT-1_V12N28-333_C1,0,7,0,0,0,7
TGCGCCGTTAATAACG-1_V12N28-333_C1,0,2,0,2,0,4
TGACAACGCATGTCGC-1_V12N28-333_C1,0,3,0,0,0,3
CGTCTTGAGTGTGACG-1_V12N28-333_C1,0,2,0,0,0,2
GATAGGATTAATTACA-1_V12N28-333_C1,0,3,0,0,0,3
GATACCGTGTCGGAGT-1_V12N28-333_C1,0,1,0,0,0,1
TGTGTCGAAGTCGAGG-1_V12N28-333_C1,0,2,0,3,0,5
GGATCAGAGCCATCAG-1_V12N28-333_C1,2,1,0,1,0,4
GTCCCAATCATCCCGC-1_V12N28-333_C1,0,1,1,3,0,5
TGCCACACTAGAGGAA-1_V12N28-333_C1,1,2,0,3,0,6
TGAATTTCACTTGCCT-1_V12N28-333_C1,0,1,1,2,0,4
CTCAGATTGTGATAAG-1_V12N28-333_C1,0,2,0,1,0,3
CGGACGTTACTTGAAG-1_V12N28-333_C1,0,2,2,3,0,7
CCGCCTTGCGATGTCG-1_V12N28-333_C1,1,1,2,0,0,4
CCAGTCAAATCTCTTA-1_V12N28-333_C1,1,0,2,3,0,6
AAACAGCTTTCAGAAG-1_V12N28-333_C1,2,1,3,0,0,6
TAGCTGATGTGAAGCG-1_V12N28-333_C1,1,0,3,1,0,5
CTTATGCGCTCAGGGC-1_V12N28-333_C1,1,0,2,2,0,5
TGGCTCTTGTCGCGTA-1_V12N28-333_C1,1,0,1,3,0,5
TTGTGAGGCATGACGC-1_V12N28-333_C1,0,0,1,0,0,1
CATAAGCTCTCCGTCT-1_V12N28-333_C1,0,1,2,5,0,8
CCTTCTCAGCGTTCCT-1_V12N28-333_C1,0,5,1,0,0,6
TGCAGCTACGTACTTC-1_V12N28-333_C1,0,0,0,0,0,0
CTCTACACTGGCGATT-1_V12N28-333_C1,0,3,0,0,2,5
TGCAGATCGTCCTAGG-1_V12N28-333_C1,0,4,2,1,0,7
TGCCAAAGTCAGACTT-1_V12N28-333_C1,0,5,0,2,0,7
ACAATAGTCGTACGTT-1_V12N28-333_C1,0,1,0,2,0,3
CATGCCAACTCGCAAA-1_V12N28-333_C1,0,1,0,2,1,4
TGCAGAACTATATCGT-1_V12N28-333_C1,0,5,0,0,0,5
TCGTGTCACGCTGACA-1_V12N28-333_C1,0,0,0,0,0,0
TGATCAGGGAACTGCT-1_V12N28-333_C1,0,1,0,3,0,4
CTTGCAACCGCCTCCT-1_V12N28-333_C1,0,2,0,3,0,5
AGCCCATACATGTAAG-1_V12N28-333_C1,0,0,0,0,0,0
ATCCAATGGAGGGTCC-1_V12N28-333_C1,1,0,0,0,1,2
AAACCGGGTAGGTACC-1_V12N28-333_C1,0,0,0,0,0,0
GCAACCACGGCCGCGT-1_V12N28-333_C1,0,0,0,0,1,1
CGCTTATTCCCGGTCG-1_V12N28-333_C1,0,1,0,0,0,1
TTACTCTGGTACGTAC-1_V12N28-333_C1,1,3,0,0,0,4
GTGGTTTCCGCCTTTC-1_V12N28-333_C1,0,2,0,0,0,2
ATAGGCGGCTATAGAA-1_V12N28-333_C1,0,1,0,0,1,2
GTGCCATCACACGGTG-1_V12N28-333_C1,0,2,0,1,0,3
CCCAACATACGTCGCG-1_V12N28-333_C1,0,3,0,0,0,3
CGGTGCAGATAGAACG-1_V12N28-333_C1,0,2,0,0,0,2
GGGCGGGTTCCCTACG-1_V12N28-333_C1,0,2,0,0,0,2
TGAGCCATACAGTCTC-1_V12N28-333_C1,0,1,0,0,0,1
CTCCGCCCACATGAGG-1_V12N28-333_C1,0,2,0,1,0,3
GTTGAACCGGTTCCAT-1_V12N28-333_C1,0,4,0,1,0,5
TTGACTACCATATGGT-1_V12N28-333_C1,0,3,0,1,0,4
ACCATCGTATATGGTA-1_V12N28-333_C1,1,1,0,0,0,2
TGCGTAAGAACCTGAT-1_V12N28-333_C1,1,1,0,0,0,2
AGAAGGTTGCCGAATT-1_V12N28-333_C1,0,2,0,0,0,2
AGGACGACCCATTAGA-1_V12N28-333_C1,2,2,0,0,0,4
GGTGCTGGTACACATT-1_V12N28-333_C1,0,4,0,1,0,5
GCGCTATGCCGAGGCA-1_V12N28-333_C1,0,3,0,0,1,4
ACCCGGTTACACTTCC-1_V12N28-333_C1,0,3,0,0,0,3
TAACTCATCCGCGCGG-1_V12N28-333_C1,1,4,0,2,0,7
CACAATGAGCTGCTAT-1_V12N28-333_C1,0,5,0,0,0,5
GTTACTTTGGGCCTAG-1_V12N28-333_C1,0,2,0,0,0,2
GGGCCCGTCTTAAACA-1_V12N28-333_C1,0,2,0,0,1,3
GAAATTGTCTCTATAA-1_V12N28-333_C1,1,3,0,2,1,7
GGCGCATGAATTGATG-1_V12N28-333_C1,0,2,0,0,0,2
CATATAGGTACAGTCA-1_V12N28-333_C1,0,3,0,0,0,3
TCAACGAGGAGACAAA-1_V12N28-333_C1,0,1,0,0,1,2
TTGCACAATTCAGAAA-1_V12N28-333_C1,0,3,0,0,0,3
CATCGGACGGGTTAAT-1_V12N28-333_C1,1,1,0,0,0,2
ATTAAACATGCGGACC-1_V12N28-333_C1,0,1,0,0,0,1
TATCTACCACAGCGGG-1_V12N28-333_C1,0,2,0,0,0,2
CGAGACCCTAGAGTGT-1_V12N28-333_C1,0,1,0,0,1,2
ACATCGATCGTTTACC-1_V12N28-333_C1,0,2,0,1,1,4
ATCGACCCAATACAGA-1_V12N28-333_C1,0,2,0,0,0,2
GAATCTGAACATTCTC-1_V12N28-333_C1,1,1,0,0,1,3
AGTTCCTATTTATGTT-1_V12N28-333_C1,0,1,0,0,2,3
CAGTCTGTATACTGGG-1_V12N28-333_C1,0,1,0,0,0,1
GGAGACGACACCTTTG-1_V12N28-333_C1,0,1,0,0,1,2
CCTAAATTAACGGTTC-1_V12N28-333_C1,0,1,0,1,0,2
GCTACGACTTATTGGG-1_V12N28-333_C1,0,0,0,1,1,2
CTGTGCAGGGTAGGTC-1_V12N28-333_C1,1,4,0,0,0,5
ACGCCGCTAGACGACC-1_V12N28-333_C1,0,1,1,0,0,2
ACTTGACTCCCTCTTT-1_V12N28-333_C1,0,0,0,0,0,0
CGCCTCCCTCCTCTAT-1_V12N28-333_C1,0,0,0,0,0,0
CTAGATTTACGACGGC-1_V12N28-333_C1,0,1,0,0,0,1
GATGCTGTATTTCATC-1_V12N28-333_C1,0,4,0,0,0,4
TGCGTTTGTTGACACT-1_V12N28-333_C1,0,4,0,0,0,4
CGTGCCCTCCCGAAGA-1_V12N28-333_C1,0,2,0,1,0,3
ACTCTCTGACTTAGGT-1_V12N28-333_C1,0,2,0,0,1,3
CTGGGTAGGCAGTTAA-1_V12N28-333_C1,0,1,1,0,0,2
GTTTGGCCCAAGTTAT-1_V12N28-333_C1,0,3,0,0,0,3
GAATGTGGTCCGGATT-1_V12N28-333_C1,0,3,0,1,0,4
CCCAGTTAAGGCGCCG-1_V12N28-333_C1,0,2,0,1,0,3
CGGTACTAGAATCAAA-1_V12N28-333_C1,0,1,0,2,0,3
GCTTAATGTAACTAAC-1_V12N28-333_C1,0,3,0,0,0,3
AGGACAGTCGAATCCC-1_V12N28-333_C1,0,3,0,1,0,4
GACAGCCAGACCTGAC-1_V12N28-333_C1,0,3,1,2,0,6
GGCGAAATCTAACTTG-1_V12N28-333_C1,0,1,0,1,0,2
CTGGTAACACATAGAA-1_V12N28-333_C1,0,0,0,0,0,0
TAGCCATTTCAAAGTC-1_V12N28-333_C1,0,0,0,1,0,1
GGGATTTACCGCACCT-1_V12N28-333_C1,0,3,0,0,1,4
ATGCCATTTGCGACCA-1_V12N28-333_C1,0,1,0,0,0,1
GAATAGACGCGACCCA-1_V12N28-333_C1,0,1,0,0,0,1
TGTATGGCGCAGACAG-1_V12N28-333_C1,0,0,0,2,1,3
GGATGAAGATCGCTGA-1_V12N28-333_C1,0,3,0,0,0,3
CGACAATTTGATCTAA-1_V12N28-333_C1,0,0,1,1,0,2
AAAGTTGACTCCCGTA-1_V12N28-333_C1,0,1,0,0,0,1
CGCGGCTCAACTTGAA-1_V12N28-333_C1,0,0,0,0,0,0
CACGCGGAACTGTTGC-1_V12N28-333_C1,0,6,0,0,0,6
TCTTAGAGTGAACTCT-1_V12N28-333_C1,1,4,0,0,0,5
AGTCCATTGGCTGATG-1_V12N28-333_C1,0,2,0,1,1,4
TTAAGATAGGATTGAC-1_V12N28-333_C1,0,5,0,1,1,7
ACATCCTGGTAACTGT-1_V12N28-333_C1,0,3,0,3,1,7
CACCTTGGCGCCTTTG-1_V12N28-333_C1,0,3,0,0,0,3
GCTAGACCGTCTACTG-1_V12N28-333_C1,0,5,0,0,0,5
CGGCCCAGGTATATCC-1_V12N28-333_C1,0,2,0,0,0,2
GTCCATTACTGCTACG-1_V12N28-333_C1,0,2,0,1,0,3
GGGTTTAGGATAGGAT-1_V12N28-333_C1,0,1,0,0,0,1
TAATTAGGACATCCGT-1_V12N28-333_C1,0,1,0,1,0,2
GCTCCCAGTCGGTCCA-1_V12N28-333_C1,1,1,0,0,0,2
ATTCGTGCTATCTCTT-1_V12N28-333_C1,0,3,0,1,0,4
GTTAACTATGTTGTCA-1_V12N28-333_C1,0,2,0,1,0,3
GCTCCGCTCGCTTCAG-1_V12N28-333_C1,0,2,0,0,0,2
GCAACGGCTAGTTATG-1_V12N28-333_C1,0,3,0,0,1,4
AATCGCGCAGAGGACT-1_V12N28-333_C1,0,1,0,0,1,2
AGGTTACACCATGCCG-1_V12N28-333_C1,0,2,0,0,0,2
CGAGATTTCGCTCGGG-1_V12N28-333_C1,0,0,0,0,0,0
CGATAATACTCAGGTT-1_V12N28-333_C1,0,2,0,1,1,4
AAGGCAGGCTGTCTCC-1_V12N28-333_C1,0,2,0,0,0,2
GTAAGTCCACACTCTA-1_V12N28-333_C1,0,2,0,0,0,2
ATGAGGGCAGCGGCTA-1_V12N28-333_C1,0,3,0,1,1,5
GCCGCACTCCGTTTCA-1_V12N28-333_C1,0,2,0,0,0,2
GAGCACGGCGCCTCTT-1_V12N28-333_C1,0,2,0,0,0,2
ACAATTTGGCCATATT-1_V12N28-333_C1,1,1,0,1,0,3
CTGGTTCGCGAGCTAC-1_V12N28-333_C1,2,1,0,0,1,4
GACGGTCCTAGGGTGT-1_V12N28-333_C1,0,4,0,2,2,8
ACTCGCGATCTGACGC-1_V12N28-333_C1,1,3,0,0,0,4
GTGTACGAACCGTTCC-1_V12N28-333_C1,0,2,0,0,0,2
CTTTGACGTCGCTTCT-1_V12N28-333_C1,0,1,0,5,0,6
CGTTATCATACTTCCA-1_V12N28-333_C1,1,0,1,2,0,4
GCTATGCCAGCTTATG-1_V12N28-333_C1,1,0,1,3,0,5
CAGTCGGCCTAGATAT-1_V12N28-333_C1,0,1,1,1,0,3
CCCGTGAGGGCGGTGA-1_V12N28-333_C1,3,1,0,1,0,5
TCTCGTGTTACGAGGA-1_V12N28-333_C1,1,1,2,2,0,6
ACGTCTCGTTCCGGGA-1_V12N28-333_C1,2,0,1,2,1,6
CGAGAGCGCGTAGATA-1_V12N28-333_C1,1,0,1,6,0,8
GACAGATTTCTGGCTC-1_V12N28-333_C1,0,0,4,0,1,5
GGGCCTAAATGGGCTA-1_V12N28-333_C1,0,0,1,5,0,6
ACTTGTAGTCCCTTCA-1_V12N28-333_C1,1,0,1,1,0,3
CCCGAAGTTTCGCGAA-1_V12N28-333_C1,1,0,2,2,2,7
ACCATCCGCCAACTAG-1_V12N28-333_C1,0,1,1,1,0,3
TGCGAATATGGGATTT-1_V12N28-333_C1,0,1,0,2,0,3
TACATCCCTATCCCTG-1_V12N28-333_C1,0,2,1,1,0,4
GTGGGAAGACTGAATC-1_V12N28-333_C1,0,1,0,0,0,1
TCAACATCGACCGAGA-1_V12N28-333_C1,1,2,0,0,0,3
CTATGTGAGTCACGGC-1_V12N28-333_C1,1,1,0,0,1,3
CCGAACACTGGGCCTC-1_V12N28-333_C1,0,1,0,3,1,5
AAACTTGCAAACGTAT-1_V12N28-333_C1,0,3,0,1,0,4
AGGGCGAGCAGCTGAT-1_V12N28-333_C1,0,0,0,0,0,0
AACACGAGACGCGGCC-1_V12N28-333_C1,0,4,0,0,0,4
TGACGAATATTTCCCT-1_V12N28-333_C1,0,2,0,0,1,3
TCGGAGAGTATCGGGA-1_V12N28-333_C1,2,6,0,0,1,9
CAAATCTCTCACAAGG-1_V12N28-333_C1,0,0,0,0,1,1
AGGCCCTAGAACGCCA-1_V12N28-333_C1,0,0,0,0,2,2
TAGAGATCATGCAACT-1_V12N28-333_C1,0,3,0,0,0,3
TTGTTTCCATACAACT-1_V12N28-333_C1,0,3,0,0,0,3
GAGAGGTGCATTCTGG-1_V12N28-333_C1,0,3,0,0,0,3
GTGGACCAACCCGATT-1_V12N28-333_C1,0,4,0,0,1,5
CTGGGCCTGCTATATC-1_V12N28-333_C1,0,3,0,1,1,5
CATAGTCCACAAGAAC-1_V12N28-333_C1,0,0,0,0,0,0
TTGACATGAACGTGGA-1_V12N28-333_C1,0,0,0,0,0,0
GGTTACCACCCTCGGG-1_V12N28-333_C1,0,1,0,0,0,1
TACCGGTCGTTTCCAT-1_V12N28-333_C1,0,5,0,2,0,7
CGAGTACTAAAGAGGA-1_V12N28-333_C1,1,3,0,0,0,4
GCAAGAATTCCTTGGC-1_V12N28-333_C1,0,1,0,0,0,1
TCGCCGAAGTTGCGTC-1_V12N28-333_C1,1,3,0,1,0,5
TTGAGAGTACTGCTAA-1_V12N28-333_C1,0,2,0,0,1,3
GCCACAATTTAAGGAC-1_V12N28-333_C1,0,3,0,0,0,3
ATATTCAGTTAAACCT-1_V12N28-333_C1,1,3,0,1,0,5
TGAGTGCCTCTTAAAT-1_V12N28-333_C1,0,2,0,0,0,2
ATCAGACGGCACGCCG-1_V12N28-333_C1,0,1,0,1,0,2
GTGCGAAATCGAACAC-1_V12N28-333_C1,0,8,0,1,0,9
GTGCCGCTTCAAAGGT-1_V12N28-333_C1,0,4,0,0,0,4
GATACGATGGGAGTCA-1_V12N28-333_C1,0,4,0,0,0,4
GACACTGAGTTCAGTG-1_V12N28-333_C1,1,4,0,0,0,5
ATCCTGCGTGGAATGG-1_V12N28-333_C1,0,1,0,0,0,1
ATCCTACCTAAGCTCT-1_V12N28-333_C1,0,2,0,4,1,7
AGTGATATGAGTAGTT-1_V12N28-333_C1,0,2,0,0,0,2
ATGATGCAATGGTACA-1_V12N28-333_C1,0,6,0,0,0,6
GAAACCGAATTACCTT-1_V12N28-333_C1,0,3,0,0,0,3
AGTGACCTACTTTACG-1_V12N28-333_C1,0,0,0,1,0,1
CAAATGTCCTTCCGTG-1_V12N28-333_C1,0,4,0,1,0,5
TTACTGGGATATTTCA-1_V12N28-333_C1,0,1,0,0,0,1
CTTGCCCAGGCTCTAC-1_V12N28-333_C1,0,3,0,0,0,3
AAATCGTGTACCACAA-1_V12N28-333_C1,0,0,0,0,0,0
GTGATCATAGATCTGC-1_V12N28-333_C1,0,3,0,0,1,4
TGGCAGATTACGATCA-1_V12N28-333_C1,0,0,0,0,0,0
TCACCCTCTTAAGATT-1_V12N28-333_C1,0,1,0,0,0,1
CAGGATATATCGTTGT-1_V12N28-333_C1,0,2,0,0,0,2
CCTGACCACCGATGGT-1_V12N28-333_C1,0,4,0,0,0,4
CTAAAGGGAAATAGGA-1_V12N28-333_C1,0,1,0,0,1,2
CCGCTATCAGCACCAG-1_V12N28-333_C1,0,3,0,0,0,3
CTTTAGTGCTATTATT-1_V12N28-333_C1,0,2,0,1,0,3
CGGGAATTTATGTAAA-1_V12N28-333_C1,0,1,0,0,0,1
TACGACTGCCTCTTAG-1_V12N28-333_C1,0,2,0,0,0,2
AAACTGCTGGCTCCAA-1_V12N28-333_C1,0,0,0,0,0,0
GTACGTTTGCCCGTCA-1_V12N28-333_C1,0,4,0,0,0,4
GGCAAGGCGAAATAGC-1_V12N28-333_C1,1,4,0,0,0,5
GATCTTGGAGGGCATA-1_V12N28-333_C1,0,10,0,0,0,10
AGCGTGGTATTCTACT-1_V12N28-333_C1,0,1,0,0,1,2
CTAAGGGAATGATTGG-1_V12N28-333_C1,0,2,0,0,0,2
CATGGTAAGTAGCGTT-1_V12N28-333_C1,0,2,0,1,1,4
CGTTGAGCGACCGTCG-1_V12N28-333_C1,0,2,0,1,0,3
TGCCCGTACCGTTAAA-1_V12N28-333_C1,0,0,0,0,0,0
ACAAGGGCAGGCTCTG-1_V12N28-333_C1,1,2,0,0,0,3
GAGATCTTCCATGACA-1_V12N28-333_C1,0,3,0,0,1,4
AATGACGTAGGATGTC-1_V12N28-333_C1,0,1,0,0,0,1
GTGGTGGCCAAGTGAA-1_V12N28-333_C1,1,1,0,0,0,2
TCCCGTGTGCAATTTG-1_V12N28-333_C1,0,0,0,0,0,0
ACATCGTATGCAATGG-1_V12N28-333_C1,1,2,0,0,1,4
GCGAAACTTAACTGGA-1_V12N28-333_C1,0,1,0,1,0,2
AATTGAACGCTCTGGT-1_V12N28-333_C1,0,1,0,0,0,1
ACAAATGGTAGTGTTT-1_V12N28-333_C1,0,2,0,0,0,2
ATGGTCGCGTGGTTTC-1_V12N28-333_C1,0,1,0,1,1,3
TGTTATTGTATGTGGC-1_V12N28-333_C1,0,3,0,1,0,4
TTCCGGTTACCCACTT-1_V12N28-333_C1,0,2,0,3,0,5
GAGTGTGCGGTACCCA-1_V12N28-333_C1,0,0,0,0,0,0
CAAGATATTATAACGT-1_V12N28-333_C1,0,1,0,0,1,2
ACACACCAGGACCAGT-1_V12N28-333_C1,0,6,0,0,0,6
ATGGGCCTCGGCCTCT-1_V12N28-333_C1,0,7,0,0,0,7
AAGGTGATAAACCAGC-1_V12N28-333_C1,0,2,0,0,2,4
TCTTACTTATGCCTCT-1_V12N28-333_C1,0,0,0,0,0,0
AAAGTGTGATTTATCT-1_V12N28-333_C1,0,2,0,0,0,2
TGCTCCACAGTTCTTA-1_V12N28-333_C1,0,3,0,3,0,6
CTGGCTGATTCATCCT-1_V12N28-333_C1,1,0,1,1,1,4
TAAGGCTGAATCCCTC-1_V12N28-333_C1,0,2,0,0,0,2
TCTAGTGATATCGTGG-1_V12N28-333_C1,0,1,0,0,1,2
TCGAAGAACCGAGCAC-1_V12N28-333_C1,0,5,0,0,2,7
GACAAACATATGCAGG-1_V12N28-333_C1,0,0,0,1,0,1
AAGTCAATTGTCGTCA-1_V12N28-333_C1,0,6,0,0,0,6
AGTGAACAAACTTCTC-1_V12N28-333_C1,0,2,0,0,0,2
CATGATGGAAGTTAGC-1_V12N28-333_C1,0,3,1,0,0,4
AAGTGCCTTGACTGTA-1_V12N28-333_C1,0,4,0,0,1,5
ATCGCCAGTCAACATT-1_V12N28-333_C1,0,3,0,2,0,5
ACCGCGGTGGAAGTCG-1_V12N28-333_C1,0,4,0,0,0,4
TCTTCTATAACCCGCC-1_V12N28-333_C1,0,2,0,0,0,2
CACATTTCTTGTCAGA-1_V12N28-333_C1,0,3,0,0,0,3
TAGCGTCCCTCGATTG-1_V12N28-333_C1,0,4,0,0,0,4
GTTCGGATCGGGAACA-1_V12N28-333_C1,0,1,0,1,0,2
CAAACTCGCGACGCCG-1_V12N28-333_C1,0,0,0,0,0,0
GTCTTGTAGCTATTCA-1_V12N28-333_C1,0,2,0,1,1,4
TCTCGACGTATCGCCG-1_V12N28-333_C1,0,4,0,1,0,5
TTGCCAAGCAGAACCC-1_V12N28-333_C1,0,1,0,0,0,1
AAACCCGAACGAAATC-1_V12N28-333_C1,0,1,0,0,1,2
TTGAGCAGCCCACGGT-1_V12N28-333_C1,0,3,0,0,0,3
CGCCTTTAGCATGCTC-1_V12N28-333_C1,0,0,0,0,0,0
TGTGGCTCCCACCAAC-1_V12N28-333_C1,0,1,0,0,0,1
CCGCCGTTGAGGATAA-1_V12N28-333_C1,0,2,0,0,0,2
CAATACGAGAGTCTGA-1_V12N28-333_C1,0,2,0,0,0,2
CATCTAGTGAAGGGAA-1_V12N28-333_C1,0,3,0,0,1,4
GGTGGAGGTTGATACG-1_V12N28-333_C1,0,4,0,0,0,4
CCGCACACGAACGTGT-1_V12N28-333_C1,0,1,0,0,0,1
AGAACCCAGCGTGACA-1_V12N28-333_C1,0,3,0,0,1,4
GCGCTCGATCACCTGT-1_V12N28-333_C1,1,2,0,1,0,4
ATCATGGACTACCGAC-1_V12N28-333_C1,0,6,0,0,1,7
TACGCCGCCTCAGAAG-1_V12N28-333_C1,0,2,0,0,0,2
CGACCTACTAGACAAT-1_V12N28-333_C1,0,1,1,1,0,3
GAGTCTTGTAAAGGAC-1_V12N28-333_C1,0,0,0,1,0,1
AATATCCTAGCAAACT-1_V12N28-333_C1,0,2,1,1,0,4
CCCTAGGCAACAAGAG-1_V12N28-333_C1,1,1,1,2,0,5
ACAAAGAAGGTAGGCC-1_V12N28-333_C1,0,0,2,3,0,5
CCCTGGCTGTTCCTTC-1_V12N28-333_C1,0,0,2,2,0,4
TCGCCGCACCGCGTGA-1_V12N28-333_C1,0,0,4,3,0,7
TATAGCGCACGTTATC-1_V12N28-333_C1,0,0,0,2,0,2
TTATCTGACATTAGGA-1_V12N28-333_C1,2,0,0,2,0,4
AGTGGTGTTACCCGTG-1_V12N28-333_C1,0,0,1,3,0,4
GCCAAGAATACTTCTG-1_V12N28-333_C1,0,1,3,1,1,6
CCGGCGTGAGACTCTG-1_V12N28-333_C1,0,2,0,1,2,5
TTCCCGGCGCCAATAG-1_V12N28-333_C1,0,3,2,0,0,5
AAACAGGGTCTATATT-1_V12N28-333_C1,0,0,0,0,2,2
ACAGTAATACAACTTG-1_V12N28-333_C1,0,1,0,0,1,2
CGAACGGCCGGACAAC-1_V12N28-333_C1,0,0,0,2,0,2
GCAACACACTAGAACT-1_V12N28-333_C1,0,0,0,0,0,0
ACTCCCATTCCTAAAG-1_V12N28-333_C1,0,0,0,0,0,0
ACCTGCGTGTCATGTT-1_V12N28-333_C1,0,3,0,1,0,4
TACTTTCCGCACGCCA-1_V12N28-333_C1,0,3,0,1,0,4
AGGTCAGGTGAGAGTG-1_V12N28-333_C1,0,1,0,0,1,2
TCCTCCTAAGACATTC-1_V12N28-333_C1,1,1,0,0,0,2
ATGTGAAAGCCTAATG-1_V12N28-333_C1,0,1,0,0,0,1
AGTCGGCTCAACTTTA-1_V12N28-333_C1,1,4,0,0,1,6
CGATCTGTTGGAGGAC-1_V12N28-333_C1,0,1,0,1,0,2
ACGGGAGTGTCGGCCC-1_V12N28-333_C1,0,2,0,0,1,3
TTAACTTCAGGTAGGA-1_V12N28-333_C1,0,1,0,1,0,2
CCACGGAGCCATAAGA-1_V12N28-333_C1,0,1,0,1,0,2
CTTCTATGTTGAAGTA-1_V12N28-333_C1,0,2,0,0,0,2
CACCGTTGCGCGATAT-1_V12N28-333_C1,0,5,0,0,0,5
TCTAGCAATCTCCGCC-1_V12N28-333_C1,0,2,0,0,0,2
AGTTTGGCCAGACCTA-1_V12N28-333_C1,0,1,0,1,0,2
TTGTAAGGACCTAAGT-1_V12N28-333_C1,0,3,0,0,0,3
AAATTTGCGGGTGTGG-1_V12N28-333_C1,0,3,0,0,0,3
AAGTTCGGCCAACAGG-1_V12N28-333_C1,0,4,0,1,0,5
CCGCTTACCTCACTCT-1_V12N28-333_C1,0,1,0,0,0,1
ATCACGTGCTAATTAA-1_V12N28-333_C1,0,2,0,0,0,2
GGTGAAGTACAGGGAT-1_V12N28-333_C1,0,1,0,1,0,2
GCTGTATTACTGGCCC-1_V12N28-333_C1,0,4,0,0,0,4
AACGGCCATCTCCGGT-1_V12N28-333_C1,0,2,0,1,2,5
TAAGTAACATCTTGAC-1_V12N28-333_C1,0,0,0,1,0,1
TTCTTGAGCCGCGCTA-1_V12N28-333_C1,1,0,0,1,0,2
AGTGCGTAGCTCGTAA-1_V12N28-333_C1,0,4,0,0,0,4
GGGATGGTCGTAACCG-1_V12N28-333_C1,0,2,0,0,0,2
GTCTGGGCGGTCGAGA-1_V12N28-333_C1,0,3,0,0,0,3
CGGAACGTAAACATAG-1_V12N28-333_C1,1,1,0,0,0,2
TGCGACACCCTAGTGC-1_V12N28-333_C1,0,2,0,0,0,2
CAAACGAGTATCGCAG-1_V12N28-333_C1,0,5,0,0,0,5
TCAGTAGGGACTATAA-1_V12N28-333_C1,0,1,0,0,0,1
GCGGTTCCCTATCATG-1_V12N28-333_C1,1,1,0,1,0,3
GTGACTTCAGTAGTGC-1_V12N28-333_C1,0,0,0,0,0,0
CGTCACGTCCATTGGT-1_V12N28-333_C1,0,3,0,0,0,3
ATAAGTTACCGCGACG-1_V12N28-333_C1,0,4,0,0,0,4
CTGAATCCGAGACCTC-1_V12N28-333_C1,0,1,0,0,0,1
TACGACGCTTGCTGCG-1_V12N28-333_C1,0,1,0,0,0,1
GAATTCACCCGGGTGT-1_V12N28-333_C1,0,4,0,0,0,4
GGGTGACACCTTAACT-1_V12N28-333_C1,0,3,0,0,0,3
TGAGTAAATTAGCGTA-1_V12N28-333_C1,0,1,0,1,0,2
GAGTCCGCTTACCGGA-1_V12N28-333_C1,0,1,0,0,0,1
GGCGCGTTCGAGTTTA-1_V12N28-333_C1,0,2,0,0,0,2
ATTCATATACTGTCCA-1_V12N28-333_C1,0,8,0,0,0,8
ATAAACGGACCCGTAA-1_V12N28-333_C1,0,1,0,0,0,1
GTCGTACCATCTCGGG-1_V12N28-333_C1,0,1,0,0,1,2
ATAATAGCTGTTGAAT-1_V12N28-333_C1,0,1,0,0,0,1
TTCCGCGTGAGGCGAT-1_V12N28-333_C1,0,1,0,0,0,1
TACCGGCTCACTGCCC-1_V12N28-333_C1,0,1,0,1,1,3
GTATCTTTCATAACCA-1_V12N28-333_C1,0,2,0,0,0,2
GTTACCTACAACTTGC-1_V12N28-333_C1,1,4,0,0,0,5
TGACTATAATCCTTTC-1_V12N28-333_C1,0,1,0,0,0,1
AAATACCTATAAGCAT-1_V12N28-333_C1,0,2,0,0,2,4
TTATTAGAGCGTGTTC-1_V12N28-333_C1,0,2,0,1,1,4
ATGTGGACATCTTGAT-1_V12N28-333_C1,0,3,0,0,0,3
GTACGCTTCATTGCAC-1_V12N28-333_C1,0,2,0,0,0,2
CACATATTAGCAGGAT-1_V12N28-333_C1,0,4,0,0,0,4
CAAGAGGGCGGAGTAC-1_V12N28-333_C1,0,1,0,0,0,1
TCGCAAAGATGCATTT-1_V12N28-333_C1,0,3,0,0,0,3
GTCGTTATTCGCTTAT-1_V12N28-333_C1,0,2,0,0,0,2
TCGTGTACTATGGATG-1_V12N28-333_C1,0,4,0,0,0,4
GCGGAGAGGGAGAACG-1_V12N28-333_C1,0,2,0,0,0,2
TCACAGGGAATCGCAA-1_V12N28-333_C1,0,3,0,0,0,3
GACTGCACCAGCCCAG-1_V12N28-333_C1,0,2,0,1,0,3
TCCGCTGTCATCCCGG-1_V12N28-333_C1,0,1,0,0,0,1
AGATACTCAAGATCGA-1_V12N28-333_C1,0,1,0,0,0,1
ACTGAATGGCGAAAGT-1_V12N28-333_C1,0,3,0,0,0,3
TCCTACATCCACGGCC-1_V12N28-333_C1,0,3,0,1,0,4
TTCAGCCCTGGTCCAC-1_V12N28-333_C1,0,4,0,0,0,4
TTAGAGTTTAGAAGGA-1_V12N28-333_C1,0,3,0,0,0,3
GGTTAGCTATATGTCT-1_V12N28-333_C1,0,3,0,0,1,4
CTGGTTTCGAGCAAGA-1_V12N28-333_C1,1,1,0,1,0,3
TGGGCCCATACTAATT-1_V12N28-333_C1,0,3,0,0,1,4
ACTTATTTATGTGCCA-1_V12N28-333_C1,0,0,0,0,0,0
TTAGTTATTCGTGGCA-1_V12N28-333_C1,0,0,0,1,0,1
AACCGCTAAGGGATGC-1_V12N28-333_C1,0,2,0,0,1,3
ATACGTCCACTCCTGT-1_V12N28-333_C1,0,2,0,0,0,2
CGACACGCTCCGACAG-1_V12N28-333_C1,0,1,0,1,0,2
TCTGAACTCGTACCCG-1_V12N28-333_C1,0,2,0,0,0,2
AGGATATAGGGATTTA-1_V12N28-333_C1,0,0,0,0,0,0
GTGATCACTAACGCCT-1_V12N28-333_C1,0,3,0,0,1,4
ACCGGGCCTTTGTTGA-1_V12N28-333_C1,0,3,0,0,0,3
TTGACAGGAGCTCCCG-1_V12N28-333_C1,0,3,0,0,1,4
CTCTTCTATTGACTGG-1_V12N28-333_C1,0,0,0,0,0,0
CGTGGCCGAATATCTA-1_V12N28-333_C1,0,5,0,0,0,5
GGTTTAGCCTTTCTTG-1_V12N28-333_C1,0,1,0,1,1,3
TCAAGGTTACTACACC-1_V12N28-333_C1,0,1,0,0,0,1
TTGACTATTGTCCGGC-1_V12N28-333_C1,0,1,0,0,0,1
CGGGAATATAGTATAC-1_V12N28-333_C1,0,5,0,0,0,5
GCAACAGCAGTATGCG-1_V12N28-333_C1,0,4,0,0,0,4
ATCAAACACTGTTCCA-1_V12N28-333_C1,0,5,0,0,0,5
TGGGCAATAGTTGGGT-1_V12N28-333_C1,0,0,0,2,2,4
TGAATGTCAGCCGGCC-1_V12N28-333_C1,0,1,0,0,0,1
CGGCTCTAAAGCTGCA-1_V12N28-333_C1,0,2,0,0,0,2
GGACACAAGTTTACAC-1_V12N28-333_C1,0,2,0,0,0,2
CCGAGAAGTCGCATAA-1_V12N28-333_C1,0,2,0,0,0,2
AACTACCCGTTTGTCA-1_V12N28-333_C1,0,2,0,0,0,2
GCACAAACGAGGCGTG-1_V12N28-333_C1,0,4,0,0,1,5
CACACAGCTTGCGCTC-1_V12N28-333_C1,0,1,0,0,0,1
GTGCTTACATCAGCGC-1_V12N28-333_C1,0,4,0,0,0,4
GCAAACGTCGCCAGGT-1_V12N28-333_C1,0,0,0,1,2,3
GAATAGCATTTAGGGT-1_V12N28-333_C1,0,3,0,1,0,4
TACTGTTTCTCTGGTA-1_V12N28-333_C1,0,0,0,0,0,0
TCCTATCATAGGTAAC-1_V12N28-333_C1,0,2,0,0,1,3
TTCGGTGGAGACGCCC-1_V12N28-333_C1,0,0,0,0,1,1
TGTTGCCGTCGTCCCA-1_V12N28-333_C1,0,1,0,0,0,1
CCAACTTGATAGATCC-1_V12N28-333_C1,0,6,0,0,0,6
CAAAGGTCATCTGAAA-1_V12N28-333_C1,0,3,0,0,0,3
CTAGCTTAATGGTCCC-1_V12N28-333_C1,0,2,0,0,0,2
AGGCCACATTGGTTAC-1_V12N28-333_C1,0,2,0,0,0,2
TTAGGATGGGAGGGTA-1_V12N28-333_C1,0,2,0,0,0,2
TATGACCTTGCGCTGG-1_V12N28-333_C1,0,1,1,1,0,3
ATATACATGTATGGTA-1_V12N28-333_C1,0,1,3,0,0,4
TGTGTGACCATGAATC-1_V12N28-333_C1,3,0,0,2,0,5
CCCACTCCACGGTATC-1_V12N28-333_C1,2,1,4,2,0,9
GGGCAGACGTCACTGC-1_V12N28-333_C1,1,0,2,0,0,3
TCAAAGAGCTATCTGT-1_V12N28-333_C1,1,0,1,3,0,5
AGATGCATCCTGTGTC-1_V12N28-333_C1,0,0,4,2,0,6
GTGAAGTCACGACTCG-1_V12N28-333_C1,0,1,0,2,2,5
TGATTCAGGTCCCGCG-1_V12N28-333_C1,0,0,1,2,0,3
CGCCACAGGTCGCGAT-1_V12N28-333_C1,0,0,0,1,1,2
TTGAATCGTTGTATAA-1_V12N28-333_C1,0,0,0,0,0,0
TGGCCAATTTGGTACT-1_V12N28-333_C1,0,1,1,2,1,5
CGACCCTTAACGCCGG-1_V12N28-333_C1,0,3,0,0,0,3
TCGGCGTACTGCACAA-1_V12N28-333_C1,0,1,1,0,0,2
GAGTAAGGCCACGGGA-1_V12N28-333_C1,1,2,0,1,0,4
ATCAGCTCGTCCACTA-1_V12N28-333_C1,0,1,0,0,0,1
AGGATCACGCGATCTG-1_V12N28-333_C1,0,2,0,1,1,4
AAATGGCCCGTGCCCT-1_V12N28-333_C1,1,1,0,0,0,2
CAGTACCAGTTTACGT-1_V12N28-333_C1,0,4,0,0,1,5
GGTCGTAAGCTCGCAC-1_V12N28-333_C1,0,1,0,0,0,1
CGTTCATGGTGCGCGT-1_V12N28-333_C1,0,2,0,0,0,2
GACTACAAAGCGGTGG-1_V12N28-333_C1,0,1,0,0,1,2
CAGCTGGCGTAACCGT-1_V12N28-333_C1,0,4,0,0,0,4
ACTCGTAACCCGTCCT-1_V12N28-333_C1,0,2,0,2,0,4
CATATGTCAGGCTACG-1_V12N28-333_C1,0,5,0,1,1,7
GCCCGACTTCTTCCCG-1_V12N28-333_C1,0,5,0,1,0,6
CTGGCATCCGAATGAG-1_V12N28-333_C1,0,4,0,1,1,6
AAGTGCGTTAGAATCT-1_V12N28-333_C1,0,3,0,1,0,4
AGAAGTGATTCGTGAT-1_V12N28-333_C1,0,2,0,1,0,3
TACCTTAAGATTTCCC-1_V12N28-333_C1,0,2,0,1,0,3
AATGACAGCAATGTCT-1_V12N28-333_C1,0,4,0,0,0,4
TCAACGCAGGAAATAA-1_V12N28-333_C1,0,2,6,0,0,8
TATTCCTCCGCCCACT-1_V12N28-333_C1,0,2,0,0,0,2
ATCAAACGAAGGTTTG-1_V12N28-333_C1,0,1,0,1,0,2
TTGATTAGCTGTTTCT-1_V12N28-333_C1,1,1,0,1,0,3
CTGCTGAGGCCACGAA-1_V12N28-333_C1,0,1,3,1,0,5
CCGTGTTAAATTCCAT-1_V12N28-333_C1,0,1,1,0,0,2
CACGTCGGCAACCTCT-1_V12N28-333_C1,0,1,1,0,1,3
GTATTCTGAGAAACGA-1_V12N28-333_C1,0,3,1,1,1,6
CGGTGCGCGTTGGTCC-1_V12N28-333_C1,0,0,1,0,1,2
GTGATTCGCCGCTCAA-1_V12N28-333_C1,0,2,0,0,0,2
GCCCGCGCGTAAACGG-1_V12N28-333_C1,1,0,1,0,0,2
AACGTACTGTGGGTAC-1_V12N28-333_C1,0,1,0,0,0,1
GAGTATGCCCGCCTTG-1_V12N28-333_C1,0,2,1,1,0,4
TGATTCTGTCGCCGGT-1_V12N28-333_C1,0,3,0,0,2,5
GGGCGGCAAATGAATT-1_V12N28-333_C1,1,1,0,1,0,3
TTCCAATCTGGCTATC-1_V12N28-333_C1,0,1,0,0,0,1
GGAACCGTGTAAATTG-1_V12N28-333_C1,0,2,0,0,0,2
TTGGTCACACTCGTAA-1_V12N28-333_C1,1,6,0,0,0,7
CGAACCCGCATGCGTC-1_V12N28-333_C1,0,2,0,0,0,2
GGGCGTCACCACGTAA-1_V12N28-333_C1,0,1,0,0,0,1
TACCAGAAGTAGGTTC-1_V12N28-333_C1,0,1,0,0,0,1
TTGGATATCGTCTACG-1_V12N28-333_C1,0,7,0,0,0,7
TAGATATGGACTGGAA-1_V12N28-333_C1,0,3,0,0,0,3
GCGACGATAGTTGTAC-1_V12N28-333_C1,0,1,0,0,0,1
CTGGATTTACACTTGA-1_V12N28-333_C1,0,4,0,0,0,4
GTTATATTATCTCCCT-1_V12N28-333_C1,0,0,0,0,0,0
TATTCCACTCAGCTCG-1_V12N28-333_C1,0,3,0,0,0,3
CTGTTACCCAATCTAG-1_V12N28-333_C1,0,3,0,0,0,3
ACGCGAAGTCAGACGA-1_V12N28-333_C1,0,5,0,0,0,5
GATAGGTAACGTTGAC-1_V12N28-333_C1,0,3,0,0,0,3
TGTTCGTATTGCGGTG-1_V12N28-333_C1,0,0,0,0,0,0
GGTCAGTGGGTCCCAC-1_V12N28-333_C1,0,3,0,0,0,3
AATTCTAGAGTTAGGC-1_V12N28-333_C1,0,1,0,0,0,1
GTTTACGTTCCATCTG-1_V12N28-333_C1,0,0,0,0,0,0
AGACCCACCGCTGATC-1_V12N28-333_C1,0,0,0,0,0,0
TCTAGCATGCCCAGAA-1_V12N28-333_C1,0,0,0,0,1,1
CCCGCAGCGCGAACTA-1_V12N28-333_C1,0,1,0,0,0,1
CTCTATTTGGCTGCAG-1_V12N28-333_C1,0,1,0,0,0,1
TTCTGCCGCGCCTAGA-1_V12N28-333_C1,0,2,0,0,0,2
ACTCCCTAGAATAGTA-1_V12N28-333_C1,0,3,0,0,0,3
CCGAACCTTCCCGGCC-1_V12N28-333_C1,0,1,0,0,0,1
TCAGACGCTATAGAAG-1_V12N28-333_C1,0,1,0,0,1,2
CAGGCGCCATGCTAGG-1_V12N28-333_C1,0,0,0,0,0,0
CACTCGAGCTGAACAA-1_V12N28-333_C1,0,1,0,1,1,3
ACAAGGAAATCCGCCC-1_V12N28-333_C1,1,0,0,0,0,1
ACCACGTGCAGCTATA-1_V12N28-333_C1,0,2,0,1,0,3
ACGGCGACGATGGGAA-1_V12N28-333_C1,0,4,1,0,1,6
TTACTAAAGGACTTTA-1_V12N28-333_C1,0,0,0,0,1,1
GGCTGAAATAGCAAAG-1_V12N28-333_C1,0,3,0,0,1,4
TTAGACGAGTCACCTC-1_V12N28-333_C1,0,1,1,1,0,3
GTAGTCGCGGGAATCA-1_V12N28-333_C1,0,2,0,0,1,3
GCAAACCCTACATTAT-1_V12N28-333_C1,0,1,0,0,1,2
GTTAAAGTAGGACTGG-1_V12N28-333_C1,0,2,0,0,1,3
ACCCTCCCTTGCTATT-1_V12N28-333_C1,0,3,0,0,0,3
CATGTCTCATTTATGG-1_V12N28-333_C1,1,0,0,0,1,2
AATAGAATCTGTTTCA-1_V12N28-333_C1,0,3,0,0,0,3
TCTCATGAGATAGGGT-1_V12N28-333_C1,0,0,0,0,3,3
ATGACTATGCGACATT-1_V12N28-333_C1,0,0,0,1,0,1
CCTAACCCAAACAAGT-1_V12N28-333_C1,0,3,0,0,1,4
AGTCAAGATGACACTT-1_V12N28-333_C1,0,2,0,0,1,3
CGGGAGCTTCAGTGTA-1_V12N28-333_C1,0,1,0,1,0,2
CCACAGTACCCATCCT-1_V12N28-333_C1,0,2,0,0,0,2
GAGCGCGCACGAGTAG-1_V12N28-333_C1,0,2,0,0,0,2
ACCAGTGCGGGAGACG-1_V12N28-333_C1,0,4,0,1,2,7
TCCTTACGACGGTCCG-1_V12N28-333_C1,0,4,0,0,0,4
TAGTCGATCACGGGTT-1_V12N28-333_C1,0,2,0,1,0,3
AGACGAAGTGCCGGTC-1_V12N28-333_C1,0,2,0,0,1,3
CGCTGGTGACTACCCT-1_V12N28-333_C1,0,2,0,0,0,2
AGGCATTGTCGTAGGG-1_V12N28-333_C1,0,2,0,0,0,2
TGGTAGAATATATGGG-1_V12N28-333_C1,0,4,0,0,0,4
TTCTTATCCGCTGGGT-1_V12N28-333_C1,0,2,0,0,2,4
AGTTTGGCACGGGTTG-1_V12N28-333_C1,0,3,0,0,1,4
GCATCGGCCGTGTAGG-1_V12N28-333_C1,0,2,0,1,1,4
ATGCGAGTCCCACCAC-1_V12N28-333_C1,0,3,0,1,2,6
TCGGCGAACCCAAACC-1_V12N28-333_C1,0,5,0,0,1,6
AGAGTAAACTTCACTA-1_V12N28-333_C1,0,0,0,0,0,0
AAGCCGAAGCGGTTTA-1_V12N28-333_C1,0,3,0,0,2,5
CCCGAGTTTCTCCGTA-1_V12N28-333_C1,0,3,0,0,0,3
AATATCGAATCAATGC-1_V12N28-333_C1,0,1,0,1,1,3
GCGCCTCCCACTCCGA-1_V12N28-333_C1,0,1,0,0,2,3
CGTTAAACTAGTTAGG-1_V12N28-333_C1,0,1,0,0,1,2
TGAGTTAAAGACATTC-1_V12N28-333_C1,0,3,0,1,2,6
AACAGGTAGTATGGAT-1_V12N28-333_C1,0,3,0,1,2,6
GAACGCGGGTCACACG-1_V12N28-333_C1,0,0,0,1,0,1
TGTTTGAGATCGTCAG-1_V12N28-333_C1,0,3,0,0,1,4
ATCTCGTGAGCGAAAC-1_V12N28-333_C1,0,2,0,0,0,2
CTGAGAAAGTTCGGCG-1_V12N28-333_C1,1,4,0,0,1,6
ATTACCACACTGCCTG-1_V12N28-333_C1,0,4,0,0,0,4
CTGCTGTCTAACGAGC-1_V12N28-333_C1,0,1,0,1,0,2
CGTGGAAGCCTCGTAC-1_V12N28-333_C1,1,6,0,1,1,9
GGACTCACAAATTAGG-1_V12N28-333_C1,0,0,0,0,0,0
CTTTGCTGTCATGGAT-1_V12N28-333_C1,0,3,0,0,2,5
GGTGTTGGGCGTCTTA-1_V12N28-333_C1,0,0,0,0,0,0
TACCATGTATTGATTT-1_V12N28-333_C1,0,1,0,0,0,1
GGTCTCCAAGTAGTGC-1_V12N28-333_C1,0,5,0,1,0,6
ATCCTTCTGAAAGAAC-1_V12N28-333_C1,0,0,0,0,0,0
CCGGAAGTTATCAGTC-1_V12N28-333_C1,0,4,0,0,1,5
TTAGAGGGATATACAG-1_V12N28-333_C1,0,0,0,0,0,0
TTGTACACCTCGAACA-1_V12N28-333_C1,0,0,0,0,0,0
GTGGGTACTGAGCGTA-1_V12N28-333_C1,0,0,3,4,0,7
CTTAAGCAGCGAGCCG-1_V12N28-333_C1,0,0,2,5,0,7
GCATTGACTTGCGGAA-1_V12N28-333_C1,0,0,2,0,0,2
CCATAACCTGTGCAGT-1_V12N28-333_C1,0,0,1,1,0,2
GGGCTACTATTTCGTG-1_V12N28-333_C1,0,0,2,2,0,4
GGCGAGCGAAACGGCA-1_V12N28-333_C1,0,0,0,2,1,3
GGAGACCATCTACATA-1_V12N28-333_C1,1,0,2,2,0,5
AGACCAAACCACACCT-1_V12N28-333_C1,0,0,1,0,0,1
CGACGCATCCGTACCT-1_V12N28-333_C1,0,1,0,2,0,3
CCTAGGTAAAGGTAGC-1_V12N28-333_C1,0,1,0,0,0,1
AGCGGCGGTTAGCGGT-1_V12N28-333_C1,0,1,0,2,1,4
CTGGACGCAGTCCGGC-1_V12N28-333_C1,0,3,0,1,0,4
AGCCTAATACCCACGT-1_V12N28-333_C1,0,2,0,2,1,5
AATCTGGCTTTCTAGT-1_V12N28-333_C1,0,2,0,0,1,3
CACCCTTGGTGAGACC-1_V12N28-333_C1,0,0,0,0,1,1
GGATCTTGACTCAACC-1_V12N28-333_C1,0,2,0,1,0,3
ACGAGGATACCACTCT-1_V12N28-333_C1,0,2,0,0,0,2
GAGTTGATGGCAATTT-1_V12N28-333_C1,0,0,0,0,0,0
GTGGCAAACAGCGGCA-1_V12N28-333_C1,0,3,0,0,1,4
GATGTAACGAACCACC-1_V12N28-333_C1,0,1,0,0,0,1
AGCCGTGGCTAAATGT-1_V12N28-333_C1,0,7,0,0,0,7
CTCCCTCCTTTCGATC-1_V12N28-333_C1,0,2,0,0,0,2
TTGGAAGAATACAGTC-1_V12N28-333_C1,1,4,0,0,0,5
AGTTAAGTCAACCGCT-1_V12N28-333_C1,0,2,0,1,0,3
CTCATGGTAATTTGCG-1_V12N28-333_C1,0,1,0,0,0,1
AAAGTAGCATTGCTCA-1_V12N28-333_C1,0,2,0,0,0,2
TTGTGGTAGGAGGGAT-1_V12N28-333_C1,0,1,2,0,0,3
AGTCGTGGGCATTACG-1_V12N28-333_C1,0,1,1,1,0,3
ACCTAAGTACCTTTCA-1_V12N28-333_C1,0,1,2,1,0,4
GTAGAGGGAGACAAGT-1_V12N28-333_C1,0,0,2,1,0,3
GATCCTCGACACTGGC-1_V12N28-333_C1,0,0,2,0,0,2
CCTACATTCACAGACG-1_V12N28-333_C1,0,0,1,0,0,1
TTGACCGTGTTAATGA-1_V12N28-333_C1,0,1,0,0,0,1
TCTGTTACCCAGCATA-1_V12N28-333_C1,0,0,0,0,0,0
CTAACTGGTCCGGTTC-1_V12N28-333_C1,0,2,1,0,1,4
AGCGACAGGAACGGTC-1_V12N28-333_C1,0,0,0,0,0,0
TAATAGAACAGAGTTA-1_V12N28-333_C1,0,0,2,0,0,2
ACAGGTGGAGGTGAGG-1_V12N28-333_C1,0,0,4,0,0,4
TGCGAGAATATTACCC-1_V12N28-333_C1,0,0,5,0,0,5
TTGCGTCGGCCAACCG-1_V12N28-333_C1,0,0,5,1,0,6
AGGCTTCCCGAAGAAG-1_V12N28-333_C1,0,3,0,0,0,3
GCGGACCGCGTTGTGG-1_V12N28-333_C1,0,1,0,0,0,1
GTAATCTGATTCTTCG-1_V12N28-333_C1,1,1,2,0,0,4
CCGCGGAATGCGTCAC-1_V12N28-333_C1,0,1,4,0,0,5
TTCCACACAGATTTGA-1_V12N28-333_C1,0,4,0,0,0,4
CTTCTATTAATGCTAG-1_V12N28-333_C1,0,1,0,0,0,1
CATTTGAGTGGTACGT-1_V12N28-333_C1,0,3,0,1,0,4
TCACAGCAAACTCGAA-1_V12N28-333_C1,0,1,0,0,0,1
CAGACGAACCTGATAC-1_V12N28-333_C1,0,1,0,0,0,1
TAGCTAGAAGGCATGA-1_V12N28-333_C1,1,7,0,0,0,8
ATCCAGAGCAACAACC-1_V12N28-333_C1,0,1,0,0,0,1
TCCGGTTCGTCCGGTC-1_V12N28-333_C1,0,4,0,0,0,4
CGCGCATGTTTGATTG-1_V12N28-333_C1,0,5,0,0,0,5
TGGCGATCAAGTTATG-1_V12N28-333_C1,0,2,0,0,0,2
CCCTTTGACAGGTCTT-1_V12N28-333_C1,1,1,0,0,0,2
CAGAGACGGTCACCCA-1_V12N28-333_C1,0,3,0,0,0,3
TAGCTCGCCTGATAAC-1_V12N28-333_C1,0,2,0,0,0,2
TTGTGTTTCCCGAAAG-1_V12N28-333_C1,0,5,0,0,0,5
TATACACAGACGCCTT-1_V12N28-333_C1,0,2,0,0,0,2
ACATTAGTTTATATCC-1_V12N28-333_C1,0,2,0,0,0,2
CCATCGCAGTTAAACT-1_V12N28-333_C1,0,1,0,0,0,1
AATTAGCGCTGCAGCG-1_V12N28-333_C1,0,3,0,0,0,3
TCCGCTTATCCCATTA-1_V12N28-333_C1,0,3,0,0,0,3
GTTTGGGCTTGTGAGC-1_V12N28-333_C1,0,4,0,0,0,4
CTTGTCAACATTCGAG-1_V12N28-333_C1,0,0,0,0,1,1
GGACCAACAGGATAAC-1_V12N28-333_C1,0,2,0,0,0,2
AAGCTAGATCGAGTAA-1_V12N28-333_C1,0,2,0,0,0,2
TACCGTGCCTCGGACC-1_V12N28-333_C1,0,5,0,1,0,6
GTAGCCAAACATGGGA-1_V12N28-333_C1,0,3,0,1,0,4
TGCCAGTACGTGGAGA-1_V12N28-333_C1,0,5,0,1,0,6
ATAAGGTGGAGAACAT-1_V12N28-333_C1,0,1,0,0,0,1
CTTTAATATTGGTCGA-1_V12N28-333_C1,0,1,0,0,0,1
TGGTTCAACGGGTAAT-1_V12N28-333_C1,0,3,0,0,0,3
GCTGCTACTGCGTAGC-1_V12N28-333_C1,0,4,0,0,0,4
CTGCACAACTACATAT-1_V12N28-333_C1,0,1,0,0,0,1
ATATTCCACATAGTGA-1_V12N28-333_C1,0,2,0,0,0,2
TGGCAAACTAAATTAC-1_V12N28-333_C1,0,4,0,0,0,4
ACCGCAATAACTGCCT-1_V12N28-333_C1,0,3,0,0,0,3
TCGCACCAGGAGGCAG-1_V12N28-333_C1,0,3,0,0,0,3
ACTTCAGGCTGATCCC-1_V12N28-333_C1,0,0,0,0,0,0
ACAAATCGCACCGAAT-1_V12N28-333_C1,0,2,0,0,0,2
TCTGATGTATTCTGTC-1_V12N28-333_C1,0,4,0,0,0,4
CTTTACCGAATAGTAG-1_V12N28-333_C1,0,0,0,0,0,0
GCAGATCCATAAGACT-1_V12N28-333_C1,0,0,0,0,0,0
TTCCTCGGACTAACCA-1_V12N28-333_C1,1,2,0,0,0,3
TTATCCGGGATCTATA-1_V12N28-333_C1,0,5,0,0,0,5
CTGGAAGACACGGTGG-1_V12N28-333_C1,1,0,0,0,1,2
GTTCGTCTAAAGAACT-1_V12N28-333_C1,0,3,0,0,0,3
GTCTATTGGTTCCGGT-1_V12N28-333_C1,0,3,0,0,0,3
CTAGGCGCCCTATCAG-1_V12N28-333_C1,0,3,0,0,1,4
AACGGACGTACGTATA-1_V12N28-333_C1,0,4,0,2,1,7
AACACACGCTCGCCGC-1_V12N28-333_C1,0,2,0,0,0,2
GCTACTATAGTAGAGT-1_V12N28-333_C1,0,2,0,2,2,6
AGCATATCAATATGCT-1_V12N28-333_C1,0,2,0,0,0,2
CGAACAGTATGGGCGT-1_V12N28-333_C1,0,2,0,0,1,3
ACAATTGTGTCTCTTT-1_V12N28-333_C1,0,0,0,0,0,0
GATCGCTACCCGATTT-1_V12N28-333_C1,0,2,0,0,0,2
ATTGCGATCAGTAACT-1_V12N28-333_C1,0,2,0,0,0,2
CAGCAGTCCAGACTAT-1_V12N28-333_C1,0,1,0,0,0,1
AGAGGCTTCGGAAACC-1_V12N28-333_C1,0,2,0,0,0,2
AAACAAGTATCTCCCA-1_V12N28-333_C1,0,1,1,0,1,3
GGCAGCAAACCTATGC-1_V12N28-333_C1,0,1,0,1,0,2
ACTAGTTGCGATCGTC-1_V12N28-333_C1,0,2,0,0,0,2
TTGGACCATCTGGCAA-1_V12N28-333_C1,0,0,0,0,1,1
CCCTCCTCGCTCGTAT-1_V12N28-333_C1,0,2,0,0,0,2
GAGCGCAAATACTCCG-1_V12N28-333_C1,1,3,0,1,0,5
ATTACATGTCAGTCTT-1_V12N28-333_C1,0,3,0,0,0,3
TTGGGACGTAAGAGTT-1_V12N28-333_C1,0,5,0,1,0,6
CTTCGGCCAATTGTTT-1_V12N28-333_C1,0,3,0,0,0,3
AGACCGCTCCGCGGTT-1_V12N28-333_C1,0,3,1,0,0,4
GACCGCGTCTGACGTG-1_V12N28-333_C1,0,4,0,0,0,4
CCAAATAACAAGATTC-1_V12N28-333_C1,0,1,0,0,1,2
TCTTTAGAGTCTAACA-1_V12N28-333_C1,0,1,0,0,0,1
CTCCCAATGAGTCGCG-1_V12N28-333_C1,0,1,0,0,0,1
TAGTCTTTCCGAATTG-1_V12N28-333_C1,0,2,0,0,0,2
GAGTAAACCGGAAAGT-1_V12N28-333_C1,0,1,0,0,0,1
GATCTCGACGCTGTGG-1_V12N28-333_C1,0,3,0,0,0,3
CTGACATAGAAATAGA-1_V12N28-333_C1,0,1,0,0,0,1
TATACCGAGTGCCACA-1_V12N28-333_C1,0,2,0,0,0,2
TCCGAACGTTGCCGCT-1_V12N28-333_C1,0,2,0,0,0,2
GCAGAAGGTAATCTCC-1_V12N28-333_C1,0,4,0,0,0,4
GGTACTAAGTGCTTTG-1_V12N28-333_C1,0,2,0,0,0,2
CAGAATATTCGTTATC-1_V12N28-333_C1,0,1,0,0,2,3
TAATCAACCAAATGGG-1_V12N28-333_C1,0,5,0,0,0,5
TCTGCTTAGAACAAGC-1_V12N28-333_C1,0,3,0,0,0,3
AACTGAGTTATACTGA-1_V12N28-333_C1,0,1,0,0,0,1
CCTCAACGATCGCTGT-1_V12N28-333_C1,0,0,1,1,0,2
CGGTACGGCAAACCCA-1_V12N28-333_C1,0,0,2,1,0,3
CAGATGTTTGTCCCAA-1_V12N28-333_C1,1,0,1,1,0,3
GTTTGTTAGCCAAGTA-1_V12N28-333_C1,2,0,4,2,0,8
ACGTGACAAAGTAAGT-1_V12N28-333_C1,0,0,2,0,0,2
TTGTCACCGCGGTATC-1_V12N28-333_C1,0,0,2,1,0,3
GATCTAACCGTATTCA-1_V12N28-333_C1,0,0,2,1,0,3
ATGGAAATTTAAGGAG-1_V12N28-333_C1,1,0,4,1,0,6
ATTGATCACCACATTT-1_V12N28-333_C1,0,0,3,2,0,5
ACTGCTCGGAAGGATG-1_V12N28-333_C1,0,2,1,1,1,5
TCTAAAGAACAGTCTC-1_V12N28-333_C1,0,1,0,1,2,4
CTGGGTTGAGTTAAAG-1_V12N28-333_C1,0,0,0,2,1,3
CCCAGTAAACTTGGGA-1_V12N28-333_C1,0,2,0,0,0,2
AGATTCACAACCGATA-1_V12N28-333_C1,0,4,0,1,0,5
AGAAGGTACACTTCAC-1_V12N28-333_C1,0,3,0,0,0,3
GCAGGAACTTAGATCT-1_V12N28-333_C1,0,5,1,1,0,7
AATCTAGGTTTACTTG-1_V12N28-333_C1,0,1,0,0,0,1
CCCGGTGTATCGGAAT-1_V12N28-333_C1,0,1,0,0,1,2
TTATCCTCAAGGAATA-1_V12N28-333_C1,0,4,0,0,0,4
AGCATCATTTCGAAAG-1_V12N28-333_C1,0,3,0,0,0,3
CGCGAGTCTGCCGGGT-1_V12N28-333_C1,0,1,0,0,0,1
TGCGTCATGACTGAGC-1_V12N28-333_C1,0,1,0,0,1,2
GTATGAAATTTCACTC-1_V12N28-333_C1,0,0,0,0,0,0
TTGGTTGCGGTGCGCG-1_V12N28-333_C1,0,2,0,0,0,2
ACAGAACTGAGAACAA-1_V12N28-333_C1,0,2,0,0,0,2
CTACTATCATAGGTTT-1_V12N28-333_C1,0,2,0,0,0,2
CCTCTATCGATTAGCA-1_V12N28-333_C1,0,1,0,0,0,1
CCGTATCTCGTCGTAG-1_V12N28-333_C1,0,4,0,0,0,4
TCACGATGTCCGTGGA-1_V12N28-333_C1,0,2,1,0,0,3
TCAACAAAGATAATTC-1_V12N28-333_C1,0,4,0,2,1,7
ATGACGCGTTCTATCC-1_V12N28-333_C1,0,1,0,0,1,2
ATTTGCGCGAGTAGCT-1_V12N28-333_C1,0,3,0,0,0,3
TTCTTGGACGATCTGC-1_V12N28-333_C1,0,1,0,0,0,1
AGACGACGATGCCGCT-1_V12N28-333_C1,0,2,0,0,0,2
GGTCTCTGAATGGACT-1_V12N28-333_C1,0,1,0,0,1,2
GCTCAATCCGTTTATT-1_V12N28-333_C1,0,0,1,2,0,3
CCAGAAAGCAACTCAT-1_V12N28-333_C1,0,1,1,0,0,2
CACCGTTAGGGATCAC-1_V12N28-333_C1,0,1,1,0,0,2
AATAACACTAGAACAA-1_V12N28-333_C1,0,0,2,0,0,2
CACCCGGTTTGTGACT-1_V12N28-333_C1,0,0,0,0,0,0
CCACCAACTTTACTGT-1_V12N28-333_C1,0,11,4,0,0,15
AACTCTCAGTGTGCTC-1_V12N28-333_C1,0,0,5,0,0,5
AAACCGTTCGTCCAGG-1_V12N28-333_C1,0,1,6,0,0,7
CAGCGATTCCCTTCAA-1_V12N28-333_C1,0,0,2,0,0,2
GCTAGCTTGAATAGCT-1_V12N28-333_C1,0,2,2,0,0,4
TTGCGGCATCAGAAAG-1_V12N28-333_C1,0,3,4,0,0,7
AATAGAACAGAGTGGC-1_V12N28-333_C1,0,1,2,1,1,5
GCCATCGAGCTGCGTG-1_V12N28-333_C1,0,1,0,0,0,1
ACACTGATCAAGGTGT-1_V12N28-333_C1,0,1,4,0,1,6
ACCAACGCTTATTTAT-1_V12N28-333_C1,0,0,5,0,0,5
GACATCGATTTATAAC-1_V12N28-333_C1,0,2,0,0,0,2
CAGACACCGATCGCTG-1_V12N28-333_C1,0,1,1,0,2,4
CCAAGAAAGTGGGCGA-1_V12N28-333_C1,1,1,0,0,0,2
GGTAGACCGTTGGGCG-1_V12N28-333_C1,0,2,2,0,0,4
TCGTTAGGAGTCCCTA-1_V12N28-333_C1,0,6,0,0,0,6
ACGGCCAACATGGACT-1_V12N28-333_C1,0,1,0,0,0,1
GTGAGTGGTACAACGC-1_V12N28-333_C1,0,3,0,0,0,3
GAGACTTCGCGACCGA-1_V12N28-333_C1,0,3,0,0,1,4
GAAGTCAGTTGCACTA-1_V12N28-333_C1,0,2,0,0,0,2
GTTTGGTAGGGTCAAC-1_V12N28-333_C1,1,6,0,0,0,7
ACGGCACTTGCTTGGG-1_V12N28-333_C1,0,2,0,0,1,3
CCTCTGTACTATTCTA-1_V12N28-333_C1,0,5,0,0,0,5
CTATTCATGTGTCCCA-1_V12N28-333_C1,0,2,0,0,0,2
GCCCGATCTGTGGTCG-1_V12N28-333_C1,0,5,0,0,0,5
TTAGAAGAACATGACT-1_V12N28-333_C1,0,2,0,2,0,4
AGGATAAAGTCGGGAT-1_V12N28-333_C1,0,1,0,0,0,1
CGGCAAACATCGTGCG-1_V12N28-333_C1,0,5,0,0,0,5
CTAGTTACAACCCGGT-1_V12N28-333_C1,0,1,0,0,0,1
TTCGACAGAGCCCGTG-1_V12N28-333_C1,0,7,0,0,0,7
AAGCATACTCTCCTGA-1_V12N28-333_C1,1,1,0,1,0,3
GACGACGATCCGCGTT-1_V12N28-333_C1,0,1,0,1,0,2
GGTAGAAGACCGCCTG-1_V12N28-333_C1,0,3,0,0,0,3
GAGATGGGAGTCGACA-1_V12N28-333_C1,0,2,0,0,0,2
AACGATAATGCCGTAG-1_V12N28-333_C1,0,2,0,0,0,2
TGGTCCCACGCTACGG-1_V12N28-333_C1,0,0,0,0,0,0
CTGCTTGGCGATAGCT-1_V12N28-333_C1,0,4,0,0,0,4
ATCGGAGACAGACGGC-1_V12N28-333_C1,0,1,0,1,0,2
TAGCGTCCGGTGTGGT-1_V12N28-333_C1,0,0,0,1,1,2
GTTGAGTCCCGCCGGT-1_V12N28-333_C1,0,0,0,0,0,0
AAATAGGGTGCTATTG-1_V12N28-333_C1,0,2,0,0,0,2
AAGTGTTTGGAGACGG-1_V12N28-333_C1,0,3,0,0,1,4
AGCACTACCTCACCAG-1_V12N28-333_C1,0,0,0,0,0,0
TGCCTTGGCCAGGCAA-1_V12N28-333_C1,0,0,0,0,0,0
TCGTCTTAGGCGTTAA-1_V12N28-333_C1,0,2,0,0,0,2
TTCTGACCGGGCTCAA-1_V12N28-333_C1,0,1,0,0,0,1
CAGAACTTAGCCCTCT-1_V12N28-333_C1,0,1,0,1,0,2
AGCTCCTTCGCACATC-1_V12N28-333_C1,0,1,0,0,0,1
ACAGGCTTGCCCGACT-1_V12N28-333_C1,0,2,0,0,0,2
GCTATACGTCTCGGAC-1_V12N28-333_C1,0,1,0,0,0,1
GAGCCAGCTACCTGTG-1_V12N28-333_C1,0,2,0,0,0,2
TGCTAAGTGTCTATTT-1_V12N28-333_C1,0,4,0,0,1,5
GTCCTACGAATAGTCT-1_V12N28-333_C1,0,0,0,0,1,1
CAGTGTCGGCTGGCCC-1_V12N28-333_C1,0,4,0,0,0,4
CTATCGACGAAATACA-1_V12N28-333_C1,0,2,0,1,0,3
CATCATTACCCTGAGG-1_V12N28-333_C1,0,0,0,0,0,0
TAAGTTGCGACGTAGG-1_V12N28-333_C1,0,3,0,0,1,4
AGTGCACGCTTAAGAA-1_V12N28-333_C1,0,5,0,0,0,5
TGTGCCGGTGCCGGAA-1_V12N28-333_C1,0,1,0,0,0,1
AGGAGGCCTTCGCGCG-1_V12N28-333_C1,0,2,0,0,1,3
TCCGCGGCCCAATGAA-1_V12N28-333_C1,0,4,0,1,0,5
TCCGTTAAGCTAATAT-1_V12N28-333_C1,0,0,0,0,0,0
AAATCTAGCCCTGCTA-1_V12N28-333_C1,0,2,0,0,0,2
CGCAGGCGATCCAAAC-1_V12N28-333_C1,0,3,0,0,0,3
CCATATGGAAACTATA-1_V12N28-333_C1,0,2,0,0,0,2
CACCGTATCCCATCCG-1_V12N28-333_C1,0,4,0,0,0,4
GGTCAAGACTACTTCG-1_V12N28-333_C1,0,1,0,0,0,1
CCCGTTTCGCAGATGT-1_V12N28-333_C1,0,1,0,1,0,2
GTTATAATACGGTGAA-1_V12N28-333_C1,0,4,0,0,1,5
ACTTGTGGATGGAACG-1_V12N28-333_C1,0,2,0,0,0,2
GTTCGCTGAGACGTCT-1_V12N28-333_C1,0,1,0,0,0,1
GACACTGGAACCCGAT-1_V12N28-333_C1,0,1,0,0,0,1
CCCAGGTCTGAAGGCT-1_V12N28-333_C1,0,7,0,0,0,7
TCTCGAGGAGGTTCGC-1_V12N28-333_C1,0,2,1,0,0,3
ACTATCTGCCCGCGTA-1_V12N28-333_C1,0,2,0,0,0,2
CCTAAATTGTATCCTA-1_V12N28-333_C1,0,2,0,0,0,2
AGAAATTATGACTCGC-1_V12N28-333_C1,0,5,0,0,0,5
TCCAGCGCTATAAGCG-1_V12N28-333_C1,0,0,0,0,0,0
TCGTGTATTGGTCACG-1_V12N28-333_C1,0,3,0,1,0,4
CCACATACTGCACCCA-1_V12N28-333_C1,0,2,0,0,0,2
GTTGCGGACGGTCAGG-1_V12N28-333_C1,0,10,0,0,0,10
GTATTTAATGGCATAA-1_V12N28-333_C1,0,0,0,0,1,1
GTCGATAGGTGACTTT-1_V12N28-333_C1,0,1,0,0,1,2
AATAATCTTCGTATCG-1_V12N28-333_C1,0,3,0,1,0,4
ATTGTTCAACGATCCG-1_V12N28-333_C1,0,0,0,0,0,0
GTGCAGCGTAGAGTAG-1_V12N28-333_C1,0,2,0,0,0,2
TGTGGTAGGGTGCCTT-1_V12N28-333_C1,0,2,0,1,0,3
TGTGGACTATCTACGT-1_V12N28-333_C1,0,1,0,0,0,1
GGCGGGCTCTAAGAGT-1_V12N28-333_C1,0,5,0,0,0,5
TGGCTTATGTATAATG-1_V12N28-333_C1,0,0,0,0,0,0
GCAAGCTGGAAACCGC-1_V12N28-333_C1,0,0,4,1,0,5
GATATCAAGCAGGAGC-1_V12N28-333_C1,3,0,4,1,0,8
CACCAATCATCCGTCT-1_V12N28-333_C1,1,0,3,1,0,5
CCACATGGCTCTTTAT-1_V12N28-333_C1,0,0,3,9,0,12
GTCCTACTCTACGGGC-1_V12N28-333_C1,0,0,6,2,0,8
CTCGAGACATACGATA-1_V12N28-333_C1,2,0,6,1,0,9
TATCAGTGGCGTAGTC-1_V12N28-333_C1,0,0,5,3,1,9
TGACAGGACAAGTCCA-1_V12N28-333_C1,0,0,6,2,0,8
TATTAACACCAAAGCA-1_V12N28-333_C1,0,0,0,1,0,1
TAGGCGATGAGGTCTC-1_V12N28-333_C1,0,0,2,0,1,3
CCGCCGGAACTTCTCG-1_V12N28-333_C1,0,1,1,1,1,4
GCCATTAGCCTCAAAC-1_V12N28-333_C1,0,4,0,1,0,5
GTTAGGCTACCCGTTT-1_V12N28-333_C1,0,0,0,1,0,1
GGGTATTCTAGCAAAC-1_V12N28-333_C1,0,2,0,0,0,2
GCCCTAGCCGTCGCGA-1_V12N28-333_C1,0,3,0,1,1,5
CAGATCCTGGTTTGAA-1_V12N28-333_C1,0,3,0,0,0,3
CTTCAGTGGTCGCCTA-1_V12N28-333_C1,0,1,0,2,0,3
GGGCAACCGCACGTGC-1_V12N28-333_C1,0,0,0,0,0,0
GACCCAATTATGATAC-1_V12N28-333_C1,0,4,0,0,0,4
GAAGCTCGGACCCGTC-1_V12N28-333_C1,0,0,0,0,0,0
CGTCGGGTCTAAGCGC-1_V12N28-333_C1,0,1,0,1,0,2
GAGGCCCGACTCCGCA-1_V12N28-333_C1,0,2,0,0,0,2
TTGCCATAGCCCGCTC-1_V12N28-333_C1,0,4,0,0,0,4
TAACATACACGCGATC-1_V12N28-333_C1,0,3,0,0,0,3
CCGACGGGCATGAGGT-1_V12N28-333_C1,0,4,0,0,0,4
AATGTGCCCGAGGTGT-1_V12N28-333_C1,0,4,0,0,0,4
AGCTGTAACCTCAATC-1_V12N28-333_C1,0,2,0,1,0,3
CGAGTGAAGGTACCAG-1_V12N28-333_C1,0,4,0,0,0,4
AGTCTCACAAGACTAC-1_V12N28-333_C1,0,4,0,0,0,4
AAATTGATAGTCCTTT-1_V12N28-333_C1,0,2,0,0,0,2
TAAGTCGCCGAGTATC-1_V12N28-333_C1,0,2,0,0,0,2
GCGGAGAAACTTCGCA-1_V12N28-333_C1,0,1,0,1,0,2
GGCAAAGGCGCCAATA-1_V12N28-333_C1,0,4,0,0,0,4
ATTTCCGGGTTCTGCG-1_V12N28-333_C1,0,2,0,0,0,2
TAAACCCAGGAGGGCA-1_V12N28-333_C1,0,2,0,1,0,3
TTCGGGCGCTAGTCTT-1_V12N28-333_C1,0,2,0,0,0,2
GTGGAGTCGGCGGTTG-1_V12N28-333_C1,0,1,0,2,0,3
GCACGCCTACTTAGAT-1_V12N28-333_C1,0,0,0,0,0,0
CAATATTCTTGACCTA-1_V12N28-333_C1,0,1,1,0,1,3
CGTTTGTGTAGAGGGT-1_V12N28-333_C1,0,1,0,1,0,2
CATAGCGTTGCCCACC-1_V12N28-333_C1,0,0,1,1,2,4
TGATACATTTAGCCGT-1_V12N28-333_C1,0,5,0,0,2,7
TTCCGGCCTTGAGGCT-1_V12N28-333_C1,0,0,0,1,0,1
CCTATACCGTCCTGTC-1_V12N28-333_C1,0,2,0,0,0,2
TCGTTGCTATCCGGTC-1_V12N28-333_C1,0,0,3,0,0,3
TGGCGACTGCTCCAAA-1_V12N28-333_C1,0,0,0,1,1,2
CAGAGGCGATGCATGA-1_V12N28-333_C1,0,0,1,0,0,1
TCACAGGAGAATAAGA-1_V12N28-333_C1,0,0,4,1,0,5
GGGTTAACATTTGAGT-1_V12N28-333_C1,0,0,4,0,0,4
GCGGGCGAGCCTTACC-1_V12N28-333_C1,0,0,7,0,1,8
TGCCAATGGGTACTCT-1_V12N28-333_C1,0,0,2,0,1,3
AGGGACTCTACGCGAC-1_V12N28-333_C1,0,1,3,0,0,4
GACGCCGTAAAGGCTA-1_V12N28-333_C1,0,1,1,0,2,4
AAAGGCTCTCGCGCCG-1_V12N28-333_C1,0,3,1,0,0,4
CTGGCTGGTTGTCAGT-1_V12N28-333_C1,0,1,0,0,1,2
ACATCCCGGCCATACG-1_V12N28-333_C1,0,0,3,0,0,3
CTCTTGTCCCGCTTGG-1_V12N28-333_C1,0,2,0,1,1,4
TACGCCTCCATTCCGA-1_V12N28-333_C1,0,1,0,0,0,1
CGGAGCAATTTAATCG-1_V12N28-333_C1,0,5,0,0,0,5
AACTAGGCTTGGGTGT-1_V12N28-333_C1,0,0,0,1,0,1
GCGTCGCCAGGGTGAT-1_V12N28-333_C1,0,2,0,0,0,2
GTTGGTCATGCTATCC-1_V12N28-333_C1,1,4,0,0,0,5
GCTGGCGGCGCATGCT-1_V12N28-333_C1,0,0,0,0,0,0
TGAGCGGAAAGTGTTC-1_V12N28-333_C1,0,4,0,0,0,4
CTTTCTGTGCGGGCTT-1_V12N28-333_C1,0,1,0,0,0,1
ATCTAATATCCTACGG-1_V12N28-333_C1,0,4,0,1,0,5
AACCTTTAAATACGGT-1_V12N28-333_C1,0,1,0,0,0,1
TTCACTCGAGCACCTA-1_V12N28-333_C1,1,5,1,0,0,7
CTGCACTCCAGTACAG-1_V12N28-333_C1,0,2,0,0,0,2
CCATTTCTACCTATTA-1_V12N28-333_C1,0,2,0,0,0,2
CAAGCGGCACATAATT-1_V12N28-333_C1,0,2,0,0,0,2
GTTAACATCACTTAAA-1_V12N28-333_C1,0,3,0,1,0,4
ATATAAATGTAGCTGC-1_V12N28-333_C1,0,1,0,0,0,1
GCCTCTATACATAGCA-1_V12N28-333_C1,0,4,0,0,0,4
GTGTCGTATAGCGTTC-1_V12N28-333_C1,0,4,0,0,1,5
ATACGTACTTAGCCAC-1_V12N28-333_C1,0,1,0,0,0,1
GCTATCATACTCATGG-1_V12N28-333_C1,0,0,0,1,0,1
TATCCAATTGGTTATC-1_V12N28-333_C1,0,3,0,0,0,3
TCTCCCTGGGCAGCGT-1_V12N28-333_C1,0,3,0,0,0,3
CCTATAATGAGTGCCC-1_V12N28-333_C1,0,2,0,0,0,2
CAATGCGAGAAGTATC-1_V12N28-333_C1,0,3,0,0,0,3
TACCAATAAAGTACCA-1_V12N28-333_C1,0,4,0,0,0,4
GCTAGGCACCACGGAG-1_V12N28-333_C1,1,2,0,0,0,3
GGTGGACTGCTCTGGC-1_V12N28-333_C1,0,3,0,1,0,4
TATTCCGAGCTGTTAT-1_V12N28-333_C1,0,1,0,1,0,2
TTGAGAAGTTTAGCAT-1_V12N28-333_C1,0,1,0,0,0,1
GTCCGGACCTGAAATT-1_V12N28-333_C1,0,2,0,1,0,3
CTGTGGTCGGGAGATA-1_V12N28-333_C1,0,0,0,0,0,0
CATGTAAGAGACATTT-1_V12N28-333_C1,0,4,0,0,0,4
CACGTTTCGTACACAC-1_V12N28-333_C1,0,5,0,0,0,5
CATCCTCTCAAAGATC-1_V12N28-333_C1,0,5,0,0,0,5
GATTAACCGAAAGCCC-1_V12N28-333_C1,0,3,0,0,0,3
AACGCTGTTGCTGAAA-1_V12N28-333_C1,0,0,0,0,0,0
TTCAGCTGGCGTGCCC-1_V12N28-333_C1,0,0,0,0,0,0
TAGAGGTTCTACTTGT-1_V12N28-333_C1,0,2,0,0,0,2
GTATCAAACGTTAGCT-1_V12N28-333_C1,0,4,0,0,0,4
AATCATGTAAAGACTC-1_V12N28-333_C1,0,1,0,0,0,1
AGTCACTAGCTCTCGA-1_V12N28-333_C1,0,2,0,0,0,2
GCGAAACGATCGGGAG-1_V12N28-333_C1,0,1,0,0,0,1
CATGGATTGTCTTCCG-1_V12N28-333_C1,0,3,0,0,0,3
ATTGGATTACAGCGTA-1_V12N28-333_C1,0,1,0,0,0,1
CACACACGCTAACGAG-1_V12N28-333_C1,0,2,0,0,0,2
CTATGGGAAGCGGAAT-1_V12N28-333_C1,0,1,0,0,1,2
TGCCTAATTGAAGATT-1_V12N28-333_C1,0,2,0,0,1,3
TGGCAATGGGACGGCG-1_V12N28-333_C1,0,1,0,0,0,1
ACCTCCGCCCTCGCTG-1_V12N28-333_C1,0,3,0,0,0,3
CGGCAATAAGATCGCC-1_V12N28-333_C1,0,0,0,0,0,0
CCTTGACCACTTTATT-1_V12N28-333_C1,0,2,0,0,0,2
TCATTTAGAAGTGTGA-1_V12N28-333_C1,0,1,0,0,0,1
CAGAATAACACACGGA-1_V12N28-333_C1,0,2,0,0,0,2
TCTGAGCAATTGACTG-1_V12N28-333_C1,0,1,0,0,0,1
CAACGTGGTGGAGTCT-1_V12N28-333_C1,0,1,0,0,2,3
CACAGTTCGCTTCCCA-1_V12N28-333_C1,0,3,0,0,0,3
TCTCTCGCCGCACATA-1_V12N28-333_C1,0,3,0,1,0,4
TGGGCAGGCCACCGCA-1_V12N28-333_C1,0,0,0,0,0,0
CTCCTGTTCAAGGCAG-1_V12N28-333_C1,0,3,0,0,0,3
TATTTGATTTGCACAG-1_V12N28-333_C1,0,5,0,0,0,5
GCCACTCCTTACGGTA-1_V12N28-333_C1,0,4,0,0,0,4
ACCGATATTTAATCAT-1_V12N28-333_C1,0,3,0,0,0,3
TTATTATCTGGAAGGC-1_V12N28-333_C1,0,3,0,0,0,3
TACATGCCGGAATTGT-1_V12N28-333_C1,0,1,0,0,0,1
GGCACTCAGCCGACCC-1_V12N28-333_C1,0,4,0,0,0,4
AAACCGGAAATGTTAA-1_V12N28-333_C1,1,4,0,0,0,5
AGACAGGCATCTCAGC-1_V12N28-333_C1,0,2,0,0,0,2
GTGGTGATGGTTTGTG-1_V12N28-333_C1,0,0,0,0,0,0
CCGATATGACGTAAGG-1_V12N28-333_C1,0,0,0,0,0,0
TCGAGTCTACGATTCG-1_V12N28-333_C1,0,0,1,2,0,3
CAATTGGGCCGCACTC-1_V12N28-333_C1,0,1,0,0,0,1
ATATCAATTCCAGCCT-1_V12N28-333_C1,0,0,1,1,0,2
TGAGGCATGTACTGTG-1_V12N28-333_C1,0,0,2,2,0,4
GACTCCTTCCAATTGA-1_V12N28-333_C1,0,0,3,1,1,5
TGGCATGAAGTTTGGG-1_V12N28-333_C1,0,0,3,2,3,8
ACGAGGTTTACAACGT-1_V12N28-333_C1,0,0,0,1,1,2
AACCCATCCCATGATC-1_V12N28-333_C1,0,2,2,2,1,7
TCGACAACTGAACCCG-1_V12N28-333_C1,0,1,1,0,0,2
TATCTTGCAATACAAC-1_V12N28-333_C1,0,1,0,2,0,3
TATTATGTTTGCCTGC-1_V12N28-333_C1,0,2,0,1,0,3
GTCAAAGAAGTGGTGT-1_V12N28-333_C1,0,2,0,0,0,2
GGGACAGAGTTACTCC-1_V12N28-333_C1,0,0,0,1,1,2
AGCAACCGAAAGTAAT-1_V12N28-333_C1,0,1,0,0,2,3
CTCTCTAACTGCCTAG-1_V12N28-333_C1,0,2,0,1,1,4
ATACGGAACGTCGTTT-1_V12N28-333_C1,0,2,0,1,0,3
TCGGTCCCGACAATAG-1_V12N28-333_C1,0,1,0,1,0,2
CGCGCAAATGTCCAGA-1_V12N28-333_C1,0,2,0,0,0,2
TCTAATACTGCCTCAG-1_V12N28-333_C1,0,2,0,1,0,3
CTCGGTTGTCGGCCCT-1_V12N28-333_C1,0,1,0,1,0,2
GGTAACCGGGAGGATA-1_V12N28-333_C1,0,1,0,1,0,2
CAGGCGCACGGTGGTC-1_V12N28-333_C1,0,1,0,0,1,2
TCATCGATGGTCCCAA-1_V12N28-333_C1,0,2,0,0,0,2
CAAAGATTATTGGGCC-1_V12N28-333_C1,0,2,0,0,0,2
ACAATGAATACGGAGA-1_V12N28-333_C1,0,3,0,1,0,4
GCTCCTGACATACTGG-1_V12N28-333_C1,0,1,0,0,0,1
GATGACAAGTAGGGCA-1_V12N28-333_C1,0,2,0,0,1,3
TACGCCGAGGGTACCC-1_V12N28-333_C1,0,2,0,0,0,2
AAGCGTCCCTCATCGA-1_V12N28-333_C1,0,2,0,0,0,2
CACTCCTATGTAAGAT-1_V12N28-333_C1,0,1,0,0,0,1
TCGAGCCAGGCAGGCC-1_V12N28-333_C1,0,1,0,1,1,3
TCGTCAAGTACGCGCA-1_V12N28-333_C1,0,2,0,0,0,2
CCCGTAGCTGGGAAGA-1_V12N28-333_C1,0,2,0,0,0,2
ACCCTATGCCATATCG-1_V12N28-333_C1,0,6,0,0,0,6
GTGGTATAGTCTGCCG-1_V12N28-333_C1,0,0,0,0,0,0
CCGGTTTGTAATTGTG-1_V12N28-333_C1,0,2,0,0,0,2
GTCGCCGTTGTGTGTT-1_V12N28-333_C1,0,5,0,1,0,6
TACTGAACAGATTTAG-1_V12N28-333_C1,0,9,0,0,0,9
TATTAACCTGACCGCG-1_V12N28-333_C1,0,6,0,0,0,6
CTGTAGCCATCTCACT-1_V12N28-333_C1,0,6,0,0,1,7
TACTATGGTTCCTCAG-1_V12N28-333_C1,0,2,0,0,0,2
GAGTCAGACCAGAATC-1_V12N28-333_C1,0,2,0,1,0,3
TAAGGCATAACATCAA-1_V12N28-333_C1,0,3,0,0,0,3
CTTCCGCTCCGTGAAG-1_V12N28-333_C1,0,1,1,0,0,2
GGGCTATGATCGATGG-1_V12N28-333_C1,0,2,0,0,0,2
GGTCGGTCGTCCACAG-1_V12N28-333_C1,0,0,1,0,0,1
GGGACCCGTATATCTT-1_V12N28-333_C1,0,0,1,0,0,1
GAAAGCAGTGCACTTT-1_V12N28-333_C1,0,0,2,0,0,2
AGCGCATAATGAATCG-1_V12N28-333_C1,0,1,0,0,0,1
GCTGCTAAGTAGTCGA-1_V12N28-333_C1,0,1,1,0,1,3
AATAGTCCGTCCCGAC-1_V12N28-333_C1,0,0,2,1,0,3
AGCAGCCAGATGAATA-1_V12N28-333_C1,0,2,2,0,0,4
CCTCGCGCTGTGCGAT-1_V12N28-333_C1,0,1,2,0,0,3
TTGTGTATGCCACCAA-1_V12N28-333_C1,0,1,1,0,1,3
TGCTCGGCGAAACCCA-1_V12N28-333_C1,0,0,0,1,0,1
CGATTAAATATCTCCT-1_V12N28-333_C1,0,1,1,0,0,2
TGCCGTGGATCGTCCT-1_V12N28-333_C1,0,0,0,0,1,1
GTGGACGCATTTGTCC-1_V12N28-333_C1,0,7,0,0,0,7
ACCCGGAAACTCCCAG-1_V12N28-333_C1,0,2,0,0,0,2
CCGCATGTGGTACGAT-1_V12N28-333_C1,0,5,0,0,0,5
GCAAACCTTGGCCATA-1_V12N28-333_C1,0,3,0,0,0,3
ATTCACTGATGTTGGA-1_V12N28-333_C1,0,5,0,0,0,5
ACTCCCTAATGCTAAA-1_V12N28-333_C1,0,1,0,1,0,2
TCCTAAATTGGGAAGC-1_V12N28-333_C1,0,2,0,0,0,2
GAACAGATTACTAAAT-1_V12N28-333_C1,0,3,0,0,0,3
ATACAGGCCCTCCAAT-1_V12N28-333_C1,0,4,0,0,0,4
CGATTCGCCTGGCTGC-1_V12N28-333_C1,0,5,0,0,0,5
TCCGCCTGTCTACAAG-1_V12N28-333_C1,0,7,0,0,0,7
CACATCTCACCGACGA-1_V12N28-333_C1,0,4,0,0,0,4
CGTCGTCCTTCGCGAA-1_V12N28-333_C1,0,4,0,0,0,4
CGTTGAATACCGCGCT-1_V12N28-333_C1,0,2,0,0,0,2
ACCAATATGCAAGTTA-1_V12N28-333_C1,0,4,0,0,0,4
ACGGATGGTGCGGATA-1_V12N28-333_C1,0,5,0,0,0,5
CACCCTAACAAGATCT-1_V12N28-333_C1,0,2,0,0,0,2
AAGCTCTTTCATGGTG-1_V12N28-333_C1,0,3,0,0,0,3
CATGGGTATGCCTTAT-1_V12N28-333_C1,0,2,0,0,0,2
GCGCGTCATTGGTACA-1_V12N28-333_C1,0,1,0,0,0,1
TCTGAAGCACGTGGTC-1_V12N28-333_C1,0,2,0,0,0,2
AAGTTCACTCCAAGCT-1_V12N28-333_C1,0,3,0,0,0,3
TTGGACCTATAACAGT-1_V12N28-333_C1,0,4,0,0,0,4
ATCAGCCTCATGCTGC-1_V12N28-333_C1,0,4,0,0,1,5
AGTACTCTTATGCCCA-1_V12N28-333_C1,0,4,0,0,0,4
GCGCTTAAATAATTGG-1_V12N28-333_C1,0,6,0,0,0,6
TTGTGAACCTAATCCG-1_V12N28-333_C1,0,4,0,1,0,5
AGTCGTCGACCACCAA-1_V12N28-333_C1,0,4,0,0,0,4
TCCTTTAAATCCGCTT-1_V12N28-333_C1,0,5,0,0,0,5
ACTGAAACGCCGTTAG-1_V12N28-333_C1,0,4,0,0,0,4
GCACACACTGGTAGCC-1_V12N28-333_C1,0,2,0,0,0,2
TAAGGGCCTGTCCGAT-1_V12N28-333_C1,0,3,0,0,0,3
GCTAGAGTAGAGATGT-1_V12N28-333_C1,0,0,0,0,0,0
CACAGGGCCATATAGT-1_V12N28-333_C1,0,2,0,0,0,2
CCATGCCCTAGATTTC-1_V12N28-333_C1,0,2,1,0,1,4
TCGCGTAGCAGTGTCC-1_V12N28-333_C1,0,1,0,0,0,1
GACGAGGCTAATAAAC-1_V12N28-333_C1,0,1,0,0,0,1
CTACACTCGCAGATGG-1_V12N28-333_C1,0,3,0,0,0,3
ACGCATACGTTTACTA-1_V12N28-333_C1,0,3,0,0,0,3
GGAGCAACATTTCAAG-1_V12N28-333_C1,0,3,0,0,0,3
CGAGAGGGTAGCCGCG-1_V12N28-333_C1,0,2,0,0,0,2
TCGTGTTCGACCACAA-1_V12N28-333_C1,0,1,0,0,0,1
TCTACCCAATAGAGAG-1_V12N28-333_C1,0,2,0,0,0,2
ATAAACGTTGCACCAC-1_V12N28-333_C1,0,2,0,0,0,2
TCAACTGCAGAGTCAG-1_V12N28-333_C1,0,4,0,1,0,5
AGCTCCATATATGTTC-1_V12N28-333_C1,0,3,0,0,0,3
GTAACATCTAAGATAA-1_V12N28-333_C1,0,1,0,0,0,1
CCGACAATAGGCCGCC-1_V12N28-333_C1,0,4,0,0,0,4
ATGCTTAGGAGTTGAT-1_V12N28-333_C1,0,0,0,0,0,0
AACCCGAGCAGAATCG-1_V12N28-333_C1,0,2,0,0,0,2
CGGGTTTGTTAGGGCT-1_V12N28-333_C1,0,3,0,0,0,3
AGGCACGTGACTGTCC-1_V12N28-333_C1,0,2,0,0,0,2
GACAAGAGATGAGATT-1_V12N28-333_C1,0,0,0,0,0,0
AGCCCTTGGACATCCC-1_V12N28-333_C1,0,4,0,0,0,4
GCAGTTCGATCCGAGC-1_V12N28-333_C1,0,2,0,0,0,2
TCGAGGGCAACAGACG-1_V12N28-333_C1,0,3,0,0,0,3
ACTTTGTCGACGCACT-1_V12N28-333_C1,0,2,0,0,0,2
GAGTATCAAAGTTACA-1_V12N28-333_C1,0,6,0,0,0,6
CCAGGCTGGCGTCTGA-1_V12N28-333_C1,0,1,0,0,0,1
GGACTCTTCCGGTTGA-1_V12N28-333_C1,0,1,0,0,0,1
TCCCAGCACACGACAT-1_V12N28-333_C1,0,0,0,0,0,0
GCTCCATGAGTGCAGA-1_V12N28-333_C1,0,3,0,0,0,3
GCAGTGCGGGCGGATG-1_V12N28-333_C1,0,5,0,0,0,5
GCGTTCTGACTAAGCG-1_V12N28-333_C1,0,2,0,0,0,2
GATGCCTTCTGCGGCA-1_V12N28-333_C1,0,0,0,0,0,0
ACCGGTCAGGTACACC-1_V12N28-333_C1,0,1,3,0,0,4
GTGGAGCGTTTACCGA-1_V12N28-333_C1,0,1,0,2,0,3
AGGCGGTTTGTCCCGC-1_V12N28-333_C1,1,2,0,1,0,4
TCCCTGGCGTATTAAC-1_V12N28-333_C1,0,1,2,0,0,3
AAACACCAATAACTGC-1_V12N28-333_C1,0,3,2,2,0,7
TGGACGCAATCCAGCC-1_V12N28-333_C1,0,1,0,1,0,2
GGAACCTTGACTCTGC-1_V12N28-333_C1,0,3,1,1,0,5
GTATCTCAGTCTTGAC-1_V12N28-333_C1,0,3,0,0,1,4
GCTGAATCTTCCAATC-1_V12N28-333_C1,0,1,0,0,1,2
AGATGCAAGACGTGCA-1_V12N28-333_C1,0,3,0,0,0,3
TTAAGGCCCGTACTTT-1_V12N28-333_C1,0,1,0,0,0,1
AGTATGCTGGAGACCA-1_V12N28-333_C1,0,4,0,1,0,5
GCGGCAAAGTATTGCC-1_V12N28-333_C1,0,1,0,0,1,2
GCGCAAATATATTCAA-1_V12N28-333_C1,0,3,0,1,0,4
GAAGAAACGATATTGT-1_V12N28-333_C1,0,2,1,0,0,3
GGACCTCTAGGCCGCC-1_V12N28-333_C1,0,4,0,0,0,4
AACAGCTGTGTGGCAA-1_V12N28-333_C1,0,3,0,0,1,4
TCGAATATCCCGCAGG-1_V12N28-333_C1,0,1,0,1,0,2
GCGACCCAACCATCTG-1_V12N28-333_C1,0,0,0,1,1,2
AGAGAAGGAGTACAAT-1_V12N28-333_C1,0,2,0,0,0,2
GGCTCCTCCACCTGTT-1_V12N28-333_C1,0,3,0,1,0,4
TCAGTGTATACGTCAT-1_V12N28-333_C1,0,1,0,0,0,1
ATTATTATGTCCGTCA-1_V12N28-333_C1,0,1,0,0,0,1
TTAGGTCATAACCGAC-1_V12N28-333_C1,0,2,0,1,1,4
AAGATGGCACCGGACC-1_V12N28-333_C1,0,0,0,0,0,0
CTACAAGAAATAACCC-1_V12N28-333_C1,0,4,0,0,0,4
ACTATTTCCGGGCCCA-1_V12N28-333_C1,0,3,3,0,1,7
TTGTTTCACATCCAGG-1_V12N28-333_C1,0,1,0,0,0,1
CGCTGTGTGGATGTTG-1_V12N28-333_C1,0,6,0,0,0,6
TCAACATAGCGCCCTA-1_V12N28-333_C1,0,1,0,1,0,2
GGCCGTTTGGGTTTCA-1_V12N28-333_C1,1,0,0,0,0,1
TACTCTTTCGTCTTCA-1_V12N28-333_C1,1,3,0,0,0,4
TTCGCGCGCCATACGA-1_V12N28-333_C1,0,2,0,0,0,2
CGGAAAGAATCAAACG-1_V12N28-333_C1,0,2,0,0,0,2
AGGCAGGGAGCGTACT-1_V12N28-333_C1,0,0,0,0,0,0
CCTTTAAGGGAGCACT-1_V12N28-333_C1,0,2,0,0,0,2
CGCCCAGCACGCCTAG-1_V12N28-333_C1,0,2,0,0,0,2
AGTATTTGGCACGACC-1_V12N28-333_C1,0,3,0,0,0,3
TATCCGCACCGTCGGG-1_V12N28-333_C1,0,0,0,0,0,0
ACCCGTGTCATCAGTA-1_V12N28-333_C1,0,3,0,1,0,4
CAACTGCTCATCCGAT-1_V12N28-333_C1,0,0,0,2,0,2
CCGGAGCGTACTTTCT-1_V12N28-333_C1,0,1,1,1,0,3
TACCGTAGGTTAACTA-1_V12N28-333_C1,0,1,0,1,0,2
TGAGGAGTGCCAGCTT-1_V12N28-333_C1,0,1,2,0,0,3
CCAGTCTTGTCATAGA-1_V12N28-333_C1,0,0,2,0,0,2
GGGCAGAGCAATCGTT-1_V12N28-333_C1,0,0,0,0,0,0
TACCAAATAGCCCAGA-1_V12N28-333_C1,0,0,2,3,0,5
TACCTACTCCCAGTAT-1_V12N28-333_C1,0,1,1,0,0,2
TGTGAGACTAGCCCAA-1_V12N28-333_C1,0,0,3,0,0,3
ATACCTAACCAAGAAA-1_V12N28-333_C1,0,0,2,1,0,3
GTCGGGAAGCAGAAAC-1_V12N28-333_C1,0,0,2,0,0,2
AATTAACGGATTTCCA-1_V12N28-333_C1,0,0,2,0,0,2
GAACCCTCTGTGTTCT-1_V12N28-333_C1,0,0,4,0,0,4
ATATAAAGCGCTCGTG-1_V12N28-333_C1,0,0,1,1,0,2
CCTGGTCGAATGTGGG-1_V12N28-333_C1,0,0,2,0,1,3
CTAGGTTCGGACGTGA-1_V12N28-333_C1,0,0,0,0,0,0
TCGGGAGACAGCGTAC-1_V12N28-333_C1,0,0,2,0,0,2
CATAAGAAGCTTGGCT-1_V12N28-333_C1,0,1,0,0,0,1
AAGCACCCTGCGTATC-1_V12N28-333_C1,0,3,0,0,0,3
AGTTTGCACCTGCCTC-1_V12N28-333_C1,0,2,0,0,1,3
GACTGCAAATCGAGCT-1_V12N28-333_C1,0,1,0,0,0,1
GTGTATATCAGCGGGC-1_V12N28-333_C1,0,1,0,0,0,1
CTTCAACTCCACTTGG-1_V12N28-333_C1,0,1,0,0,0,1
ACTTACGCATCCACGC-1_V12N28-333_C1,0,3,0,0,0,3
CATGAGATGCACTCTC-1_V12N28-333_C1,0,2,3,0,1,6
GAGCACCTGTGTCCAG-1_V12N28-333_C1,0,4,1,0,1,6
CGCGACCGCGACAGAT-1_V12N28-333_C1,0,1,0,0,0,1
GTCCCGCGACGTTATG-1_V12N28-333_C1,0,0,0,0,0,0
GCAGTGTGGCTATAGG-1_V12N28-333_C1,0,4,0,0,0,4
ATACTGCCTTACACCG-1_V12N28-333_C1,0,3,0,0,0,3
TACAGAAACGGTGGGC-1_V12N28-333_C1,0,3,0,0,0,3
GGCGCGGAGATCTTTC-1_V12N28-333_C1,0,2,0,0,0,2
CGTTAATGTCCCGACG-1_V12N28-333_C1,0,3,0,0,0,3
GCTAACTGAAGTCTGA-1_V12N28-333_C1,0,2,0,0,0,2
AGTGATAACCTGCGCG-1_V12N28-333_C1,0,1,0,0,1,2
TATGATCTTCTCTTTA-1_V12N28-333_C1,0,5,0,0,0,5
TGTACCTACACGAGGG-1_V12N28-333_C1,0,4,0,0,0,4
ATATCGTTCCTCGAAC-1_V12N28-333_C1,0,1,0,0,0,1
CGGCGCCATCAATCCC-1_V12N28-333_C1,0,6,0,0,0,6
CCTGTTTGAAGACACG-1_V12N28-333_C1,0,2,0,0,0,2
GCCACTCAGAGCGCGA-1_V12N28-333_C1,0,3,0,0,0,3
TCGGCTTGTATCGACG-1_V12N28-333_C1,0,0,0,0,0,0
TAGATGGTTCCTTACT-1_V12N28-333_C1,0,2,0,0,1,3
ATCGTTAGCTAGCGGA-1_V12N28-333_C1,0,6,0,0,0,6
ACAGCGACATTCTCAT-1_V12N28-333_C1,0,1,0,0,0,1
ATTCAACCATTTAAGG-1_V12N28-333_C1,0,1,0,0,0,1
CACTCTTCTGCTAGCC-1_V12N28-333_C1,0,3,0,0,0,3
CTAACTGATAATCGCC-1_V12N28-333_C1,0,4,0,0,0,4
TGATGTCAATTAAGTG-1_V12N28-333_C1,0,2,0,0,0,2
CGCCGTTCAGCATAGT-1_V12N28-333_C1,0,0,0,0,0,0
ATACTACCCGTACCAC-1_V12N28-333_C1,0,2,0,0,0,2
CCACTGTTTGGATTAA-1_V12N28-333_C1,0,3,0,1,0,4
CACTACGGGAGCTGCC-1_V12N28-333_C1,0,2,0,0,0,2
GACCAAACGTTGACTG-1_V12N28-333_C1,0,3,0,0,0,3
AAGAGGCCCTTTGGAA-1_V12N28-333_C1,0,1,0,0,0,1
ACACGTAGGCCACAAG-1_V12N28-333_C1,0,1,0,0,0,1
TACTCTTACTTTACTG-1_V12N28-333_C1,0,2,1,0,0,3
AGAGCCGCCGAGATTT-1_V12N28-333_C1,1,2,0,0,0,3
GGCCTGCTTCTCCCGA-1_V12N28-333_C1,0,2,0,0,0,2
TCAAGCGCGGACGGTA-1_V12N28-333_C1,0,2,0,0,0,2
ACACTGGGACAGTCGT-1_V12N28-333_C1,0,2,0,0,0,2
TGTGTAGTAGCACGTG-1_V12N28-333_C1,0,3,0,0,0,3
CTAGCCACAGGCGAGC-1_V12N28-333_C1,0,1,1,0,0,2
CTATCGCGTAGAGAAC-1_V12N28-333_C1,0,1,0,0,0,1
GTTCCCGTAAACATAT-1_V12N28-333_C1,0,1,0,0,0,1
TCTTTCCTTCGAGATA-1_V12N28-333_C1,0,1,0,0,0,1
ATATTGGAGAGGCCTT-1_V12N28-333_C1,0,1,0,0,0,1
AGGCGATAACTGGCGT-1_V12N28-333_C1,0,3,0,0,1,4
ACCCGGAGCACCACAA-1_V12N28-333_C1,0,0,0,0,0,0
TGAGCTCAACTGTATA-1_V12N28-333_C1,0,2,0,0,0,2
ACGACCCATGAGTTGC-1_V12N28-333_C1,0,3,0,0,0,3
CGGTCAGTCCATATTT-1_V12N28-333_C1,0,2,0,0,0,2
TCCGGCTGTCGGGTCG-1_V12N28-333_C1,0,1,0,0,0,1
GCTGGTTTAGGCCATA-1_V12N28-333_C1,0,0,0,0,0,0
TGTCGTTATCACATAT-1_V12N28-333_C1,0,0,0,0,0,0
ACACATGATCAAATCT-1_V12N28-333_C1,1,0,2,0,0,3
TATCCATCTCGGTTAG-1_V12N28-333_C1,0,0,4,0,0,4
CTCGTCGAGGGCTCAT-1_V12N28-333_C1,0,1,0,1,0,2
ATCAATGCCGTGGCTG-1_V12N28-333_C1,0,0,1,2,0,3
GAAACATAGGAAACAG-1_V12N28-333_C1,0,2,0,1,0,3
TAATAGGTCACCAGAA-1_V12N28-333_C1,0,1,0,2,0,3
CACCAGTCAGCATGCA-1_V12N28-333_C1,0,1,0,2,0,3
GAGCGCTGTTAGGTAA-1_V12N28-333_C1,0,0,1,0,0,1
CCCTATGTAGAGCAGA-1_V12N28-333_C1,0,3,0,1,0,4
GATCGCTATATCTCAG-1_V12N28-333_C1,0,1,0,0,0,1
AAGGGACTATGCATTC-1_V12N28-333_C1,0,2,1,3,1,7
CTCGGGTTCTCTGGCC-1_V12N28-333_C1,0,2,0,0,0,2
TATATATCGAGAAATG-1_V12N28-333_C1,0,1,0,0,0,1
ACCCGAGCGAAATTAC-1_V12N28-333_C1,0,1,2,1,0,4
TTGTTTCATTAGTCTA-1_V12N28-333_C1,0,1,0,0,1,2
ATGGGACCTGCTGAAC-1_V12N28-333_C1,0,0,1,0,0,1
TGCGACGGCCGAACGT-1_V12N28-333_C1,0,3,0,1,1,5
AGCTAACAAGCAATGT-1_V12N28-333_C1,0,3,0,0,0,3
CGTGTCTCGTTACGAC-1_V12N28-333_C1,0,2,0,1,0,3
CTAAATCCGGTGTACA-1_V12N28-333_C1,0,0,0,0,0,0
GAATAGTGCTCGATTA-1_V12N28-333_C1,0,3,0,0,0,3
AACAATACATTGTCGA-1_V12N28-333_C1,0,2,0,1,2,5
CACATCGTGCACGCGC-1_V12N28-333_C1,0,2,0,0,0,2
ACCGTGACCACGTGGG-1_V12N28-333_C1,0,1,1,2,0,4
CCCAATGAGATTTGCA-1_V12N28-333_C1,0,2,0,1,0,3
TCAGCAGTAGGCCCTG-1_V12N28-333_C1,0,3,0,0,0,3
CTACTCAAGGTATAGT-1_V12N28-333_C1,0,1,0,1,0,2
TAGTAGCTTATACCAG-1_V12N28-333_C1,0,1,0,1,0,2
ACGTTCGTTCAGGAAA-1_V12N28-333_C1,0,1,0,1,0,2
TTAGAATAAGGGTCGG-1_V12N28-333_C1,0,0,0,2,0,2
TTCTAGAAAGTCTTAT-1_V12N28-333_C1,0,3,0,0,0,3
CCTTCAGTTAAAGTGA-1_V12N28-333_C1,0,1,1,0,0,2
TAGCTAGTGATGATGG-1_V12N28-333_C1,0,1,1,0,0,2
AGCCCGGTAGCCTGTA-1_V12N28-333_C1,1,0,5,0,0,6
TACCTCAGTTGTCTGT-1_V12N28-333_C1,0,1,0,0,0,1
GACGGGTTGGCCCGTA-1_V12N28-333_C1,0,0,2,3,0,5
GAAACCTATACAAATG-1_V12N28-333_C1,0,1,1,0,0,2
TCCACCTCTAGCCTTT-1_V12N28-333_C1,0,3,0,1,0,4
AAGACCCAACTGAACA-1_V12N28-333_C1,0,2,0,5,0,7
CATACACGGTTCCCAC-1_V12N28-333_C1,1,1,1,3,0,6
ACTACGCGTTAGAATT-1_V12N28-333_C1,0,1,0,2,0,3
CTTGGCCAAGCTGGGA-1_V12N28-333_C1,0,2,1,0,0,3
TTACCCTAGGGATTGG-1_V12N28-333_C1,0,0,0,1,0,1
TTCGCACTGTACGACA-1_V12N28-333_C1,0,0,1,0,0,1
TAGGTGTTCCACAGAT-1_V12N28-333_C1,0,2,1,1,0,4
GAAGCCTGCACATTCC-1_V12N28-333_C1,0,0,1,2,0,3
GGCTTTCAATAAGGGT-1_V12N28-333_C1,0,0,2,2,0,4
TCCAGGGTATATACGA-1_V12N28-333_C1,0,5,4,2,0,11
CTCGCCGAATGTAGGG-1_V12N28-333_C1,0,0,0,1,0,1
AGGAAGCTGTCCGCCG-1_V12N28-333_C1,0,4,0,0,0,4
GTCTCAAGGCCCGGCT-1_V12N28-333_C1,0,0,3,0,0,3
ACCGACACATCTCCCA-1_V12N28-333_C1,0,0,0,3,0,3
TATACGCGTCATCACT-1_V12N28-333_C1,0,0,4,0,0,4
ATCTGGGCTGTTCTTG-1_V12N28-333_C1,1,2,0,7,0,10
TCAAATTTGAGACTCA-1_V12N28-333_C1,0,1,3,0,0,4
GTTAAGGGTGCGATGT-1_V12N28-333_C1,0,1,3,3,0,7
AGCAAAGGCCGCTAGT-1_V12N28-333_C1,0,0,0,0,0,0
TTATAGGTAATTGTCT-1_V12N28-333_C1,0,0,4,2,0,6
TTGTGCAGCCACGTCA-1_V12N28-333_C1,0,0,1,0,0,1
ACGGACTCTCAAAGCG-1_V12N28-333_C1,0,0,4,0,0,4
ATGCTCTGGCGCGGTA-1_V12N28-333_C1,0,0,2,0,0,2
ATAATCTTGGAGAACC-1_V12N28-333_C1,0,0,3,0,0,3
CTCATTGCTCTAACAA-1_V12N28-333_C1,0,1,3,0,0,4
TAGGTGACGATAACCT-1_V12N28-333_C1,0,0,0,0,0,0
CGGATCCTCAAGGACT-1_V12N28-333_C1,0,0,3,0,0,3
GGGCGTGGTTTCCCAG-1_V12N28-333_C1,0,0,1,0,0,1
TGGCTATGTGACATAC-1_V12N28-333_C1,0,0,2,0,0,2
CTTAGTGTAGTAGCAT-1_V12N28-333_C1,0,0,1,0,0,1
GGATTGCTGTGACTCC-1_V12N28-333_C1,0,0,0,0,1,1
ACTTCCATGCGGGACA-1_V12N28-333_C1,0,0,1,0,0,1
ACTCAAGTGCAAGGCT-1_V12N28-333_C1,0,0,1,0,0,1
ACAAGGATGCTTTAGG-1_V12N28-333_C1,0,2,1,0,0,3
TTGAACGACGTGCTGA-1_V12N28-333_C1,0,3,0,0,0,3
ATTCATCGTTGAGGCA-1_V12N28-333_C1,0,0,2,0,1,3
TGCAACCCATCTGCGG-1_V12N28-333_C1,0,1,4,0,0,5
AGTGCTAAACACAGCA-1_V12N28-333_C1,0,3,0,0,0,3
AACTCCAGAGCGTGTT-1_V12N28-333_C1,0,2,0,0,1,3
TCTCCACAAGTTGAAT-1_V12N28-333_C1,0,2,0,0,0,2
CTTTGCATCGCTCTTG-1_V12N28-333_C1,0,0,0,0,0,0
TCACAAACCGAGGTAC-1_V12N28-333_C1,0,4,0,0,0,4
CCGTAGGAAATCCCTG-1_V12N28-333_C1,0,2,0,0,0,2
AAACATTTCCCGGATT-1_V12N28-333_C1,0,1,0,0,0,1
GCCTCCGACAATTCAC-1_V12N28-333_C1,0,1,0,0,0,1
TCTGCATACCTTGCTT-1_V12N28-333_C1,0,0,0,0,0,0
ACCCATTTGTCCCTCT-1_V12N28-333_C1,0,3,0,0,0,3
CTGCAGAGAATCAGAG-1_V12N28-333_C1,0,1,0,0,0,1
GGAAACTAAATGGGCC-1_V12N28-333_C1,0,0,0,0,0,0
CAACCTACCGAGCAGT-1_V12N28-333_C1,0,1,0,0,0,1
CCGTAGGGTTGTTTAC-1_V12N28-333_C1,0,1,0,0,3,4
GGTTTGTGACCTGAGG-1_V12N28-333_C1,0,3,0,0,0,3
TAACCTAGGGAGTCCA-1_V12N28-333_C1,0,0,0,0,0,0
TTCCATCGACAGCGTG-1_V12N28-333_C1,0,0,0,0,0,0
ATCTCCCACGGAATAT-1_V12N28-333_C1,0,0,0,0,0,0
GTTTCAAACGAGTTGT-1_V12N28-333_C1,0,5,0,0,0,5
GGAACTTTGGCGATTA-1_V12N28-333_C1,0,2,0,0,0,2
CTGCAAGCACGTTCCG-1_V12N28-333_C1,0,2,0,0,0,2
CACAGTCCCGCTTCGC-1_V12N28-333_C1,0,4,0,0,0,4
TACGCTCGGTATTGGA-1_V12N28-333_C1,0,1,0,0,0,1
CTGGTAAAGTGTGGGC-1_V12N28-333_C1,0,3,0,0,0,3
CAACCAGTGGCCTACC-1_V12N28-333_C1,0,5,0,0,0,5
TCTTCGCGGTGAGAGG-1_V12N28-333_C1,0,0,0,0,0,0
TTCGGGTTGCCACGGG-1_V12N28-333_C1,0,3,0,0,0,3
ACCGATAGGCATAACC-1_V12N28-333_C1,0,4,0,0,0,4
CTTATAGATGGCTGTT-1_V12N28-333_C1,0,1,1,0,0,2
AGACGCCCACTTCGCC-1_V12N28-333_C1,0,0,0,0,0,0
AGGTCGCCTCCCAACA-1_V12N28-333_C1,0,2,0,0,0,2
CCTCACGTCAGCTAAT-1_V12N28-333_C1,0,3,0,0,0,3
CCACCTGTATGGAATA-1_V12N28-333_C1,0,1,0,0,0,1
GGACTCGAAGCTTTCA-1_V12N28-333_C1,0,3,0,0,0,3
AAGCCGGAGAGCAGGA-1_V12N28-333_C1,0,0,0,0,1,1
GCCTATCAGGTAAGAT-1_V12N28-333_C1,0,2,0,0,0,2
TCAGAGTGTGAGCATG-1_V12N28-333_C1,0,1,0,0,0,1
CGAATGAAGTCATTGC-1_V12N28-333_C1,0,0,1,1,1,3
AAGGGAACGACTGGCT-1_V12N28-333_C1,0,0,6,1,0,7
CGAATCTGCTCGACGC-1_V12N28-333_C1,0,0,0,0,0,0
CCTATGGCTCCTAGTG-1_V12N28-333_C1,0,0,0,0,0,0
CGTCGCTTGGTTATAC-1_V12N28-333_C1,0,0,0,2,0,2
TGCTTAGAGAGAATGC-1_V12N28-333_C1,0,3,1,4,1,9
GATTGCTCCAGTTGCA-1_V12N28-333_C1,0,1,1,3,1,6
CGTGCTTCTACCTAAA-1_V12N28-333_C1,1,2,1,0,0,4
ACTCCAATATCATCAT-1_V12N28-333_C1,0,0,2,0,0,2
GCCGACCCACGACTGC-1_V12N28-333_C1,0,3,0,0,0,3
GAGGGTAGTAACAAAG-1_V12N28-333_C1,0,2,0,1,0,3
GGCCGAGACTCTGGTG-1_V12N28-333_C1,0,1,0,0,0,1
TATATAGGGCTTTACG-1_V12N28-333_C1,0,0,0,1,1,2
TGCCGGATGTACGAGC-1_V12N28-333_C1,0,2,1,1,1,5
AGGTAGATCGAGATAT-1_V12N28-333_C1,0,5,0,2,0,7
GATCAACATAAAGGGA-1_V12N28-333_C1,0,1,1,1,0,3
TAACAGCGTTTGTGCT-1_V12N28-333_C1,0,2,0,1,0,3
CTATAGGCGTTGATGT-1_V12N28-333_C1,0,2,0,2,0,4
GGTTTAATTACCATCG-1_V12N28-333_C1,0,3,1,0,0,4
CTCTTCTGGAAGTTAG-1_V12N28-333_C1,0,3,0,0,1,4
ATCTGACATGGAAGGA-1_V12N28-333_C1,0,3,0,0,0,3
TACGTACTAGTGCTGA-1_V12N28-333_C1,0,2,0,2,1,5
ATGACTATCAGCTGTG-1_V12N28-333_C1,0,1,1,1,0,3
CTTTGGGATTGTTGCA-1_V12N28-333_C1,0,2,0,0,0,2
AGACTGTTACCGGGTC-1_V12N28-333_C1,0,1,0,2,1,4
TCCTAACCGTCGGGCA-1_V12N28-333_C1,0,0,2,0,0,2
ACGCAAACTAATAGAT-1_V12N28-333_C1,0,1,0,2,0,3
AAGTGAGTCGGGTTTA-1_V12N28-333_C1,0,0,1,1,0,2
TAAAGCGGTATTTCCA-1_V12N28-333_C1,0,0,2,2,0,4
CTCCTCCAGCTCACAC-1_V12N28-333_C1,0,1,2,3,0,6
CGGTCCGTCGCAAGCC-1_V12N28-333_C1,1,0,1,1,0,3
CCTATATTTGTCCTGG-1_V12N28-333_C1,0,1,0,3,0,4
TCCAATAAAGGCTACC-1_V12N28-333_C1,0,4,2,1,0,7
AAAGGCTACGGACCAT-1_V12N28-333_C1,0,2,1,0,0,3
CGTGACCAGTCCTCTG-1_V12N28-333_C1,0,4,2,4,0,10
GATCTGCTATCTAAGG-1_V12N28-333_C1,0,4,0,1,0,5
CGAATGACGCATAATG-1_V12N28-333_C1,0,3,0,4,0,7
GCTCAATGTAATACCG-1_V12N28-333_C1,0,2,0,1,0,3
CTATGCCCGAATGCAA-1_V12N28-333_C1,0,2,0,3,0,5
CACAGGGCCGTTGTCA-1_V12N28-333_C1,0,3,0,2,0,5
TCAATACGCCGTCATG-1_V12N28-333_C1,1,4,0,1,0,6
AGCGGACACTTCGTAG-1_V12N28-333_C1,1,3,0,4,0,8
ATACGTTATGCACGGA-1_V12N28-333_C1,0,3,0,2,0,5
GAGTAGATACTAGTTG-1_V12N28-333_C1,0,1,0,1,0,2
CCAGCTCGAACGCATT-1_V12N28-333_C1,0,0,1,3,0,4
TGCTTCCCAAGCAGTA-1_V12N28-333_C1,0,5,0,6,0,11
GTAGACACGCCTGACT-1_V12N28-333_C1,0,3,0,1,0,4
CTCACATTTACTAAAT-1_V12N28-333_C1,0,1,1,4,0,6
GAATGCGAATCGGTTC-1_V12N28-333_C1,1,3,0,2,0,6
TAAGGCCCGTCACCCT-1_V12N28-333_C1,0,2,0,4,0,6
GAGTATGCGCGTGCAT-1_V12N28-333_C1,1,3,0,1,0,5
ATCCACATCGACAGAA-1_V12N28-333_C1,0,1,0,3,0,4
TAGACGAAACGCCAAT-1_V12N28-333_C1,1,1,0,5,0,7
CAGCAGTCTGTGCTGC-1_V12N28-333_C1,0,1,2,2,0,5
CTCACTGTGATACTTA-1_V12N28-333_C1,1,3,0,0,0,4
TTAATTGCTTTGGGTG-1_V12N28-333_C1,0,3,0,3,0,6
GTAGTCTACGATATTG-1_V12N28-333_C1,0,0,1,2,0,3
TTGCCGCTTTCTAGTA-1_V12N28-333_C1,0,1,5,7,0,13
GAACCTTTAACGATCC-1_V12N28-333_C1,0,2,0,3,0,5
TGGACCAATCTAAGAT-1_V12N28-333_C1,0,3,0,3,0,6
CTAGTAGAAAGGGATT-1_V12N28-333_C1,0,2,0,4,0,6
AACCTCGCTTTAGCCC-1_V12N28-333_C1,0,0,4,1,0,5
GAGTGTCAACCAGAAA-1_V12N28-333_C1,0,0,0,6,0,6
GTGATCCTTGTCATGA-1_V12N28-333_C1,0,0,1,0,0,1
CTCAACTAACCCGGAT-1_V12N28-333_C1,0,1,2,2,0,5
AGTGGCGTCTGAAGGT-1_V12N28-333_C1,0,0,0,0,0,0
GGGAAGGGCTTTCTCA-1_V12N28-333_C1,0,0,0,1,0,1
AGGCCTGAGAATCTCG-1_V12N28-333_C1,0,0,1,0,0,1
AGCCACAGGTTACCCG-1_V12N28-333_C1,0,0,1,0,0,1
TGCAATCTAACACGGT-1_V12N28-333_C1,0,0,1,0,1,2
GTTTGGGTTTCGCCCG-1_V12N28-333_C1,0,0,2,0,0,2
CCTATGTCCACTCCAC-1_V12N28-333_C1,0,0,1,0,0,1
CTGCCTTTCTAGTAAA-1_V12N28-333_C1,0,0,1,1,0,2
TTAGTAAACCTGCTCT-1_V12N28-333_C1,0,1,0,1,0,2
TTGTGGTGGTACTAAG-1_V12N28-333_C1,0,0,1,0,0,1
CCTCCTGTTGTGTCGT-1_V12N28-333_C1,0,1,2,0,0,3
ACAAAGCATGACCTAG-1_V12N28-333_C1,0,0,0,0,0,0
ATAGCAACTAGGGAAG-1_V12N28-333_C1,0,1,0,0,0,1
CCGCTCTTCCGAACTA-1_V12N28-333_C1,0,1,0,0,0,1
TAGAATAGCCGATGAA-1_V12N28-333_C1,0,0,0,0,0,0
GGTCTCCGTCCAGGTT-1_V12N28-333_C1,0,0,0,0,0,0
TAATTACGTCAGTAGA-1_V12N28-333_C1,0,3,1,0,0,4
TACGTAAAGCGGAGTG-1_V12N28-333_C1,0,2,0,0,0,2
GCTACAATCGAGGATA-1_V12N28-333_C1,0,0,0,0,0,0
TCAGCCAATCCGTAAA-1_V12N28-333_C1,0,0,1,0,2,3
ATCATAGCCCTATGTA-1_V12N28-333_C1,0,4,0,0,0,4
GAGGCCTGTTGATACA-1_V12N28-333_C1,0,2,0,0,0,2
ATATACGCTCGTGACG-1_V12N28-333_C1,0,3,0,0,0,3
CCCTTTAATGGAGTTC-1_V12N28-333_C1,0,0,0,0,1,1
TTACACGATCTGCGAC-1_V12N28-333_C1,0,2,0,0,0,2
TCGCATAAAGGGCGCA-1_V12N28-333_C1,0,1,0,0,0,1
TGTAGCCATCCCATTC-1_V12N28-333_C1,0,0,0,0,0,0
GGGTCTATCGCTTTCC-1_V12N28-333_C1,0,2,0,0,0,2
GGAGGGTCAAGTAAGA-1_V12N28-333_C1,0,3,0,0,1,4
TACGGCATGGACGCTA-1_V12N28-333_C1,0,0,0,0,0,0
CACGTCAATCAATGGA-1_V12N28-333_C1,0,3,0,0,0,3
CGCTTGGACGGATAGA-1_V12N28-333_C1,0,5,0,0,1,6
CGCGGTACGGTATACA-1_V12N28-333_C1,0,0,0,0,0,0
CCTACTCAACACGATT-1_V12N28-333_C1,0,4,1,0,0,5
CGTTTGGTGTTGTGGG-1_V12N28-333_C1,0,5,0,1,0,6
GTTGTTGCAAGATGGC-1_V12N28-333_C1,0,3,0,0,1,4
CATTCGTCGTAGCGGT-1_V12N28-333_C1,0,1,0,0,0,1
CAGCCTCGATAGCGGT-1_V12N28-333_C1,0,1,1,0,0,2
TCATAAGTCCAAGAAG-1_V12N28-333_C1,0,3,0,0,0,3
AAAGTGCCATCAATTA-1_V12N28-333_C1,0,3,0,1,1,5
GTTGCAGTCGACAACA-1_V12N28-333_C1,0,0,1,0,1,2
TAAATGGGCTACTGAG-1_V12N28-333_C1,0,2,0,0,0,2
CTGCCTTTAATACCTT-1_V12N28-333_C1,0,0,0,0,0,0
GAGCATCAACAACTTG-1_V12N28-333_C1,0,0,0,1,0,1
CATACGAACTAGCTGG-1_V12N28-333_C1,0,0,1,2,0,3
GGGAACGGTTTCAGAT-1_V12N28-333_C1,0,1,0,2,0,3
AGGGTGCCGTTCTTTA-1_V12N28-333_C1,0,0,2,2,1,5
ACGACTGGTCATACTC-1_V12N28-333_C1,1,0,0,1,2,4
GGATCTTACTGCCCTT-1_V12N28-333_C1,0,0,2,2,1,5
TACTCCTCTAGTTGAC-1_V12N28-333_C1,0,1,1,1,0,3
GTAGCTCCGGGAGGCT-1_V12N28-333_C1,0,0,7,1,0,8
GGACTCGTGAGTGGTC-1_V12N28-333_C1,0,1,0,2,0,3
GTAGTTCGAAGGCGAA-1_V12N28-333_C1,0,1,0,0,0,1
CTCAAACCACTGCCCG-1_V12N28-333_C1,0,0,1,3,0,4
GAGGGAGTCAGATCGC-1_V12N28-333_C1,0,0,2,0,0,2
GCGTCCCTAAGACATA-1_V12N28-333_C1,1,0,1,2,0,4
TCTCTTACCGCGAACC-1_V12N28-333_C1,1,0,2,2,0,5
GGCTACTATACACTCC-1_V12N28-333_C1,0,0,0,1,0,1
CGTTGCCCGCGTGGGA-1_V12N28-333_C1,0,2,2,1,0,5
TATAGAGTCGCTTGAA-1_V12N28-333_C1,0,1,2,2,0,5
ATGTTGTAGTCTGTTT-1_V12N28-333_C1,0,2,0,2,0,4
AGTATACACAGCGACA-1_V12N28-333_C1,0,2,1,4,0,7
TGTGGTTGCTAAAGCT-1_V12N28-333_C1,0,4,1,2,0,7
TGATTCCCGGTTACCT-1_V12N28-333_C1,1,1,1,4,0,7
CACTGACGATTGTGGA-1_V12N28-333_C1,0,2,0,1,0,3
AACATTGTGACTCGAG-1_V12N28-333_C1,0,3,3,2,0,8
GTCCAATATTTAGCCT-1_V12N28-333_C1,2,1,0,1,0,4
GCTCTTTCCGCTAGTG-1_V12N28-333_C1,0,3,1,0,0,4
GGGTCAGGAGCTAGAT-1_V12N28-333_C1,0,1,0,4,0,5
AGGTGGTGACCTTCGC-1_V12N28-333_C1,0,7,0,2,0,9
CCCGGGTCGTTCAGGG-1_V12N28-333_C1,0,1,0,4,0,5
AGCCAAGCTTTGTGTC-1_V12N28-333_C1,1,2,0,4,0,7
TGTGGCGGGCTTCTGG-1_V12N28-333_C1,1,4,1,0,0,6
CGAGGGTATCCAGGTG-1_V12N28-333_C1,1,2,0,3,0,6
CGTTCAGACCCGCGAA-1_V12N28-333_C1,0,1,0,7,0,8
TCATATGAGCTTTGTT-1_V12N28-333_C1,3,1,0,2,0,6
AGTTGACGGTCCTTGC-1_V12N28-333_C1,1,1,0,5,0,7
ATAATTAGCTAAGTAG-1_V12N28-333_C1,3,0,0,2,0,5
GGTCTTGAGCGCTCTT-1_V12N28-333_C1,0,3,1,3,0,7
CGTTGTCGGCAATTGA-1_V12N28-333_C1,0,4,0,2,0,6
TCTTGCTCCCGATACT-1_V12N28-333_C1,1,1,1,2,0,5
AGCAGAAGGAGAAAGA-1_V12N28-333_C1,0,1,3,1,0,5
GAAGCCACTGATTATG-1_V12N28-333_C1,1,1,1,2,0,5
TGCTCTTGAGAGTTTG-1_V12N28-333_C1,2,0,1,1,0,4
GACATCCGTCGAACTG-1_V12N28-333_C1,1,2,1,2,0,6
AGATATAATACGACTA-1_V12N28-333_C1,0,4,1,4,0,9
TCGCTACTGGCTTTGA-1_V12N28-333_C1,0,3,0,2,0,5
GTGACAGCTTCCCACT-1_V12N28-333_C1,0,0,2,1,0,3
GTGACGCAGGTTTCAT-1_V12N28-333_C1,0,1,0,4,0,5
GGGAAGACGGTCTGTC-1_V12N28-333_C1,0,0,0,5,0,5
CGTCGCATGTGAGCCA-1_V12N28-333_C1,0,3,0,2,0,5
AGAAGGTTGTAGGTCG-1_V12N28-333_C1,0,2,0,3,0,5
GGCCGGCGTCTGCTAT-1_V12N28-333_C1,1,0,0,1,0,2
TTGACCAGGAACAACT-1_V12N28-333_C1,1,2,0,2,0,5
AGTCGTATAAAGCAGA-1_V12N28-333_C1,1,3,1,3,0,8
GGCGTAGGGAAAGCTG-1_V12N28-333_C1,1,0,0,3,0,4
AAACCTAAGCAGCCGG-1_V12N28-333_C1,0,1,0,2,0,3
ATTGCCTTTATGTTTG-1_V12N28-333_C1,0,2,1,3,0,6
CAGGCAGTCTTACCAG-1_V12N28-333_C1,1,2,0,1,0,4
AGCTAAGTACGCAGGC-1_V12N28-333_C1,0,0,0,3,0,3
AAATCCGATACACGCC-1_V12N28-333_C1,0,3,0,6,0,9
CGAGAGCTTTCACTAC-1_V12N28-333_C1,0,1,1,4,0,6
CGCCCAGCGTTTCACG-1_V12N28-333_C1,0,1,1,3,0,5
TTAAGTATTGTTATCC-1_V12N28-333_C1,0,0,2,2,0,4
AAACGGGCGTACGGGT-1_V12N28-333_C1,0,2,1,6,0,9
GTATCCTTTGGTAACC-1_V12N28-333_C1,0,0,0,2,0,2
CATAGTCAAATACATA-1_V12N28-333_C1,0,2,3,2,0,7
TCTATGCTATAACGAC-1_V12N28-333_C1,0,0,0,0,0,0
ACGTTCTGTACAAGTC-1_V12N28-333_C1,0,0,2,2,0,4
CGCGAAGTGGCATACT-1_V12N28-333_C1,0,0,3,0,0,3
ACCAACCGCACTCCAC-1_V12N28-333_C1,0,0,1,1,0,2
GTCATGCGCGAGGGCT-1_V12N28-333_C1,0,1,0,0,0,1
TAGGCTAAAGTGGCAC-1_V12N28-333_C1,0,1,1,0,0,2
TGGCTACACTCTACCT-1_V12N28-333_C1,0,0,0,0,0,0
TGTCCACGGCTCAACT-1_V12N28-333_C1,0,0,0,1,1,2
AATTGCAGCAATCGAC-1_V12N28-333_C1,0,1,4,0,1,6
GTCAACCAGGCCTATA-1_V12N28-333_C1,0,1,1,0,0,2
ATCTTATCGCACACCC-1_V12N28-333_C1,0,0,1,0,0,1
GTCTATTGCATGCTCG-1_V12N28-333_C1,0,0,1,0,0,1
GCACGTGGTTTACTTA-1_V12N28-333_C1,0,1,2,0,0,3
ATTCGCGCCTTGAGAG-1_V12N28-333_C1,0,1,0,0,0,1
AGCGATGCGCCTAATA-1_V12N28-333_C1,0,2,0,0,0,2
TCTATAGGTGGGTAAT-1_V12N28-333_C1,0,0,1,0,0,1
AGATACCAATAGAACC-1_V12N28-333_C1,0,0,0,0,0,0
CGTGTATGGGAGCTGA-1_V12N28-333_C1,0,1,0,0,0,1
ATGTACATGCGGTGAG-1_V12N28-333_C1,0,0,0,0,0,0
TTGGCTCAATATGTGT-1_V12N28-333_C1,0,1,0,0,3,4
GTTCGGAGCACTCAAC-1_V12N28-333_C1,0,1,0,0,1,2
TCCCTCTTCTCAAGGG-1_V12N28-333_C1,0,1,0,0,0,1
TTACGTATCTATGACA-1_V12N28-333_C1,0,2,0,0,0,2
CCCATATAGGTCGATT-1_V12N28-333_C1,0,2,0,0,0,2
GTCCACGTCGCATTCG-1_V12N28-333_C1,0,4,1,0,0,5
AATTGTGGTTGCCAAA-1_V12N28-333_C1,0,1,0,0,0,1
AGGAACGAACGACTTC-1_V12N28-333_C1,0,1,0,0,0,1
TAATTCCAATGCTTCA-1_V12N28-333_C1,0,1,0,0,0,1
AGGGCCCTAATGTTCT-1_V12N28-333_C1,0,2,0,0,0,2
AGGTGTTGCCGACCAC-1_V12N28-333_C1,0,1,0,0,0,1
CTGAGAGTAGAAATAC-1_V12N28-333_C1,0,2,0,0,0,2
TAGAAGAAGGGTTACA-1_V12N28-333_C1,0,1,2,0,0,3
GGTGACTGATAGAGAG-1_V12N28-333_C1,0,0,0,0,0,0
TACCCTCGGTAACCCT-1_V12N28-333_C1,0,0,0,0,1,1
CATTATCCCATTAACG-1_V12N28-333_C1,0,0,3,2,0,5
AATGTGCTAATCTGAG-1_V12N28-333_C1,0,0,3,5,0,8
CTTAGTTGAGGAATCG-1_V12N28-333_C1,0,0,1,5,0,6
CTTCTGGGCGTACCTA-1_V12N28-333_C1,0,0,3,3,0,6
AGTCAAATGATGTGAT-1_V12N28-333_C1,0,0,4,2,0,6
TGAACAAGCAGGGACT-1_V12N28-333_C1,0,0,1,3,0,4
AATACCGGAGGGCTGT-1_V12N28-333_C1,1,2,0,2,0,5
GTTTGGTGATCGGTGC-1_V12N28-333_C1,0,1,1,2,0,4
GACTGCTGGTGAGAAA-1_V12N28-333_C1,1,2,0,4,0,7
CGATCCTCGCAACATA-1_V12N28-333_C1,0,1,1,6,0,8
CCAACCTTATGTAACT-1_V12N28-333_C1,0,0,0,3,0,3
CGTGGTACCCAAAGGC-1_V12N28-333_C1,1,0,0,3,0,4
AACCCGACAACCCGTG-1_V12N28-333_C1,0,1,2,3,0,6
TATGTAAAGTGCTTAA-1_V12N28-333_C1,0,0,1,4,0,5
GCAAGTGTAAAGCATG-1_V12N28-333_C1,1,0,0,1,0,2
GTAACTGCCCAAGGAG-1_V12N28-333_C1,0,1,1,2,0,4
GGTGCATAAATGATTA-1_V12N28-333_C1,1,0,1,1,0,3
TAGTCCCGGAGACCAC-1_V12N28-333_C1,0,0,0,2,0,2
CGGCCAGAGCGACCAT-1_V12N28-333_C1,0,3,1,5,0,9
TGAATGAGTGTTTCCC-1_V12N28-333_C1,0,0,1,4,0,5
TTCACTTCCTAGAACG-1_V12N28-333_C1,0,2,1,3,0,6
CGCTTAGTATTGATAC-1_V12N28-333_C1,0,0,0,2,0,2
AACGCGACCTTGGGCG-1_V12N28-333_C1,0,1,1,4,0,6
GTGCACCAGCTTCAAC-1_V12N28-333_C1,1,1,0,0,0,2
TTCTATTAAACGCAGC-1_V12N28-333_C1,1,1,0,1,0,3
TGGCAAGCACAAGTCG-1_V12N28-333_C1,1,1,0,1,0,3
ATCTGCTGTTATCGCC-1_V12N28-333_C1,0,1,0,4,0,5
AATTCCAAGCATGTAC-1_V12N28-333_C1,1,2,0,1,0,4
AAACGGTTGCGAACTG-1_V12N28-333_C1,0,3,1,1,0,5
GAAGGAGTCGAGTGCG-1_V12N28-333_C1,0,3,0,3,0,6
GGCAAGCCCATAGTGG-1_V12N28-333_C1,1,1,0,1,0,3
TGACCAAATCTTAAAC-1_V12N28-333_C1,0,0,0,3,0,3
TTCGGTACTGTAGAGG-1_V12N28-333_C1,0,1,0,6,0,7
ATGTACGATGACGTCG-1_V12N28-333_C1,0,0,0,5,0,5
ATCTAGCTTGTGAGGG-1_V12N28-333_C1,1,3,0,3,0,7
AGCGGGTCTGACACTC-1_V12N28-333_C1,0,3,2,0,0,5
GAGGTACGCGTGTCCC-1_V12N28-333_C1,0,0,3,4,0,7
GCACTGCCTACCTTTA-1_V12N28-333_C1,0,4,0,1,0,5
GGAGCGAGGCCTACTT-1_V12N28-333_C1,0,2,0,2,0,4
AAACTCGGTTCGCAAT-1_V12N28-333_C1,0,0,0,1,0,1
GGCGCTTCATTCCCTG-1_V12N28-333_C1,0,3,0,1,0,4
TGCTCGGTGGGTCACC-1_V12N28-333_C1,0,1,0,5,0,6
AAGCGCAGGGCTTTGA-1_V12N28-333_C1,0,2,1,2,0,5
GACCTTCCACGTCTAC-1_V12N28-333_C1,0,3,0,1,0,4
GTTAGCCCATGACATC-1_V12N28-333_C1,0,2,0,3,0,5
AATTCGATTCGAGGAT-1_V12N28-333_C1,0,1,0,1,0,2
AGTCTTTAAAGTGTCC-1_V12N28-333_C1,1,1,1,2,0,5
GACTAGGCCGTTAGGT-1_V12N28-333_C1,1,3,1,2,0,7
TCCAAGCCTAGACACA-1_V12N28-333_C1,1,1,2,1,0,5
GATTGGGAAAGGTTGT-1_V12N28-333_C1,0,0,3,4,0,7
GATGAGGAACCTTCGG-1_V12N28-333_C1,0,1,0,0,0,1
TGAATACCGACGCGTA-1_V12N28-333_C1,1,1,2,1,0,5
AATCGTGAGCCGAGCA-1_V12N28-333_C1,0,0,0,4,0,4
GCGAAGAATCTGACGG-1_V12N28-333_C1,0,1,0,5,0,6
GAACAACTGGGATGAA-1_V12N28-333_C1,0,1,2,0,0,3
TCGCCGACATATTCGC-1_V12N28-333_C1,1,4,1,4,0,10
CGTAGAGAGTAATTAT-1_V12N28-333_C1,1,2,2,1,0,6
CGATAGTCGTACTGCA-1_V12N28-333_C1,0,1,0,3,0,4
CGCATGCCGAATGCGT-1_V12N28-333_C1,0,1,2,3,0,6
CTCTAGCCCTCGGAAA-1_V12N28-333_C1,0,1,1,3,0,5
TCCAACTCAGCTATCT-1_V12N28-333_C1,0,3,0,2,0,5
GTCTAGTGAGCCGCTT-1_V12N28-333_C1,0,1,0,1,0,2
TACCGAATAATTGTAA-1_V12N28-333_C1,1,2,0,2,0,5
ATATAACACGGGCGCA-1_V12N28-333_C1,0,0,0,7,0,7
GCATGCTAATAACGAT-1_V12N28-333_C1,1,1,0,6,0,8
TCCGGGCTTGACGGGA-1_V12N28-333_C1,0,0,2,1,0,3
ATTATTCAGAGTCACT-1_V12N28-333_C1,0,1,1,4,0,6
TAGCAGTATGACTAAA-1_V12N28-333_C1,0,2,2,1,0,5
TATGAAGAATTAAGGT-1_V12N28-333_C1,0,0,2,4,0,6
CAAGGCCAGTGGTGCA-1_V12N28-333_C1,0,2,4,1,0,7
TGCGTACGGCTAATTG-1_V12N28-333_C1,0,3,0,5,0,8
CAGATAATGGGCGGGT-1_V12N28-333_C1,0,0,2,0,0,2
GAGAACGGTTCTGACT-1_V12N28-333_C1,0,1,2,3,0,6
CGCTTCGGTCTAAGAC-1_V12N28-333_C1,0,0,2,0,0,2
AGCATTACGAGGCAAG-1_V12N28-333_C1,0,2,1,1,0,4
AAGTTGTGATGTTATA-1_V12N28-333_C1,0,0,1,0,0,1
TTGCTCATAGTACGTG-1_V12N28-333_C1,0,0,1,0,0,1
TACTTAAACATGTACA-1_V12N28-333_C1,0,0,0,0,0,0
AGTGAGTCGAATTAAC-1_V12N28-333_C1,0,0,0,0,0,0
TAGGCCTATATAGTCT-1_V12N28-333_C1,0,0,0,0,0,0
ACTCGCCGTTCGATAA-1_V12N28-333_C1,0,1,0,0,0,1
GGTACGTTGCGGCCGG-1_V12N28-333_C1,0,0,4,0,0,4
TATTGCCGGGCTTGTA-1_V12N28-333_C1,0,1,0,0,0,1
GGTAAACTCTGCGCTG-1_V12N28-333_C1,0,2,1,0,0,3
TCCCTTGTCTGAAACT-1_V12N28-333_C1,0,2,3,0,0,5
CATGATCGCTTTGAGA-1_V12N28-333_C1,0,0,2,0,0,2
GGACGGGCGACCAACC-1_V12N28-333_C1,0,2,0,0,0,2
GAGAGGCCTATGTGTA-1_V12N28-333_C1,0,2,1,0,1,4
TCGTAACTCCCAAGAC-1_V12N28-333_C1,0,0,3,0,0,3
CGTATCTAGAACTAAG-1_V12N28-333_C1,0,2,0,0,0,2
GCACCTTCCCGAAGGT-1_V12N28-333_C1,0,1,2,0,1,4
TACCTCTTTACCATCC-1_V12N28-333_C1,0,0,1,0,0,1
TGACTCTAACTGGTAA-1_V12N28-333_C1,0,3,0,0,0,3
GAGAAACTGGATCCCA-1_V12N28-333_C1,0,0,0,0,0,0
ATCCGGACCAGCCTGA-1_V12N28-333_C1,0,0,1,0,0,1
TTATTTAGGTTCCTTA-1_V12N28-333_C1,0,3,1,0,1,5
CGAATTCCCGGTTCAA-1_V12N28-333_C1,0,0,0,0,0,0
ACTGCCCGCCATTCTC-1_V12N28-333_C1,0,0,2,2,0,4
CTATATCCAGCCTGGC-1_V12N28-333_C1,1,0,0,5,0,6
CGCACGTCTGTTTATG-1_V12N28-333_C1,0,1,3,0,0,4
AATCAGGTTTCATTTA-1_V12N28-333_C1,0,3,0,1,0,4
AGAGAAACACCAGAAA-1_V12N28-333_C1,0,2,1,4,0,7
ACCCGATTGGTTCCGA-1_V12N28-333_C1,1,1,2,0,0,4
TACCAGGAATCCCGTC-1_V12N28-333_C1,0,1,0,0,0,1
AAGTGCTTCTCTATTG-1_V12N28-333_C1,1,1,3,1,0,6
TGCATGTGACCCATAG-1_V12N28-333_C1,0,5,1,1,0,7
TAGATTCAAAGTGCGG-1_V12N28-333_C1,0,1,0,2,0,3
AGGGTCAGAGCACTCG-1_V12N28-333_C1,1,1,0,2,0,4
GTGAGATAACCTTATA-1_V12N28-333_C1,0,2,0,6,0,8
GTGTCAGTGTACGTGG-1_V12N28-333_C1,0,1,0,3,0,4
CTGTAGTGAGGATCGA-1_V12N28-333_C1,0,1,1,3,0,5
GATAGTGCGAGTAAGT-1_V12N28-333_C1,1,0,1,7,0,9
AGGGTTCAGACGGTCC-1_V12N28-333_C1,1,2,1,6,0,10
GGACTCGACAGCGCAT-1_V12N28-333_C1,0,3,4,0,0,7
CACTCTCAAGCATCGA-1_V12N28-333_C1,0,1,0,0,0,1
GAGCGGAATGCGGTGT-1_V12N28-333_C1,0,4,0,2,0,6
CAGTTCGAGGACCCGA-1_V12N28-333_C1,0,0,2,4,0,6
CGTAACTTCGACACTT-1_V12N28-333_C1,0,3,0,2,0,5
TGATCACCACACTGAC-1_V12N28-333_C1,0,2,1,1,0,4
CATACTTCTTTCTCCG-1_V12N28-333_C1,1,1,0,2,0,4
CAAGTAAGTGATAGAC-1_V12N28-333_C1,2,2,0,0,0,4
AGCCCGCAACAAGCAG-1_V12N28-333_C1,2,3,0,3,0,8
GCTCCATGCAAAGCAA-1_V12N28-333_C1,0,2,0,1,0,3
TCGTACCGACGTCAAG-1_V12N28-333_C1,1,3,1,0,0,5
ATTATCGGAATGTACG-1_V12N28-333_C1,2,3,0,5,0,10
ACCTACTATAAATCTA-1_V12N28-333_C1,0,2,0,2,0,4
TATCCTATCAACTGGT-1_V12N28-333_C1,1,2,0,2,0,5
GCGCGGTCTAGTAACT-1_V12N28-333_C1,0,0,0,5,0,5
CCTTCGTATAGAATCC-1_V12N28-333_C1,0,1,0,0,0,1
TGGGCGATACAATAAG-1_V12N28-333_C1,1,3,0,0,0,4
TGACATGTAACGTGAC-1_V12N28-333_C1,0,1,0,0,0,1
TTGGGAAGACGAGCCG-1_V12N28-333_C1,0,5,0,2,0,7
GGTGTAAATCGATTGT-1_V12N28-333_C1,3,2,0,8,0,13
GAACTGTGGAGAGACA-1_V12N28-333_C1,0,0,0,2,0,2
TCCACATCGTATATTG-1_V12N28-333_C1,0,2,0,6,0,8
CCTATGGTCAAAGCTG-1_V12N28-333_C1,0,1,0,4,0,5
TCCTTGTCCTTTAATT-1_V12N28-333_C1,0,2,0,3,0,5
AAGTTTATGGGCCCAA-1_V12N28-333_C1,1,1,0,3,0,5
GTCCGGGTTCACATTA-1_V12N28-333_C1,1,2,0,5,0,8
ATGTAGCGCGCGTAGG-1_V12N28-333_C1,1,1,0,2,0,4
TACGGAAGCCAAACCA-1_V12N28-333_C1,0,4,0,1,0,5
GCCCTGAGGATGGGCT-1_V12N28-333_C1,2,0,0,2,0,4
CGGGCGATGGATCACG-1_V12N28-333_C1,1,0,0,2,0,3
TGCGGACTTGACTCCG-1_V12N28-333_C1,0,0,0,3,0,3
TAATACTAGAACAGAC-1_V12N28-333_C1,0,2,0,2,0,4
TCAAATTGTTGTGCCG-1_V12N28-333_C1,0,0,0,1,0,1
GGGCAGTCAACGCCAA-1_V12N28-333_C1,0,4,0,2,0,6
TCGCTGCCAATGCTGT-1_V12N28-333_C1,0,0,0,3,0,3
TACGTGGGCCCAGGGC-1_V12N28-333_C1,0,1,0,2,0,3
GCCTACGTTCTGTGCA-1_V12N28-333_C1,0,1,0,3,0,4
TTGCGTGTGTAGGCAT-1_V12N28-333_C1,0,2,1,2,0,5
TCCTAAAGATTCAGAC-1_V12N28-333_C1,0,1,4,3,0,8
TGGGTGCACAAGCCAT-1_V12N28-333_C1,1,3,0,2,0,6
GGGAGCGACCGTAGTG-1_V12N28-333_C1,0,0,1,4,0,5
CATAGAGGAGATACTA-1_V12N28-333_C1,3,0,0,3,0,6
CTTCGATTGCGCAAGC-1_V12N28-333_C1,0,1,0,2,0,3
GTGCCTGAGACCAAAC-1_V12N28-333_C1,0,2,0,2,0,4
TCATCCTCAGCTGCTT-1_V12N28-333_C1,0,3,0,4,0,7
TGCAACTACTGGTTGA-1_V12N28-333_C1,2,1,1,4,0,8
ATGTTGATTAGAGACT-1_V12N28-333_C1,0,3,0,2,0,5
GTTTCTAGAGGCGCGG-1_V12N28-333_C1,0,1,0,5,0,6
TACAAGGGCTTCTTTA-1_V12N28-333_C1,0,3,0,3,0,6
ACAGGCACGGATCCTT-1_V12N28-333_C1,0,1,0,3,0,4
CCCAAGTCATTACACT-1_V12N28-333_C1,1,2,0,3,0,6
ACTCTGACCTAATAGA-1_V12N28-333_C1,0,3,1,2,0,6
GGATGGCTTGAAGTAT-1_V12N28-333_C1,2,3,0,0,0,5
ACCCTCCCGTCAGGGC-1_V12N28-333_C1,0,3,0,1,0,4
AGCTTCTTCTCGAGCA-1_V12N28-333_C1,0,3,0,3,0,6
TTGCGCTTGATCAATA-1_V12N28-333_C1,0,3,1,1,0,5
TGGGTGTAATAGATTT-1_V12N28-333_C1,0,4,0,3,0,7
CATGGTTTATTAATCA-1_V12N28-333_C1,0,1,0,0,0,1
TTGCCTTCTCGCCGGG-1_V12N28-333_C1,0,2,0,2,0,4
TTAAAGTAAGTCGCCA-1_V12N28-333_C1,0,3,0,2,0,5
AGTTGGCAAGGCTAGA-1_V12N28-333_C1,0,7,0,3,0,10
CCGCACTTGCAATGAC-1_V12N28-333_C1,0,4,0,2,0,6
AATGTTGTCGTGAGAC-1_V12N28-333_C1,0,4,2,6,0,12
CCAAGGTTGCCCTTTC-1_V12N28-333_C1,0,4,0,3,0,7
TGTGACTAGAGTTTGC-1_V12N28-333_C1,0,0,2,1,0,3
TTGTGATCTGTTCAGT-1_V12N28-333_C1,0,1,0,2,0,3
GGAGTTGATTCTGTGT-1_V12N28-333_C1,0,0,0,0,0,0
GTAGTGAGCAACCTCA-1_V12N28-333_C1,0,2,2,3,0,7
AAGACATACGTGGTTT-1_V12N28-333_C1,0,0,1,0,0,1
CATCCCGAGATTCATA-1_V12N28-333_C1,0,0,3,0,0,3
GGCCGCAGGAACCGCA-1_V12N28-333_C1,0,0,1,0,0,1
CCAGAAACTGATGCGA-1_V12N28-333_C1,0,0,2,0,0,2
ACCCGTAGTCTAGTTG-1_V12N28-333_C1,0,1,1,0,0,2
AGGGTCTGGACGCAGT-1_V12N28-333_C1,0,0,1,0,0,1
TTGAAACCCTCATTCC-1_V12N28-333_C1,0,1,0,0,0,1
TCAATCCCGCGCCAAA-1_V12N28-333_C1,0,0,0,0,0,0
AGGACATCGGCACACT-1_V12N28-333_C1,0,1,1,0,1,3
GACAAGACGCCCGTGC-1_V12N28-333_C1,0,0,0,0,0,0
GAGTAAATTAAGAACC-1_V12N28-333_C1,0,1,2,0,0,3
TAAGTCGGTGAGCTAG-1_V12N28-333_C1,0,0,2,0,0,2
CTTACTGACTCCTCTG-1_V12N28-333_C1,0,0,1,0,0,1
TTAACTGATCGTTTGG-1_V12N28-333_C1,0,0,0,0,0,0
GAGTATACCCTAATCA-1_V12N28-333_C1,0,0,0,1,0,1
CCACGGCAGGTGTAGG-1_V12N28-333_C1,0,0,0,2,0,2
ACGTACTTTGGCACGG-1_V12N28-333_C1,1,0,0,1,0,2
CCTGAGAATAAATGCA-1_V12N28-333_C1,0,1,1,1,0,3
TTGATGCCGCTCGTCG-1_V12N28-333_C1,0,1,2,2,0,5
GCCAGGAAAGAACACT-1_V12N28-333_C1,0,3,2,3,0,8
TCCGACCGCTAATCAA-1_V12N28-333_C1,1,0,1,2,0,4
TATATCAAAGTGATCT-1_V12N28-333_C1,1,3,1,2,0,7
CCTCGGTTTCCTTGCC-1_V12N28-333_C1,3,1,0,5,0,9
TAAATTTAGTAACACC-1_V12N28-333_C1,0,2,1,2,0,5
CTCGTTACGGCTACCA-1_V12N28-333_C1,0,2,0,1,0,3
GCCGTCGGTTTCGGGC-1_V12N28-333_C1,0,3,0,1,0,4
GTTCCGTCCGCCTGCA-1_V12N28-333_C1,1,0,0,5,0,6
CTAGGGATAGGGACAA-1_V12N28-333_C1,1,1,0,3,0,5
GTCCAGGCACGTGTGC-1_V12N28-333_C1,0,0,1,4,0,5
GAGGAATATCTCTTTG-1_V12N28-333_C1,0,3,0,0,0,3
CGTTCAAGGAAACGGA-1_V12N28-333_C1,1,2,0,4,0,7
GTGGGAACAAACCGGG-1_V12N28-333_C1,0,4,0,4,0,8
GGGCACGTAGTACTGT-1_V12N28-333_C1,2,1,0,2,0,5
ACTACAAAGAGAGGTG-1_V12N28-333_C1,0,4,0,2,0,6
GGTGTAGGTAAGTAAA-1_V12N28-333_C1,3,1,0,0,0,4
CCTGTTCAACCTCGGG-1_V12N28-333_C1,1,5,0,0,0,6
TGAGGTGTGTGGCGGA-1_V12N28-333_C1,1,1,0,0,0,2
ATTGTCTGTTTCATGT-1_V12N28-333_C1,0,1,0,6,0,7
GCCGGTCGTATCTCTC-1_V12N28-333_C1,1,2,1,1,0,5
ATATGGGATAGCAACT-1_V12N28-333_C1,0,2,0,3,0,5
GATAGAACCCGCTAGG-1_V12N28-333_C1,0,1,0,1,0,2
ATCCCATTTCCGTGGG-1_V12N28-333_C1,1,2,0,0,0,3
GATGCTACCTTCGATG-1_V12N28-333_C1,1,2,0,3,0,6
TGCAAAGTTCGTCTGT-1_V12N28-333_C1,0,0,0,2,0,2
GTTCAGTCGCCAAATG-1_V12N28-333_C1,0,0,0,1,0,1
GTCTCCGCCTCAATAC-1_V12N28-333_C1,1,0,0,2,0,3
AGTAGAAGGCGCCTCA-1_V12N28-333_C1,0,2,0,4,0,6
GTTGTAGATTTATGAG-1_V12N28-333_C1,0,3,1,3,0,7
CTATTTGCTTGGAGGA-1_V12N28-333_C1,0,2,0,2,0,4
AGCCATATAGTATGTG-1_V12N28-333_C1,1,1,0,1,0,3
TGTTCCGGCCTGAGCT-1_V12N28-333_C1,5,1,1,2,0,9
TGCCGTGGGACCCAAT-1_V12N28-333_C1,1,2,1,2,0,6
TTGCAAGAAGACTCCT-1_V12N28-333_C1,1,4,1,2,0,8
CCGCTCCAGGGCGATC-1_V12N28-333_C1,1,3,0,0,0,4
CAAACCCTCCGGCGGG-1_V12N28-333_C1,1,6,0,1,0,8
CGGACCTTTACGTCCC-1_V12N28-333_C1,1,2,0,6,0,9
ACGTAGGAGAGTCGCT-1_V12N28-333_C1,3,2,1,0,0,6
CTGCGACCTCGCCGAA-1_V12N28-333_C1,1,4,0,2,0,7
GGCCCAGCTGGTTTGC-1_V12N28-333_C1,0,2,0,2,0,4
GGATTAATCATGGACC-1_V12N28-333_C1,0,4,0,4,0,8
GAGATGGCTTTAATCA-1_V12N28-333_C1,1,0,0,3,0,4
AGTACAGAAGCTTATA-1_V12N28-333_C1,1,2,0,2,0,5
GCGGCTTTAGCAAGTT-1_V12N28-333_C1,0,0,0,2,0,2
ACCGAGTCTCCTTATT-1_V12N28-333_C1,0,4,0,3,0,7
GACCACACTTCCCTTT-1_V12N28-333_C1,0,3,0,3,0,6
TGTAGCCAATTCCGTT-1_V12N28-333_C1,1,6,0,0,0,7
CTCGTCTGTGCCTTCG-1_V12N28-333_C1,0,1,2,1,0,4
GGACTCTTTGACTAAG-1_V12N28-333_C1,0,4,0,1,0,5
TCATCGACGACCGTCG-1_V12N28-333_C1,0,0,0,3,0,3
TACTACGTGCAATGCG-1_V12N28-333_C1,2,1,0,5,0,8
CCCTACTTGAACAATG-1_V12N28-333_C1,1,2,0,3,0,6
GCAGCTGTCAACGCAT-1_V12N28-333_C1,4,2,0,0,0,6
ATCTACCATCTGCTCC-1_V12N28-333_C1,3,2,0,2,0,7
TCTCAAATCAATCGGG-1_V12N28-333_C1,0,2,0,2,0,4
ACTCCGGCCGACCACT-1_V12N28-333_C1,0,1,0,2,0,3
TACACCTCTTCGAATC-1_V12N28-333_C1,1,1,0,5,0,7
GTGGCTGTTTCTGTTC-1_V12N28-333_C1,0,3,1,2,0,6
ACGACTCTAGGGCCGA-1_V12N28-333_C1,1,3,0,3,0,7
TCGTTTACGCGACCCT-1_V12N28-333_C1,0,1,0,5,0,6
AGGATATCCGACTGCA-1_V12N28-333_C1,3,4,1,1,0,9
GACACTTCCAATTACC-1_V12N28-333_C1,3,4,0,0,0,7
ACGGTACAGTTCAATG-1_V12N28-333_C1,0,1,0,3,0,4
CTTGATGACCATCCAG-1_V12N28-333_C1,1,3,0,2,0,6
CTGGTAAAGACTTACA-1_V12N28-333_C1,0,2,0,1,0,3
CTTGCCCACCCACGCA-1_V12N28-333_C1,0,3,0,3,0,6
CATTACGCAGGAAGGG-1_V12N28-333_C1,1,2,0,2,0,5
GGACAACCATGAAGCC-1_V12N28-333_C1,0,3,0,4,0,7
GTTATCAAGCTATCGA-1_V12N28-333_C1,0,1,0,4,0,5
AGGTGCACGTCCACAT-1_V12N28-333_C1,0,2,0,1,0,3
AAAGAATGTGGACTAA-1_V12N28-333_C1,1,4,0,4,0,9
ACCAAGTCATCGGCAG-1_V12N28-333_C1,0,3,0,1,0,4
AGTAACTATAGCAGCC-1_V12N28-333_C1,0,4,0,2,0,6
GGGAAAGAATGCCAAC-1_V12N28-333_C1,0,5,0,2,0,7
AATCGGTATAGCCCTC-1_V12N28-333_C1,1,5,0,0,0,6
GGCACTGCGGTGGTTT-1_V12N28-333_C1,0,3,1,4,0,8
CGTCCTCATCGCGTGC-1_V12N28-333_C1,0,3,0,5,0,8
CTTAACTTACAGTATA-1_V12N28-333_C1,0,2,0,4,0,6
GTGAGTCGACTAATAG-1_V12N28-333_C1,0,5,0,2,0,7
TGTACTTCCGGGCATG-1_V12N28-333_C1,1,1,0,0,0,2
CACAAACCGCAGAACT-1_V12N28-333_C1,0,2,0,3,0,5
GCTTTACACAACTGGG-1_V12N28-333_C1,0,3,5,0,0,8
CACCGATGATGGGTAC-1_V12N28-333_C1,0,4,0,2,0,6
TCAATATACAGGAGGC-1_V12N28-333_C1,0,0,2,0,0,2
AACGACCTCCTAGCCG-1_V12N28-333_C1,0,1,2,2,0,5
GTTACCAAGGCGTACG-1_V12N28-333_C1,0,0,4,0,0,4
TAGCTCACTGTGTTTG-1_V12N28-333_C1,0,0,0,0,0,0
TCGGCAGGGTTAAGGG-1_V12N28-333_C1,0,0,0,0,0,0
TGTTAACAAAGTGACT-1_V12N28-333_C1,0,0,0,0,0,0
CAGAGCGATGGATGCT-1_V12N28-333_C1,0,2,1,0,0,3
CATAGTGGGCACGCCT-1_V12N28-333_C1,0,2,0,0,0,2
AAACGCTGGGCACGAC-1_V12N28-333_C1,0,2,0,0,0,2
TGTTCTCATACTATAG-1_V12N28-333_C1,0,0,0,0,0,0
TCGACATAGCGTAGCG-1_V12N28-333_C1,0,2,9,0,0,11
GACGTTGCTCGGCGGC-1_V12N28-333_C1,0,0,0,0,0,0
CTCGAGGCAAGTTTCA-1_V12N28-333_C1,0,3,1,1,0,5
GCTGGGAGCGCGTCAA-1_V12N28-333_C1,0,0,0,0,0,0
GACGATATCACTGGGT-1_V12N28-333_C1,0,2,0,2,0,4
CAGCTCTGGGCTCACT-1_V12N28-333_C1,0,0,0,1,0,1
TAGTCTGCGGCACATT-1_V12N28-333_C1,0,2,0,3,0,5
TGGTCGATATACCTCT-1_V12N28-333_C1,0,0,0,0,0,0
TTCAGTTCAAGAGGAG-1_V12N28-333_C1,0,2,1,0,0,3
GTCTGTAGGTTGAACA-1_V12N28-333_C1,0,2,0,0,0,2
GAGAGTCTCGGGAGAG-1_V12N28-333_C1,1,2,0,2,0,5
TTGTTTGTATTACACG-1_V12N28-333_C1,0,0,0,0,0,0
GCACAGCACGGGCCGA-1_V12N28-333_C1,1,0,0,1,0,2
AAACAGTGTTCCTGGG-1_V12N28-333_C1,0,0,0,0,0,0
TGGAGAATAATCGTCC-1_V12N28-333_C1,4,2,0,3,0,9
CGCCGCGTTCTGAACG-1_V12N28-333_C1,0,1,0,0,0,1
CATGCGTTGAGAGGAG-1_V12N28-333_C1,0,1,0,0,0,1
TACGCTCCTAGAACTG-1_V12N28-333_C1,1,4,0,1,0,6
CCTTGTGAACGTGGTT-1_V12N28-333_C1,1,3,0,3,0,7
TTAAAGGCGATGCTCG-1_V12N28-333_C1,1,1,0,1,0,3
TAAAGTGCACGTCTCG-1_V12N28-333_C1,2,0,0,2,0,4
TGTCCGCAAACAATTC-1_V12N28-333_C1,0,2,0,1,0,3
AGGCCTATCATACCAA-1_V12N28-333_C1,2,1,0,2,0,5
ACTGGGATGCCAGTGC-1_V12N28-333_C1,1,5,0,0,0,6
CGATCCACCATTGTTG-1_V12N28-333_C1,1,0,0,2,0,3
GGGCATGCATGTCGAG-1_V12N28-333_C1,0,1,0,4,0,5
TCCAGGCAGGACGATC-1_V12N28-333_C1,0,4,0,0,0,4
CAATGACCCTTAATTT-1_V12N28-333_C1,0,1,0,2,0,3
ATCAAGATCCCAGGAC-1_V12N28-333_C1,1,2,0,4,0,7
CTCAGAGCTAATGTCG-1_V12N28-333_C1,0,3,0,1,0,4
CTGCGATTTCGAGATT-1_V12N28-333_C1,0,2,0,4,0,6
ATGGTATTGGGAACCG-1_V12N28-333_C1,0,1,0,1,0,2
TAGGTTCTGCTGAGAA-1_V12N28-333_C1,0,2,0,4,0,6
GCCTGTCCCGGTGCAT-1_V12N28-333_C1,4,0,0,2,0,6
GGCCTGCTCTGATGTT-1_V12N28-333_C1,1,4,1,1,0,7
TAGAGGGAGTTTATCT-1_V12N28-333_C1,0,1,0,3,0,4
CTCTACATCCTGCGTG-1_V12N28-333_C1,0,3,0,2,0,5
ACACATTTCCGTAGAC-1_V12N28-333_C1,3,0,0,5,0,8
TGGGTGTTAAGTAGAA-1_V12N28-333_C1,0,3,0,0,0,3
GAGCTCAACATGAGCG-1_V12N28-333_C1,1,2,0,4,0,7
GCACACAGCTATTACC-1_V12N28-333_C1,0,1,0,2,0,3
GCGACGGTAGTCTCCT-1_V12N28-333_C1,0,2,0,2,0,4
GTATCAAGGTACTTCC-1_V12N28-333_C1,0,1,0,0,0,1
GGAAAGGGAATTGAGC-1_V12N28-333_C1,0,1,0,1,0,2
TACACAGCCGTGGTGC-1_V12N28-333_C1,0,4,0,0,0,4
CGGTTGGGCAGGGTCC-1_V12N28-333_C1,0,2,0,1,0,3
GCACGCCGATTCCCGC-1_V12N28-333_C1,0,3,0,1,0,4
CGCTTTCCGCCAAGGT-1_V12N28-333_C1,0,2,0,4,0,6
TGCCCGATAGTTAGAA-1_V12N28-333_C1,0,2,0,0,0,2
TCAGAACGGCGGTAAT-1_V12N28-333_C1,1,2,0,1,0,4
CCACTCAGATCCGCAA-1_V12N28-333_C1,0,3,0,1,0,4
GAAGGGTCATTAAGAC-1_V12N28-333_C1,5,2,0,3,0,10
GCGGTCTTGCTTTCAC-1_V12N28-333_C1,3,1,0,0,0,4
GGAAGGACACCGTATA-1_V12N28-333_C1,0,4,0,0,0,4
CGCGGGAATTCCTTTC-1_V12N28-333_C1,0,2,0,1,0,3
TCTATCCGATTGCACA-1_V12N28-333_C1,2,3,0,1,0,6
TACTCGTTTGAATCAA-1_V12N28-333_C1,1,3,0,2,0,6
GTCTGCCGACTCGACG-1_V12N28-333_C1,1,2,0,2,0,5
TACGGGTAATAACATA-1_V12N28-333_C1,2,3,0,3,0,8
CCAGTTCGGTAACTCA-1_V12N28-333_C1,2,2,0,2,0,6
CGTGCACACCACTGTA-1_V12N28-333_C1,3,3,0,1,0,7
CTTCAGTTGGACAACG-1_V12N28-333_C1,0,2,0,3,0,5
TGATCTATCACACTCT-1_V12N28-333_C1,2,2,0,1,0,5
TAGCAGATACTTAGGG-1_V12N28-333_C1,0,0,0,4,0,4
CACCGGGCATCACAAG-1_V12N28-333_C1,1,1,0,4,0,6
AGTGGCCCGCAAATGG-1_V12N28-333_C1,1,3,0,3,0,7
CTCGCTAGGTAAGCGA-1_V12N28-333_C1,1,3,0,3,0,7
GATAGATAGTACAGTC-1_V12N28-333_C1,0,5,0,2,0,7
CGAGACTACTGCTGCT-1_V12N28-333_C1,0,0,0,1,0,1
ACATTTGAAACCTAAC-1_V12N28-333_C1,2,3,0,1,0,6
GACACAGCCGGGACTG-1_V12N28-333_C1,1,3,0,2,0,6
ACGGAACACGAGTGCC-1_V12N28-333_C1,2,0,0,5,0,7
ACGCCAGTGCGTTTGC-1_V12N28-333_C1,0,2,0,4,0,6
GCACCTAGGCGAGTCC-1_V12N28-333_C1,0,1,0,2,0,3
TCACTATCCCTTCGGT-1_V12N28-333_C1,0,5,0,3,0,8
TGAGTGTAACAACGGG-1_V12N28-333_C1,1,1,0,3,0,5
ATTGGTTGTGCATTAC-1_V12N28-333_C1,0,2,0,1,0,3
CTGGCGATTTACATGT-1_V12N28-333_C1,0,2,0,3,0,5
TCCACCAAGACATAGG-1_V12N28-333_C1,0,2,0,3,0,5
AACGTCGCTGCACTTC-1_V12N28-333_C1,3,3,0,1,0,7
GTCTCCCGAGTCCCGT-1_V12N28-333_C1,1,2,0,1,0,4
AGCCCGCACTACAATG-1_V12N28-333_C1,0,7,0,0,0,7
GGCACGCTGCTACAGT-1_V12N28-333_C1,2,3,0,0,0,5
GCTTGAGTGACCTCTG-1_V12N28-333_C1,1,8,0,3,0,12
ATAGCCATAACAGTCA-1_V12N28-333_C1,1,4,0,0,0,5
TAGGAGGCTCGAGAAC-1_V12N28-333_C1,0,2,0,5,0,7
GTCGGGTGAAGTACCG-1_V12N28-333_C1,2,5,0,2,0,9
CACCCGCGTTTGACAC-1_V12N28-333_C1,6,1,0,1,0,8
TCTCAGGCTACTCGCT-1_V12N28-333_C1,0,4,0,1,0,5
TAGATTCTCTAGCAAA-1_V12N28-333_C1,1,3,0,1,0,5
CCCATTATTGTATCCT-1_V12N28-333_C1,0,0,0,0,0,0
GTTAATAGCGTCATTA-1_V12N28-333_C1,0,0,0,0,0,0
TAGTGACAAGCTCTAC-1_V12N28-333_C1,0,0,0,0,0,0
CTGCTCTCAACACACC-1_V12N28-333_C1,0,0,0,0,0,0
GCATGACACAAAGGAA-1_V12N28-333_C1,0,1,0,0,0,1
CAACGATCGATCCAAT-1_V12N28-333_C1,0,4,0,0,0,4
CTTAGATGTTTCATCC-1_V12N28-333_C1,0,0,0,0,0,0
TAAATTGTGGGTAAAG-1_V12N28-333_C1,0,0,0,0,0,0
GCGTCGTAACATGGTC-1_V12N28-333_C1,0,1,0,0,0,1
CTATCACAACGCTGGA-1_V12N28-333_C1,0,1,0,0,0,1
TCAGCGCACGCCGTTT-1_V12N28-333_C1,0,1,0,0,0,1
CTTACATAGATTTCTT-1_V12N28-333_C1,0,0,0,0,0,0
AGCAGTCGAAGCATGC-1_V12N28-333_C1,0,1,0,0,0,1
TTGGCCAAATTGTATC-1_V12N28-333_C1,0,2,0,0,0,2
AGTAATCTAAGGGTGG-1_V12N28-333_C1,0,2,0,1,0,3
CCCTACCCACACCCAG-1_V12N28-333_C1,0,1,0,2,0,3
TCGCCTCCTTCGGCTC-1_V12N28-333_C1,0,0,0,2,0,2
GACTTCAACGCATCAA-1_V12N28-333_C1,0,1,0,0,0,1
AGAACTGTACTTTGTA-1_V12N28-333_C1,0,2,0,2,0,4
GGCCAATTGTATAGAC-1_V12N28-333_C1,0,0,0,0,0,0
AATACCTGATGTGAAC-1_V12N28-333_C1,0,2,0,0,0,2
GCTTCCATGTAACCGC-1_V12N28-333_C1,0,2,0,0,0,2
TCAATCCGGGAAGTTT-1_V12N28-333_C1,0,0,0,1,0,1
CTCATAAATGTGTATA-1_V12N28-333_C1,0,0,0,1,0,1
GCTAAGCCCAGTATGC-1_V12N28-333_C1,0,0,0,0,0,0
GCGGATTACTTGTTCT-1_V12N28-333_C1,0,1,0,2,0,3
TCTAACCTAGCCTGCG-1_V12N28-333_C1,0,0,0,0,0,0
GTCTTACCACGCCAAG-1_V12N28-333_C1,1,1,0,2,0,4
CGTTTCGGTTATATGC-1_V12N28-333_C1,3,1,0,1,0,5
CGTTAAATACGACCAG-1_V12N28-333_C1,1,2,0,0,0,3
ACGCTACTGAATGGGC-1_V12N28-333_C1,0,3,0,1,0,4
GCCCGTCAAGCCCAAT-1_V12N28-333_C1,0,0,0,0,0,0
TCAAATTATGTTCGAC-1_V12N28-333_C1,0,1,0,0,0,1
