key,astrocyte,oligo,other,microglia,neuron,n_cells
ACGCCTGACACGCGCT-1_V12N28-333_A1,1,0,0,0,0,1
TACCGATCCAACACTT-1_V12N28-333_A1,3,2,0,0,0,5
ATTAAAGCGGACGAGC-1_V12N28-333_A1,3,1,0,0,0,4
GATAAGGGACGATTAG-1_V12N28-333_A1,1,3,1,0,0,5
GTGCAAATCACCAATA-1_V12N28-333_A1,0,4,1,0,0,5
TGTTGGCTGGCGGAAG-1_V12N28-333_A1,2,4,0,0,0,6
GCATCCTCTCCTATTA-1_V12N28-333_A1,2,0,6,0,0,8
GCGAGGGACTGCTAGA-1_V12N28-333_A1,1,0,0,0,0,1
TGGTACCGGCACAGCC-1_V12N28-333_A1,2,0,0,0,0,2
GCGCGTTTAAATCGTA-1_V12N28-333_A1,1,0,1,0,0,2
TGCCTTGCCCTTACGG-1_V12N28-333_A1,1,2,0,0,0,3
GACGACTTTCCAAGAA-1_V12N28-333_A1,0,1,0,0,0,1
CCAGTGAGCTCCTTGT-1_V12N28-333_A1,3,4,0,0,0,7
ATACCCTGGCTCAAAT-1_V12N28-333_A1,3,3,0,0,0,6
GGGTTTCCGGCTTCCA-1_V12N28-333_A1,2,4,0,0,0,6
TAACCGTCCAGTTCAT-1_V12N28-333_A1,2,2,0,0,0,4
AAACAACGAATAGTTC-1_V12N28-333_A1,1,2,0,0,0,3
CAAGGGAGTGTATTTG-1_V12N28-333_A1,0,1,0,0,0,1
CCAAGCTTGATCTCCT-1_V12N28-333_A1,0,5,0,0,0,5
TTATTTCATCCCAAAC-1_V12N28-333_A1,1,3,0,0,0,4
GAGCGCTATGTCAGGC-1_V12N28-333_A1,1,4,0,0,0,5
TATGGCAGACTTTCGA-1_V12N28-333_A1,2,2,0,0,0,4
CTTCGTGCCCGCATCG-1_V12N28-333_A1,1,2,0,0,0,3
AAACGGGTTGGTATCC-1_V12N28-333_A1,1,4,0,0,0,5
TGCAAACCCACATCAA-1_V12N28-333_A1,1,1,0,0,0,2
GACGGGATGTCTTATG-1_V12N28-333_A1,3,1,0,0,0,4
GGCGAGCATCGAGGAC-1_V12N28-333_A1,2,2,0,0,0,4
CGCGTGCTATCAACGA-1_V12N28-333_A1,2,0,0,0,0,2
TGAAACCTCAACTCAC-1_V12N28-333_A1,3,0,0,0,0,3
CACATAAGGCGACCGT-1_V12N28-333_A1,1,6,0,0,0,7
TGACCCAACTCACATT-1_V12N28-333_A1,1,0,0,0,0,1
ATACGCCGATCTACCG-1_V12N28-333_A1,5,0,0,0,0,5
ACTTATCTGATCTATA-1_V12N28-333_A1,8,1,1,1,0,11
GTGTGAGCCGAGGTGC-1_V12N28-333_A1,3,0,0,0,0,3
GATGATTTGAAACTGG-1_V12N28-333_A1,2,0,0,0,0,2
GGGAACCACCTGTTTC-1_V12N28-333_A1,2,0,0,0,0,2
GTTCGTTGCGGACCAG-1_V12N28-333_A1,5,0,2,0,0,7
TGAGGTTGATCCCAAG-1_V12N28-333_A1,4,0,0,0,0,4
GATGCCACACTACAGC-1_V12N28-333_A1,1,0,1,0,0,2
AGGCAAAGAGGAATCA-1_V12N28-333_A1,3,0,2,0,0,5
AAGTAAGCTTCCAAAC-1_V12N28-333_A1,1,0,1,1,0,3
AACGTAGTCTACCCAT-1_V12N28-333_A1,2,0,4,0,0,6
GTTTGAGCGGTTATGT-1_V12N28-333_A1,3,0,2,1,0,6
GAAGCAAGGCAATGTT-1_V12N28-333_A1,2,0,2,0,0,4
TCACTCAGCGCATTAG-1_V12N28-333_A1,0,0,3,0,0,3
TACAATGAAACCAGCA-1_V12N28-333_A1,1,0,3,0,0,4
GTGCGCTTACAAATGA-1_V12N28-333_A1,1,0,5,0,0,6
GCACTCCCACAGTCCC-1_V12N28-333_A1,1,0,2,0,0,3
CGAAGACTGCCCGGGA-1_V12N28-333_A1,0,0,6,0,0,6
CAGGATCCGCCCGACC-1_V12N28-333_A1,1,0,2,3,0,6
CACGATTGGTCGTTAA-1_V12N28-333_A1,2,0,2,0,0,4
GGTTGTATCGTGAAAT-1_V12N28-333_A1,2,0,2,1,0,5
TCTTATGGGTAGTACC-1_V12N28-333_A1,1,0,3,0,0,4
TACAAGCTGTTCACTG-1_V12N28-333_A1,0,0,3,0,0,3
GTATCTTGTTGCTCAC-1_V12N28-333_A1,1,0,1,0,0,2
ATACCAGGTGAGCGAT-1_V12N28-333_A1,0,1,3,0,0,4
CCTAAACAGGGTCCGT-1_V12N28-333_A1,0,1,2,1,0,4
ATGGTGCTCAAAGCCA-1_V12N28-333_A1,0,1,2,0,0,3
CAAATGCGGAGTGTTC-1_V12N28-333_A1,0,5,0,0,0,5
CGTGCCCGACATTTGT-1_V12N28-333_A1,0,4,1,0,0,5
GTATCTCCCTAACTGT-1_V12N28-333_A1,0,4,3,0,0,7
ATTTGCCTAGTTACGA-1_V12N28-333_A1,0,5,0,2,0,7
ACGTCCTAAACGAGAT-1_V12N28-333_A1,0,0,3,0,0,3
CTGGGATCGCCCAGAT-1_V12N28-333_A1,0,3,5,0,0,8
CTGCAAATGGGCTCCA-1_V12N28-333_A1,0,3,2,1,0,6
CATTATAACAGGGTCC-1_V12N28-333_A1,0,4,1,1,0,6
ACCTTTCCTTTAGAAG-1_V12N28-333_A1,0,0,3,1,0,4
ATAGATTTGCAGTCGG-1_V12N28-333_A1,0,1,3,2,0,6
CTCGGGCATCGTCGGG-1_V12N28-333_A1,0,0,1,2,0,3
GTGGCGGGCCGTAGCT-1_V12N28-333_A1,0,2,2,3,0,7
CAACAGTGCCAAACGG-1_V12N28-333_A1,0,1,3,0,0,4
TGCGGGTATTGGGATC-1_V12N28-333_A1,0,2,4,0,0,6
GTCTCGCCAACACGCC-1_V12N28-333_A1,0,3,2,0,0,5
CTGGGCGGCCAAATGT-1_V12N28-333_A1,1,0,2,0,0,3
TAAAGGAGAAACTAGT-1_V12N28-333_A1,1,2,0,2,0,5
TCCCACGGAGGGAGCT-1_V12N28-333_A1,0,4,1,0,0,5
AGCTTCAATACTTTGA-1_V12N28-333_A1,1,4,0,0,0,5
TTCCACATTTCTCGTC-1_V12N28-333_A1,1,2,3,0,0,6
ACAAACCGACAAGGCG-1_V12N28-333_A1,0,1,4,0,0,5
AGACGGGATTGGTATA-1_V12N28-333_A1,0,6,1,0,0,7
AACCTAAAGCCGTCCG-1_V12N28-333_A1,0,0,2,0,0,2
TACAAATTGCGGAGGT-1_V12N28-333_A1,0,3,2,1,0,6
CCCGCTAGAGGGTTAA-1_V12N28-333_A1,0,1,1,0,0,2
CATTGCAAAGCATAAT-1_V12N28-333_A1,1,4,0,0,0,5
TGTACGCTATCAGCTT-1_V12N28-333_A1,1,1,3,1,0,6
TTCTTCGCAATAGAGC-1_V12N28-333_A1,0,1,5,0,0,6
TGTGATTCCAGCGCTT-1_V12N28-333_A1,1,5,2,1,0,9
ATTCAGGATCGCCTCT-1_V12N28-333_A1,1,1,1,0,0,3
GCCCATGGGTGCAATG-1_V12N28-333_A1,0,2,1,0,0,3
TTCCCGACGCTTCACT-1_V12N28-333_A1,2,1,0,0,0,3
AGCGGTTGAGATGTAC-1_V12N28-333_A1,2,4,4,0,0,10
GCTGTCTGTGATCGAC-1_V12N28-333_A1,1,3,0,1,0,5
AAAGACATGAAGTTTA-1_V12N28-333_A1,0,3,2,0,0,5
CAACAGAATAACGCTA-1_V12N28-333_A1,1,6,0,0,0,7
TGCGGTCTACGAGTAA-1_V12N28-333_A1,1,1,0,0,0,2
AAGACTCACGCCCACT-1_V12N28-333_A1,0,1,2,1,0,4
CTTTGAAACATATTCC-1_V12N28-333_A1,2,2,0,0,0,4
CTGGGCACTAGTCGGA-1_V12N28-333_A1,0,3,1,1,0,5
CGCCCTTACATCCACC-1_V12N28-333_A1,0,1,1,0,0,2
CACGACCACAGACTTT-1_V12N28-333_A1,1,2,2,0,0,5
CAATCCATTATCCGTT-1_V12N28-333_A1,0,1,2,0,0,3
GTGGCGTGCACCAGAG-1_V12N28-333_A1,0,3,2,0,0,5
CGGAGTCCTAACCTGG-1_V12N28-333_A1,0,3,2,0,0,5
GGTCCCATAACATAGA-1_V12N28-333_A1,0,2,2,0,0,4
ATCTCATAAACCTACC-1_V12N28-333_A1,0,0,0,0,1,1
TGCATGGCAGTCTTGC-1_V12N28-333_A1,0,2,0,0,0,2
TTGCAGGTCATGAAGT-1_V12N28-333_A1,0,2,5,0,0,7
AGCTGCATTTGAGGTG-1_V12N28-333_A1,0,0,3,0,2,5
TAATCAGGAATGCTGC-1_V12N28-333_A1,1,2,2,0,0,5
CCATCATAAGAACAGG-1_V12N28-333_A1,0,0,0,0,0,0
TCGTATCACCAAGCTA-1_V12N28-333_A1,0,0,2,0,2,4
ATTCAGATGAATCCCT-1_V12N28-333_A1,0,0,2,0,1,3
AAAGGTCAACGACATG-1_V12N28-333_A1,1,3,0,0,2,6
AGCTGCTGTGCCGAAT-1_V12N28-333_A1,0,1,1,0,1,3
CTAGCGCCAATCCTAC-1_V12N28-333_A1,0,0,6,0,1,7
GCTCGACCGAACTGAA-1_V12N28-333_A1,0,0,1,0,1,2
ACAGTGCAGCGCATTT-1_V12N28-333_A1,0,0,0,0,1,1
CGGCTGAAGGTTACGC-1_V12N28-333_A1,0,0,1,0,0,1
CACCTCTACGAGTGTG-1_V12N28-333_A1,0,2,2,0,0,4
ATACGACAGATGGGTA-1_V12N28-333_A1,1,2,0,0,0,3
ACTTCCTGTCGTGCGA-1_V12N28-333_A1,0,1,1,0,1,3
CGTAACGGAACGATCA-1_V12N28-333_A1,0,0,0,0,0,0
AAATCACTCCTAAACG-1_V12N28-333_A1,0,0,1,0,0,1
CTCCGAGTAAATCCGC-1_V12N28-333_A1,0,0,3,0,0,3
ACGCTAGTATCAGTGC-1_V12N28-333_A1,0,2,5,0,0,7
AGAGTGAACAGACACC-1_V12N28-333_A1,0,0,2,0,2,4
ACACCCGTAAATCTGT-1_V12N28-333_A1,0,0,0,0,0,0
ACAGGAGGCGCAGCCG-1_V12N28-333_A1,3,1,0,0,0,4
AGGCAATACGGAGGAC-1_V12N28-333_A1,3,1,0,0,0,4
TGGTGTGACAGACGAT-1_V12N28-333_A1,3,2,0,0,0,5
ATCTATCGATGATCAA-1_V12N28-333_A1,2,4,0,0,0,6
CGGTAACAAGATACAT-1_V12N28-333_A1,2,3,0,0,0,5
TCGCCGGAGAGTCTTA-1_V12N28-333_A1,1,1,0,0,0,2
GGAGGAGTGTGTTTAT-1_V12N28-333_A1,2,2,0,0,0,4
TTAGGTGTGACTGGTC-1_V12N28-333_A1,2,5,0,0,0,7
CAGGGCTAACGAAACC-1_V12N28-333_A1,4,0,0,0,0,4
CCCGTGGGTTAATTGA-1_V12N28-333_A1,1,2,1,0,0,4
GACCGACCGCTAATAT-1_V12N28-333_A1,2,3,0,0,0,5
GGTATCAAGCATAGAA-1_V12N28-333_A1,2,2,0,0,0,4
TGCATGAGTAGATTCG-1_V12N28-333_A1,3,1,0,0,0,4
AATTCCAACTTGGTGA-1_V12N28-333_A1,3,2,0,0,0,5
TGCCGATGTCATCAAT-1_V12N28-333_A1,1,2,0,1,0,4
GCTGGGTCCGCTGTTA-1_V12N28-333_A1,2,0,0,0,0,2
TGAACACCCGAAGCAG-1_V12N28-333_A1,1,7,0,0,0,8
AACATTGGTCAGCCGT-1_V12N28-333_A1,1,2,0,0,0,3
GTGGGTCTTCTTTGCG-1_V12N28-333_A1,2,0,0,0,0,2
CATCGAATGGATCTCT-1_V12N28-333_A1,1,4,0,0,0,5
GCTACACTGTCCGAAC-1_V12N28-333_A1,1,1,0,0,0,2
CGGGTTGTAGCTTTGG-1_V12N28-333_A1,1,4,0,0,0,5
CCTAAGTGTCTAACCG-1_V12N28-333_A1,4,5,0,0,0,9
TCTGTGACTGACCGTT-1_V12N28-333_A1,0,6,0,0,0,6
TTATCATACTCGCAAA-1_V12N28-333_A1,3,1,0,0,0,4
AGCGTAGCGCTAGACC-1_V12N28-333_A1,1,3,0,0,0,4
TCCCTCCGAAATCGTT-1_V12N28-333_A1,2,2,0,0,0,4
AGGTCGCCACTTCGGT-1_V12N28-333_A1,1,6,0,0,0,7
CTAGCAACTAATTTAC-1_V12N28-333_A1,3,4,0,0,0,7
TTGCTAGCTACCAATC-1_V12N28-333_A1,6,4,0,0,0,10
GCCGGTTTGGGCGGAT-1_V12N28-333_A1,2,3,0,0,0,5
TGTAACTTGTCAACCT-1_V12N28-333_A1,3,4,0,0,0,7
CGAGATGTTGCCTATA-1_V12N28-333_A1,3,0,0,0,0,3
GTTACGAAATCCACGC-1_V12N28-333_A1,2,1,0,0,0,3
CTTGTCGTACGTGTCA-1_V12N28-333_A1,1,0,0,0,0,1
GCGTCCAGCTCGTGGC-1_V12N28-333_A1,0,0,0,0,0,0
CCCTTCTCGTACGCGA-1_V12N28-333_A1,3,1,0,0,0,4
CCAAAGTCCCGCTAAC-1_V12N28-333_A1,0,1,0,0,0,1
CCGCTTCGCGGTTAAC-1_V12N28-333_A1,1,1,2,0,0,4
GTTACGGCCCGACTGC-1_V12N28-333_A1,3,0,0,0,0,3
CCCGCTTGCCCTCGTC-1_V12N28-333_A1,4,0,1,0,0,5
TAGTGAGAAGTGGTTG-1_V12N28-333_A1,1,3,1,0,0,5
CGCTACCGCCCTATGA-1_V12N28-333_A1,2,1,2,0,0,5
AAACAATCTACTAGCA-1_V12N28-333_A1,2,2,1,0,0,5
GCGCGATGGGTCAAGT-1_V12N28-333_A1,2,0,3,0,0,5
ATAAACCATTGGACGG-1_V12N28-333_A1,2,3,0,0,0,5
TCGGGCACTTCTGGAT-1_V12N28-333_A1,3,1,1,0,0,5
TCTGTGGCTACATTTC-1_V12N28-333_A1,2,0,1,0,0,3
CTCTGTGCCTGCTATG-1_V12N28-333_A1,1,2,0,1,0,4
CACGACTAAAGTTCTG-1_V12N28-333_A1,2,2,0,1,0,5
GAGGAGTAATTCCTAC-1_V12N28-333_A1,2,1,3,0,0,6
AGAGGTATCTCGGTCC-1_V12N28-333_A1,0,0,1,0,0,1
GGCGTACCCTATATAA-1_V12N28-333_A1,0,5,2,0,0,7
GCCGGAAACACATCTT-1_V12N28-333_A1,1,1,0,0,0,2
AAATGTGGGTGCTCCT-1_V12N28-333_A1,0,1,2,0,0,3
ACCAGGAGTGTGATCT-1_V12N28-333_A1,0,2,1,0,0,3
TGTGGAGGAAGCTTAA-1_V12N28-333_A1,2,2,2,0,0,6
AAGGAGAACTTATAAG-1_V12N28-333_A1,0,2,3,0,0,5
CCCTCGGGAGCCTTGT-1_V12N28-333_A1,0,1,1,0,0,2
ACTGTTTAGTGTAGGC-1_V12N28-333_A1,0,2,2,0,0,4
CGTCAGTTTATCGTCT-1_V12N28-333_A1,0,0,3,0,0,3
GCGTGTATGTCGTATT-1_V12N28-333_A1,0,0,2,0,0,2
ACAATCGATCTTTATA-1_V12N28-333_A1,0,3,0,0,0,3
CAGCCCTCACAGGCAG-1_V12N28-333_A1,0,3,0,0,0,3
CGCGTCATATTAAACC-1_V12N28-333_A1,1,5,0,0,0,6
GAAGACTTCAATGCCG-1_V12N28-333_A1,0,4,1,0,0,5
TTGCGGCGACTCATGC-1_V12N28-333_A1,0,0,2,0,0,2
ACCAAACTAGAAATCC-1_V12N28-333_A1,1,1,1,1,0,4
TTACTGTTTCTCTACG-1_V12N28-333_A1,1,3,1,0,0,5
GACCAGGTCATTCATA-1_V12N28-333_A1,0,0,1,0,0,1
TTCTTCCCTTTGATAT-1_V12N28-333_A1,0,2,1,2,0,5
ACGCCCAGCTGTCGAT-1_V12N28-333_A1,0,0,3,1,0,4
AGTAGCGTGAACGAAC-1_V12N28-333_A1,0,2,1,0,0,3
CCTCGACCCACTGCCT-1_V12N28-333_A1,0,4,2,0,1,7
AGTTATTGAAAGGTAA-1_V12N28-333_A1,0,0,3,0,0,3
TCAGTTACGGAATGAT-1_V12N28-333_A1,0,0,5,0,0,5
GAATCTATACTCGGAC-1_V12N28-333_A1,0,2,1,0,0,3
TCGGCTAACTTCCCTT-1_V12N28-333_A1,0,1,1,0,0,2
ACGTGGTCGAATGTGC-1_V12N28-333_A1,0,1,1,0,0,2
ATATCGTGCCAGACCC-1_V12N28-333_A1,0,2,3,0,0,5
GTAGCTAGTAAGCGCG-1_V12N28-333_A1,0,1,0,0,0,1
ACGCTTAGTGTCTCTC-1_V12N28-333_A1,0,3,0,1,0,4
TCCGGCCTGCATCGAT-1_V12N28-333_A1,0,1,1,1,0,3
TAGTGGAACTCATACA-1_V12N28-333_A1,1,3,2,0,0,6
ATCATCTGCCCAGTGT-1_V12N28-333_A1,0,3,2,0,0,5
GTTATTAAATACGACC-1_V12N28-333_A1,0,2,2,0,0,4
GCGCTAAGTATGCATG-1_V12N28-333_A1,1,3,3,0,0,7
CCTGACGCAACCTTTA-1_V12N28-333_A1,0,2,2,0,0,4
CCCAAGAATGCACGGT-1_V12N28-333_A1,2,3,1,0,0,6
AACTGGGTTCGAGCCG-1_V12N28-333_A1,0,4,1,0,0,5
GGTTCCACCCGCTTCT-1_V12N28-333_A1,1,4,0,0,0,5
CATGCACGTGTTACTG-1_V12N28-333_A1,0,0,3,0,0,3
AGCGTTCCGATTTAAA-1_V12N28-333_A1,1,5,0,1,0,7
CCTACGCGACCTTACA-1_V12N28-333_A1,1,2,1,0,0,4
CGAATTACATGGTGTT-1_V12N28-333_A1,0,1,0,0,0,1
GAGGTCTTAGTGGGTC-1_V12N28-333_A1,0,0,0,0,0,0
GCCGCTAGATACGCAG-1_V12N28-333_A1,1,3,0,0,1,5
GTCACCTGTCTATGTC-1_V12N28-333_A1,1,1,0,0,0,2
CCGATTGGTCAATGAA-1_V12N28-333_A1,1,1,1,0,0,3
CCTGTGCGGATTGTAA-1_V12N28-333_A1,1,4,2,0,0,7
TTACGTAGCGCGTGCT-1_V12N28-333_A1,2,0,1,1,0,4
GGAGGCGAAGAACCGC-1_V12N28-333_A1,2,3,0,0,0,5
GGGTCACGTGCTTATG-1_V12N28-333_A1,1,0,1,0,0,2
GCTCCGGACGTTGATA-1_V12N28-333_A1,0,2,2,0,1,5
ATGTTTGTAAGATCAT-1_V12N28-333_A1,0,4,1,0,0,5
TGACCCAGCATTCCCG-1_V12N28-333_A1,0,1,3,0,1,5
TGGTCGTTTGATAGAT-1_V12N28-333_A1,0,0,2,0,1,3
TGTAATGCCTTCGGAC-1_V12N28-333_A1,0,2,1,0,0,3
TGCTCACACAACAACC-1_V12N28-333_A1,0,1,2,0,0,3
TACGATCCAAGCCACT-1_V12N28-333_A1,0,1,3,0,0,4
TTGTAACTTCATAGCG-1_V12N28-333_A1,0,0,1,0,0,1
AGATTCAAGCGGGTCG-1_V12N28-333_A1,0,0,2,0,2,4
CTCAGCAGACTGCCGA-1_V12N28-333_A1,0,1,2,0,2,5
GTAACATCAGCTCATC-1_V12N28-333_A1,1,0,2,0,1,4
ATGGAACAGAATAAAC-1_V12N28-333_A1,0,0,3,0,1,4
GGGCCTATACAACCGG-1_V12N28-333_A1,0,0,2,0,0,2
TCAAACAATTAGGACA-1_V12N28-333_A1,0,1,0,0,0,1
AAACCACTACACAGAT-1_V12N28-333_A1,0,0,2,0,0,2
AAACGACAGTCTTGCC-1_V12N28-333_A1,0,1,2,0,0,3
TTGAGGGTCGAACGCG-1_V12N28-333_A1,0,0,0,0,0,0
TGTTGATCACTGTTTA-1_V12N28-333_A1,0,0,0,0,1,1
AGGGTGTGCTACACGC-1_V12N28-333_A1,3,4,0,0,1,8
GTAGTTAGACAATATA-1_V12N28-333_A1,0,0,2,0,0,2
AATGGCCGCCAATGCG-1_V12N28-333_A1,0,0,2,0,5,7
TCGGCGGTATTAGATT-1_V12N28-333_A1,0,1,2,0,0,3
GGGTCACTGAGTAGTG-1_V12N28-333_A1,0,0,2,0,0,2
GAATTATGCAACCTAC-1_V12N28-333_A1,0,0,0,0,0,0
GATCTTAGTGAACGTG-1_V12N28-333_A1,0,0,0,0,0,0
CTAATGCGCCCAACAA-1_V12N28-333_A1,0,1,0,0,0,1
GCCACCCATTCCACTT-1_V12N28-333_A1,1,4,0,0,0,5
TACTCACAACGTAGTA-1_V12N28-333_A1,2,1,0,0,0,3
GTTCGGTGTGGATTTA-1_V12N28-333_A1,1,1,0,0,1,3
TCTTTCGGCGGGACAC-1_V12N28-333_A1,0,2,0,0,0,2
GGAGACATTCACGGGC-1_V12N28-333_A1,2,2,0,0,0,4
GGGATTATCTCACAAC-1_V12N28-333_A1,1,1,0,0,0,2
TAGAACGCCAGTAACG-1_V12N28-333_A1,3,0,0,0,0,3
ACGAGTCGCCGGCGTT-1_V12N28-333_A1,2,0,0,0,0,2
TGATGGGACTAAGTCA-1_V12N28-333_A1,2,2,0,0,0,4
TGCGAGAAACGTTACG-1_V12N28-333_A1,0,1,0,0,0,1
TCGCCTCGACCTGTTG-1_V12N28-333_A1,2,0,0,0,0,2
AACTCGATAAACACGT-1_V12N28-333_A1,1,2,0,0,0,3
AGGAAAGCCTCTGATG-1_V12N28-333_A1,1,1,0,0,0,2
GAAGGACTAAATTGAA-1_V12N28-333_A1,3,0,0,0,0,3
GTATCGGGACGAGCTG-1_V12N28-333_A1,4,1,0,0,0,5
CCTGTGCATAGGAGAC-1_V12N28-333_A1,3,3,0,0,1,7
CATACGGGTGCATGAT-1_V12N28-333_A1,4,2,0,0,1,7
CCACTAAACTGAATCG-1_V12N28-333_A1,3,2,0,0,0,5
AAATTGCGGCGGTTCT-1_V12N28-333_A1,2,0,0,0,0,2
AGTCCAGCGGGTACGT-1_V12N28-333_A1,2,2,0,0,0,4
CATTCAGGTCAGTGCG-1_V12N28-333_A1,2,2,0,0,0,4
CTAAAGTCCGAAGCTA-1_V12N28-333_A1,3,3,1,0,0,7
AATCAGACTGCAGGAC-1_V12N28-333_A1,0,4,0,0,0,4
AGTATCCATAATAACG-1_V12N28-333_A1,3,1,0,0,0,4
CTGGCTGCTAACGTAA-1_V12N28-333_A1,0,2,0,0,0,2
GTTCCAAGACAGCGAC-1_V12N28-333_A1,1,4,0,0,1,6
AAGACTAACCCGTTGT-1_V12N28-333_A1,0,2,0,0,0,2
GATTAATCCTGGCTCA-1_V12N28-333_A1,0,5,0,0,0,5
CGCGCAAGGAACTACA-1_V12N28-333_A1,2,1,0,0,0,3
CAGTAGCGAGGTAGTA-1_V12N28-333_A1,2,3,0,0,0,5
ACGGCGGGTTGCCCTG-1_V12N28-333_A1,3,0,0,0,0,3
CTAGGCGGCAGAGAAT-1_V12N28-333_A1,2,3,0,0,0,5
GTGCGCAGCTTGCTCC-1_V12N28-333_A1,2,2,0,0,0,4
TCACTATCGTGCAATC-1_V12N28-333_A1,1,2,0,0,0,3
TATGATTCTGCTTGGT-1_V12N28-333_A1,3,6,0,0,0,9
TAAGATTTAGCGGGAG-1_V12N28-333_A1,2,2,1,0,0,5
TTACGGTGTCACCGAG-1_V12N28-333_A1,1,4,0,0,0,5
CTACACTAGCTTGTTC-1_V12N28-333_A1,1,2,0,0,0,3
TGAGCAGTCGTGAAGT-1_V12N28-333_A1,2,1,0,0,0,3
CGCTGAGGACGTCCAA-1_V12N28-333_A1,1,2,0,0,0,3
GTGTATGACTTTAAAG-1_V12N28-333_A1,1,5,0,0,0,6
CTAAACGGGTGTAATC-1_V12N28-333_A1,3,2,0,0,0,5
TGTACTGTGCCAAAGT-1_V12N28-333_A1,2,2,0,0,0,4
GGCCACAAGCGATGGC-1_V12N28-333_A1,1,2,0,0,0,3
GTCAATTGTACTGAAG-1_V12N28-333_A1,0,3,0,0,0,3
AGGGACAGCACGGCGG-1_V12N28-333_A1,1,3,0,0,0,4
AGCTTATAGAGACCTG-1_V12N28-333_A1,5,5,0,0,0,10
AACTAGCGTATCGCAC-1_V12N28-333_A1,1,4,0,1,0,6
AACTTTAGCTGCTGAG-1_V12N28-333_A1,5,4,0,0,0,9
CCCAAGACAGAGTATG-1_V12N28-333_A1,0,1,0,0,0,1
GGCATCAACGAGCACG-1_V12N28-333_A1,1,0,0,0,0,1
ATGCATTCCGTGATGG-1_V12N28-333_A1,1,0,2,0,0,3
TTATAGATGCACATTA-1_V12N28-333_A1,0,4,1,0,0,5
GAACCATCTGGGAGAC-1_V12N28-333_A1,0,4,0,0,0,4
TGCTATACAAACGGAC-1_V12N28-333_A1,1,3,0,0,0,4
ACTTGCCATATTGTAC-1_V12N28-333_A1,0,6,0,1,0,7
TATTCCGGCAGTCCTA-1_V12N28-333_A1,3,0,1,0,0,4
GACGGACCGCGTTCCT-1_V12N28-333_A1,1,1,2,0,0,4
ATGTGTAGTTTAGTCA-1_V12N28-333_A1,1,3,2,0,0,6
ATACCAGCAAATTGCT-1_V12N28-333_A1,0,4,3,0,0,7
AAGTTTACTAATGGCA-1_V12N28-333_A1,0,0,4,0,0,4
CTCTCGATGTGCGCCT-1_V12N28-333_A1,0,3,1,0,0,4
GATTGACACTCTGCTC-1_V12N28-333_A1,0,4,1,0,0,5
TATCACAGCACGGGCA-1_V12N28-333_A1,0,3,2,0,0,5
ACCGTTCCCGCTCTGA-1_V12N28-333_A1,0,3,1,0,0,4
CCGCCACCACAATCCA-1_V12N28-333_A1,0,1,2,0,0,3
CATTCACTGACAGCTA-1_V12N28-333_A1,0,2,0,1,0,3
CGGCTGCAAGATTAAG-1_V12N28-333_A1,0,6,2,0,0,8
CATGAACCTCTTATCA-1_V12N28-333_A1,0,0,0,1,0,1
TTAATGCGAGGTAACT-1_V12N28-333_A1,2,0,1,1,0,4
AATAAGTCCTCGAGAC-1_V12N28-333_A1,1,1,0,0,0,2
ACCAGCCCGGTCTTTG-1_V12N28-333_A1,0,3,4,0,0,7
CTACGAACTAGGTCGA-1_V12N28-333_A1,0,0,3,0,0,3
ACATCTCAACGCGTAA-1_V12N28-333_A1,1,1,3,0,0,5
CACTACTCAGTTCTGT-1_V12N28-333_A1,0,6,1,0,0,7
CCGACTCGCATAGTCT-1_V12N28-333_A1,0,2,2,0,0,4
CATTTATCGTTCAAGA-1_V12N28-333_A1,0,4,1,0,0,5
CAAACGTGGTCTTGCG-1_V12N28-333_A1,0,4,2,0,0,6
TAGAAACCACTAAGTA-1_V12N28-333_A1,0,0,3,1,0,4
ACTGATTTAGTGATTC-1_V12N28-333_A1,1,1,4,1,0,7
TCGTATTTCGTCCGGA-1_V12N28-333_A1,0,0,1,1,0,2
CGGAAATTTCACATCC-1_V12N28-333_A1,0,1,3,1,0,5
ATCCACGCTAAATGTT-1_V12N28-333_A1,0,3,5,0,0,8
GTTCAATCTATGTCAA-1_V12N28-333_A1,0,4,4,1,0,9
ATAAAGGTCAAGTACG-1_V12N28-333_A1,0,0,1,1,0,2
CAACTCCAACGTTTAG-1_V12N28-333_A1,0,3,3,0,0,6
TAGGAACAGCCTCCAG-1_V12N28-333_A1,0,2,0,0,0,2
ATGGGAACGGAAGCGG-1_V12N28-333_A1,1,5,2,0,0,8
CACACGTTTCAATGGG-1_V12N28-333_A1,1,3,1,0,0,5
GGTGTTCTGTTTCTAC-1_V12N28-333_A1,1,1,1,0,0,3
AGTAACGTTCATCCTG-1_V12N28-333_A1,0,3,0,0,0,3
GTATAGTGGCCCATGT-1_V12N28-333_A1,0,4,1,1,0,6
TCTACACGTTCATGCA-1_V12N28-333_A1,1,3,2,0,0,6
AATCTGGGTAGACCCT-1_V12N28-333_A1,0,4,2,0,0,6
TCGGTTAGCCATGTAG-1_V12N28-333_A1,2,0,0,1,0,3
TGCCATGGCTTATAAG-1_V12N28-333_A1,2,0,1,1,0,4
TAAGTAAATGTGCCGC-1_V12N28-333_A1,1,3,1,0,0,5
GTGTCCGATAAGGCAT-1_V12N28-333_A1,1,1,1,0,0,3
TGGCACGAGCTCGAGT-1_V12N28-333_A1,0,3,4,0,0,7
ACCGGTCTGAGTACGG-1_V12N28-333_A1,1,1,3,0,0,5
GAACTTAGCGCCCGGT-1_V12N28-333_A1,0,3,0,0,0,3
AGTAGCTAGACGCCGA-1_V12N28-333_A1,0,0,1,0,0,1
ATAGGAATCTAAGCTT-1_V12N28-333_A1,1,1,4,0,0,6
CTTCCTGCATATTTAC-1_V12N28-333_A1,0,2,2,0,0,4
CAATATGTAGATTTAC-1_V12N28-333_A1,0,4,3,0,0,7
ACAAGGCCTACCAGCC-1_V12N28-333_A1,0,2,2,1,0,5
TTATAGTCCAAGGTGC-1_V12N28-333_A1,0,1,3,0,0,4
AAACGCCCGAGATCGG-1_V12N28-333_A1,0,1,1,1,2,5
CCTCGTTACGCCTGTT-1_V12N28-333_A1,0,1,3,0,0,4
GAACGGTGTAAAGCAG-1_V12N28-333_A1,0,0,1,0,2,3
ACGCATAAATGACATG-1_V12N28-333_A1,0,2,4,0,0,6
GGTTCGATGCTGAGTT-1_V12N28-333_A1,0,2,2,0,0,4
CTTTGGCAGACAGAGT-1_V12N28-333_A1,1,2,1,0,0,4
TTCGTGGGCTGGAAGC-1_V12N28-333_A1,0,1,0,0,2,3
CAAAGGTTAAATTCAG-1_V12N28-333_A1,0,2,2,0,0,4
GTTTGGCGTCAGGCAC-1_V12N28-333_A1,0,0,1,0,1,2
GCTTTCTATCTCAACT-1_V12N28-333_A1,0,1,1,0,1,3
TGCATCTCCGGATCTT-1_V12N28-333_A1,0,1,0,0,0,1
CTGAAACGGCCCTCAG-1_V12N28-333_A1,0,0,0,0,0,0
TAGCAGTAAATACGCG-1_V12N28-333_A1,0,2,2,0,0,4
CGGGCTACTTAAATTG-1_V12N28-333_A1,0,1,1,0,0,2
ATTATGCTCAGTATTG-1_V12N28-333_A1,0,0,2,0,1,3
TGATGCTCACGTAGTC-1_V12N28-333_A1,0,1,2,0,0,3
GTCTAAGATGCCCAGC-1_V12N28-333_A1,0,0,2,0,0,2
AACCCGATAGGGCTTC-1_V12N28-333_A1,0,0,0,0,0,0
CGCTATCGTGGCTTTA-1_V12N28-333_A1,0,1,1,0,2,4
CGTCTCTCGCCGAGGC-1_V12N28-333_A1,0,0,0,0,0,0
AGTGGGAGTATACACG-1_V12N28-333_A1,2,2,0,0,0,4
GGTCTTGGTGTTAACT-1_V12N28-333_A1,1,2,0,0,0,3
GGCTGGCAGCTTTATG-1_V12N28-333_A1,2,0,0,1,0,3
CGCCAATTATTGCGTT-1_V12N28-333_A1,2,0,0,0,1,3
GGTAACCGGCAAAGGT-1_V12N28-333_A1,4,1,0,0,0,5
TGGGACCATTGGGAGT-1_V12N28-333_A1,2,2,2,0,0,6
CTGCAGGTGCTCGGCC-1_V12N28-333_A1,2,1,0,0,0,3
CCGGTGCGAGTGATAG-1_V12N28-333_A1,2,0,2,0,0,4
GGGTACACTCTGGAGG-1_V12N28-333_A1,2,2,0,0,0,4
TAGCCAGAGGGTCCGG-1_V12N28-333_A1,2,2,0,0,0,4
CTTGTGAGGACAGCGG-1_V12N28-333_A1,2,0,0,0,0,2
GAAGGGCATAACCATG-1_V12N28-333_A1,1,3,0,0,0,4
CAACATGGCCTGATAA-1_V12N28-333_A1,4,2,0,0,1,7
CAATTTGACCGGGAAG-1_V12N28-333_A1,2,2,0,0,0,4
TCTGACTGTAATGGTT-1_V12N28-333_A1,2,3,0,0,0,5
TTCATAGCCTTGTAAC-1_V12N28-333_A1,0,1,0,0,0,1
TGGAAACGGAGTGAAC-1_V12N28-333_A1,1,0,0,0,1,2
ATCGCACGATTGTTCA-1_V12N28-333_A1,4,1,0,0,1,6
CGCCACCCGCATTAAC-1_V12N28-333_A1,3,1,0,0,0,4
TGGACCACGGCGTTGA-1_V12N28-333_A1,2,1,0,0,0,3
GTATATGTTACGGCGG-1_V12N28-333_A1,3,1,0,0,1,5
GTATTCTTACCGTGCT-1_V12N28-333_A1,2,2,0,0,1,5
TTCAGAGTAACCTGAC-1_V12N28-333_A1,2,4,0,0,1,7
GCGGTAACCCAAATGA-1_V12N28-333_A1,4,3,0,0,0,7
CTACGTGTTGCCACCA-1_V12N28-333_A1,1,3,0,0,0,4
CTAGATAAACTCCTCG-1_V12N28-333_A1,2,1,0,0,0,3
TCCATTAGTTGGATAG-1_V12N28-333_A1,2,5,0,0,0,7
CTGGCTCCTGCGGGAT-1_V12N28-333_A1,1,2,0,0,0,3
CAGTCTCTCGGCTAAT-1_V12N28-333_A1,0,1,0,0,0,1
GTATGACGTGGGAAAC-1_V12N28-333_A1,2,5,0,0,0,7
AGTCACTCCGCCTCAT-1_V12N28-333_A1,0,6,0,0,0,6
GCAGCGGTGGGCATTA-1_V12N28-333_A1,2,4,0,0,0,6
TATGGAGTTTCTCGTT-1_V12N28-333_A1,1,2,0,0,0,3
ACTCAACGAATGTATT-1_V12N28-333_A1,2,3,0,0,0,5
AACACGCGGCCGCGAA-1_V12N28-333_A1,5,1,0,0,0,6
CGATATTAGCCGCAGG-1_V12N28-333_A1,2,1,0,0,0,3
AGCGTCTGAACCCGCA-1_V12N28-333_A1,4,3,0,0,0,7
GATGTCCGGATCACAT-1_V12N28-333_A1,2,1,0,0,0,3
GGTCACGTTAGATTCA-1_V12N28-333_A1,0,2,0,0,0,2
TTAAGGATACGGAGGT-1_V12N28-333_A1,0,5,0,0,0,5
GTGCGGGACCATCGGC-1_V12N28-333_A1,2,3,0,0,0,5
CCATCTTGTTCACAAT-1_V12N28-333_A1,2,1,0,0,0,3
TCCGAGAAGGCTAAGC-1_V12N28-333_A1,2,1,0,0,0,3
TGGCGGTGTGCGATTG-1_V12N28-333_A1,2,0,0,0,0,2
ATCCTGCTGCAGATAG-1_V12N28-333_A1,1,2,0,0,0,3
TTATGCGTCCCGGTCC-1_V12N28-333_A1,1,2,0,0,0,3
CATAATGAGCGGGCGA-1_V12N28-333_A1,0,2,0,0,0,2
AGACATAGATCCTTCC-1_V12N28-333_A1,2,2,0,0,0,4
GGTGAAACCGGGAATG-1_V12N28-333_A1,1,7,0,0,0,8
AACTGGTGTGGGCCTT-1_V12N28-333_A1,3,4,0,1,0,8
GTAGCGCTGTTGTAGT-1_V12N28-333_A1,3,0,1,0,0,4
TTGTTTGTGTAAATTC-1_V12N28-333_A1,2,1,0,0,0,3
GGATCAAAGGACGAGG-1_V12N28-333_A1,2,3,1,0,0,6
CGTAGCGCCGACGTTG-1_V12N28-333_A1,3,3,0,0,0,6
CAAGTGAACTTTGGTT-1_V12N28-333_A1,3,0,1,0,0,4
GTAGACAACCGATGAA-1_V12N28-333_A1,1,3,0,0,0,4
CAATGGTCGGCCTGGG-1_V12N28-333_A1,1,1,0,0,0,2
ACAGATTAGGTTAGTG-1_V12N28-333_A1,2,2,1,0,0,5
GTTATCACCTTCTGAA-1_V12N28-333_A1,0,1,2,0,0,3
TGGTATCGGTCTGTAT-1_V12N28-333_A1,1,1,0,0,0,2
GGAATAACCTCAAGAA-1_V12N28-333_A1,0,3,1,0,0,4
ATTATCTCGACAGATC-1_V12N28-333_A1,0,2,0,0,0,2
CCGAGGGATGTTAGGC-1_V12N28-333_A1,1,4,0,0,0,5
TGAGATCAAATACTCA-1_V12N28-333_A1,0,6,1,0,0,7
AAACGAAGAACATACC-1_V12N28-333_A1,0,3,2,0,0,5
CTGGTCCTAACTTGGC-1_V12N28-333_A1,0,2,3,0,0,5
TGCACGAGTCGGCAGC-1_V12N28-333_A1,0,4,1,0,0,5
ATAGTCTTTGACGTGC-1_V12N28-333_A1,0,2,1,0,0,3
TGGAGCTAAAGTTCCC-1_V12N28-333_A1,0,1,4,0,1,6
GGGTGGTCCAGCCTGT-1_V12N28-333_A1,1,1,2,0,0,4
CATGCATGGAGACCCT-1_V12N28-333_A1,0,4,2,0,0,6
ACACGGCACTATGCAT-1_V12N28-333_A1,0,7,0,1,0,8
CCCTGGTATGGGCGGC-1_V12N28-333_A1,0,2,1,0,0,3
GGAGGATTGAAAGGAG-1_V12N28-333_A1,1,0,2,0,0,3
CCGCTGGTGCCATTCA-1_V12N28-333_A1,0,1,0,0,0,1
GTTAGAGTGTGCCGCT-1_V12N28-333_A1,0,5,0,0,0,5
TCGGAATGACCATCAA-1_V12N28-333_A1,0,1,4,0,0,5
TTCAATTAGCCATAAT-1_V12N28-333_A1,0,1,2,0,0,3
GATGTGTTGTCACAAG-1_V12N28-333_A1,0,1,4,0,0,5
TCTTTCTCTTAAGGAG-1_V12N28-333_A1,0,1,4,0,2,7
ACCCTTTAGTTCTCCA-1_V12N28-333_A1,1,0,3,0,0,4
ACCACAACTCAGAACA-1_V12N28-333_A1,0,0,3,0,0,3
TATGATAAATCTAACG-1_V12N28-333_A1,0,0,0,0,0,0
GATCCTCTTGCGCTTA-1_V12N28-333_A1,0,5,1,0,0,6
TTCTACCTTTATGTTG-1_V12N28-333_A1,2,2,3,0,0,7
GAAATACCTGCTGGCT-1_V12N28-333_A1,0,8,4,0,0,12
ATTCTGAGTATGAACT-1_V12N28-333_A1,1,1,1,0,0,3
GGATTAAGCTAAGGTC-1_V12N28-333_A1,1,4,1,0,0,6
AGTACGTGGCCTGTCT-1_V12N28-333_A1,1,5,1,0,0,7
TCAGGGTGCACGAAAC-1_V12N28-333_A1,0,0,3,0,0,3
AAATTTACCGAAATCC-1_V12N28-333_A1,3,1,1,0,0,5
TTGAGGCATTTAACTC-1_V12N28-333_A1,0,3,1,2,0,6
AACCAGTATCACTCTT-1_V12N28-333_A1,1,6,2,0,0,9
CACCGGAGATATCTCC-1_V12N28-333_A1,0,2,3,1,0,6
GACTGGGCGCCGCAAC-1_V12N28-333_A1,0,1,1,0,0,2
CACGTCTATGATGTGG-1_V12N28-333_A1,3,3,0,0,0,6
TTAAGACGAACGAACC-1_V12N28-333_A1,0,2,2,0,0,4
TGACCAGCTTCAAAGT-1_V12N28-333_A1,0,0,1,0,0,1
AGAGTTAGAGACCGAT-1_V12N28-333_A1,0,3,2,0,0,5
TTCGGACTGATGCCTT-1_V12N28-333_A1,0,2,1,0,0,3
CTCGAATGGAACGTAT-1_V12N28-333_A1,1,2,2,0,0,5
GGACGGCTTGCGCAAC-1_V12N28-333_A1,1,0,3,0,0,4
CTAAGTACAGGGCTAC-1_V12N28-333_A1,4,0,1,0,0,5
ACAAATTCAGATCTGA-1_V12N28-333_A1,0,2,4,0,0,6
CATGGAAATGGGACCA-1_V12N28-333_A1,0,3,2,0,0,5
GGTGGACCACGTGTTA-1_V12N28-333_A1,0,2,2,0,0,4
CACGACGTAATAGTAA-1_V12N28-333_A1,0,0,0,0,0,0
CGGGTTCGGCACGTAT-1_V12N28-333_A1,0,3,0,0,0,3
CTGGGCTATCCTTTGG-1_V12N28-333_A1,0,1,2,0,0,3
GTATTAGGGTTCGCGT-1_V12N28-333_A1,0,1,2,0,1,4
TCATTCGTATAATTTG-1_V12N28-333_A1,0,0,0,0,0,0
AATAGCAAGCCTCCTG-1_V12N28-333_A1,0,0,1,0,0,1
CATCTACCCGAGAACG-1_V12N28-333_A1,0,3,2,0,0,5
GCTTCAGTGGGATTAC-1_V12N28-333_A1,0,0,1,0,1,2
TCTGTGATGGAGGTTG-1_V12N28-333_A1,0,0,0,0,1,1
ATCCACTTTCAGACTA-1_V12N28-333_A1,0,0,2,0,0,2
ATGGTTACGAAACATG-1_V12N28-333_A1,0,0,1,0,3,4
GGCCCAATCTAGAGGG-1_V12N28-333_A1,0,0,3,0,0,3
GATGGTGAAATAACCC-1_V12N28-333_A1,0,1,1,0,1,3
AGAGGGACAATTGTCC-1_V12N28-333_A1,0,0,1,0,0,1
CGCGTACATTCTGGAA-1_V12N28-333_A1,0,1,1,0,1,3
CAAGAAACCCTAAACT-1_V12N28-333_A1,0,1,2,0,0,3
TTGGTGCGGTGTTGAA-1_V12N28-333_A1,0,1,0,0,1,2
GGTTCCCTAGTGTCTC-1_V12N28-333_A1,1,2,0,0,0,3
CGATAACCAATTTGAG-1_V12N28-333_A1,0,0,1,0,0,1
GCCCACTGGTCCACAA-1_V12N28-333_A1,0,0,2,0,0,2
GAGGGCCGGCAGAGTC-1_V12N28-333_A1,0,1,2,0,0,3
CGACACGGATGCCCAC-1_V12N28-333_A1,0,1,2,0,1,4
CTGTCTGTGGCTGGCT-1_V12N28-333_A1,3,1,0,0,0,4
ATATTATCCCGTATTT-1_V12N28-333_A1,1,1,0,0,0,2
GCGCTGGCGGAAAGTC-1_V12N28-333_A1,3,1,0,0,0,4
ATCTAACGTCCCTATG-1_V12N28-333_A1,1,0,3,0,0,4
GTCAGACAGCGTTGGA-1_V12N28-333_A1,2,0,2,0,1,5
GCCAGGCTTAGTGGTA-1_V12N28-333_A1,0,0,3,0,0,3
ATTCAAAGTACCTGTT-1_V12N28-333_A1,1,0,0,0,0,1
TGGACGTAGGCGAATC-1_V12N28-333_A1,1,0,1,0,0,2
ACACATTGACGCAACA-1_V12N28-333_A1,1,0,1,0,0,2
GATATCAGTATGTATC-1_V12N28-333_A1,4,1,1,0,0,6
TGGGCCTTGCCTGCAT-1_V12N28-333_A1,0,1,2,0,0,3
CAAAGTCAGGTTAGCT-1_V12N28-333_A1,0,2,3,0,0,5
GGATCCCTACCAGCTA-1_V12N28-333_A1,2,1,0,0,0,3
ATCGTCCAATCGAGTC-1_V12N28-333_A1,1,1,2,0,1,5
ACATGGCTCAATTTAG-1_V12N28-333_A1,0,0,3,0,0,3
AGGCCCAGTGACTGGT-1_V12N28-333_A1,1,0,3,0,0,4
GCTTCCAGCTTAGATT-1_V12N28-333_A1,2,3,0,0,0,5
TGCTTGAAACCATGCA-1_V12N28-333_A1,1,1,3,0,0,5
CAATATTGGACTAGTG-1_V12N28-333_A1,0,0,0,0,0,0
CGTGCTGGCCTAGTCG-1_V12N28-333_A1,3,0,0,0,0,3
CCTGCGATAGAACTGT-1_V12N28-333_A1,2,3,0,0,0,5
GGGTAATGCTGTGTTT-1_V12N28-333_A1,1,0,0,0,0,1
AACGCGAACGGCAACA-1_V12N28-333_A1,2,2,1,0,0,5
TGTCGGCATGGTGGAA-1_V12N28-333_A1,5,0,0,0,0,5
AGCGTACGAGAGCTAG-1_V12N28-333_A1,1,2,0,0,1,4
ATACTCTCGCCACTCT-1_V12N28-333_A1,2,2,0,0,0,4
AATCCATGCAAGGGTG-1_V12N28-333_A1,3,1,0,0,0,4
TTAAACAGAGTCCCGC-1_V12N28-333_A1,1,0,0,0,0,1
CCACAGCTGAAATCAT-1_V12N28-333_A1,3,2,0,0,0,5
CGGTTCCGGCTTCTTG-1_V12N28-333_A1,4,2,0,0,1,7
GACGTGAGACTCCATG-1_V12N28-333_A1,3,3,0,0,0,6
TCGTTGGCTCGTCAAT-1_V12N28-333_A1,1,1,0,0,0,2
GGTGAACGGGCTAGCC-1_V12N28-333_A1,1,1,0,0,0,2
GCACTGTGCAAATGTA-1_V12N28-333_A1,4,6,0,0,0,10
ACGAGAACCCATCACG-1_V12N28-333_A1,2,5,0,0,0,7
CCAGCTACGCCTCATA-1_V12N28-333_A1,0,2,2,2,0,6
TCCCGGTCAGGAATTT-1_V12N28-333_A1,2,2,0,0,0,4
TCGCATTCAATGACTT-1_V12N28-333_A1,4,4,0,0,0,8
CTGGTTCAACGCATCA-1_V12N28-333_A1,4,4,0,0,0,8
GGTGATTTCATCTTGT-1_V12N28-333_A1,5,3,0,0,0,8
CACCCTTTCCTCGCTC-1_V12N28-333_A1,2,3,0,0,0,5
CAACTTGTAGTGGGCA-1_V12N28-333_A1,1,2,0,0,0,3
AATATCAAGGTCGGAT-1_V12N28-333_A1,3,1,0,0,0,4
ACTCAGACCTGCTTCT-1_V12N28-333_A1,0,1,0,0,0,1
TTGGAGTCTCCCTTCT-1_V12N28-333_A1,2,0,0,0,0,2
GGATACTCATGAATTG-1_V12N28-333_A1,2,0,0,0,0,2
TGGGCACAAACAGAAC-1_V12N28-333_A1,3,1,0,0,0,4
GAGCCACGGTAGTAGG-1_V12N28-333_A1,5,1,0,0,0,6
TCGATAGGCTAGTCGC-1_V12N28-333_A1,2,2,0,0,0,4
TAACCGCCCGCAGTGC-1_V12N28-333_A1,2,1,0,0,0,3
GCCTATTTGCTACACA-1_V12N28-333_A1,0,0,1,0,0,1
TTGACGATTCAGCACG-1_V12N28-333_A1,1,2,0,0,0,3
TTAAACCGGTAGCGAC-1_V12N28-333_A1,2,4,0,1,0,7
ACCGAAAGGGCCCTGC-1_V12N28-333_A1,1,1,0,0,0,2
ACGTTCCGCGCTCCGT-1_V12N28-333_A1,0,1,1,0,0,2
ATACCAGGCTAATAGA-1_V12N28-333_A1,3,1,0,0,0,4
CGGCTTTGTATGATAA-1_V12N28-333_A1,2,3,0,0,0,5
CTTGACCCGAAAGATA-1_V12N28-333_A1,2,3,0,0,0,5
CGCAGAAACATTTGCG-1_V12N28-333_A1,3,2,0,0,0,5
GACCCGTCGCCGGCTA-1_V12N28-333_A1,1,2,0,0,0,3
AATCGGGACACTACGA-1_V12N28-333_A1,1,1,1,0,0,3
GTCACAAAGTTTCCAA-1_V12N28-333_A1,1,3,1,0,0,5
TATATTCGCGTCGATA-1_V12N28-333_A1,0,1,1,0,0,2
CCTCCCGACAATCCCT-1_V12N28-333_A1,0,2,0,0,0,2
CGACATGCGATCTTCT-1_V12N28-333_A1,0,5,1,0,1,7
AACACGACTGTACTGA-1_V12N28-333_A1,3,0,2,0,0,5
CCCAACCACACTAACA-1_V12N28-333_A1,3,2,1,0,0,6
CACCGCCGACCAGCGA-1_V12N28-333_A1,0,1,2,1,0,4
TGGTATCGCATCCCAA-1_V12N28-333_A1,0,2,2,0,0,4
CAGAGTGATTTAACGT-1_V12N28-333_A1,0,0,3,0,0,3
AACCCTGGTGGAACCA-1_V12N28-333_A1,1,2,1,0,0,4
GTCAGTTGTGCTCGTT-1_V12N28-333_A1,0,1,1,0,0,2
ATTGACGTAACTCGGT-1_V12N28-333_A1,0,4,2,0,0,6
GATGTCGGTCAACTGC-1_V12N28-333_A1,2,2,1,0,0,5
AGGGCAGCGGCGTGGT-1_V12N28-333_A1,0,1,0,1,0,2
ACATCGTTAACCTAGT-1_V12N28-333_A1,0,5,0,1,0,6
TCCATTGTGACCTCGT-1_V12N28-333_A1,0,1,1,0,0,2
TGTTTAATACTTCATC-1_V12N28-333_A1,0,2,1,0,1,4
TTGCTGGCCGGGCTTC-1_V12N28-333_A1,0,0,3,0,0,3
CATATTATTTGCCCTA-1_V12N28-333_A1,1,2,2,0,0,5
CTGCCTAGCCACCAAG-1_V12N28-333_A1,0,3,3,0,0,6
ACGAGATATTTGCTTA-1_V12N28-333_A1,0,0,5,0,0,5
GACTACAATTGCTCGT-1_V12N28-333_A1,1,4,1,0,0,6
AACGTGATGAAGGACA-1_V12N28-333_A1,1,4,2,0,0,7
ACTCTCTTATACACGA-1_V12N28-333_A1,1,1,1,0,0,3
CGCATCATGGCTTCAG-1_V12N28-333_A1,0,3,2,0,0,5
CGGCTCTTCGTCGAAC-1_V12N28-333_A1,2,1,0,0,0,3
ATTCTTCGTACTTATG-1_V12N28-333_A1,0,1,1,0,0,2
AGTGAGGGTTTCTGAC-1_V12N28-333_A1,0,1,4,0,0,5
GCCAGGCGTTCGCATG-1_V12N28-333_A1,0,3,2,0,0,5
GACTAACACAGCACCT-1_V12N28-333_A1,0,0,1,0,0,1
CAATGGAATCTACATA-1_V12N28-333_A1,1,0,1,1,0,3
GTGGTCAGCGAAGTAT-1_V12N28-333_A1,0,6,2,0,0,8
ATGGCTGGAAATGGCC-1_V12N28-333_A1,0,4,0,0,0,4
ATCAGGTCGCCATTGC-1_V12N28-333_A1,1,2,0,0,0,3
TATCACCATGTAAAGT-1_V12N28-333_A1,1,3,3,0,0,7
AGCGCTTATGGGCAAG-1_V12N28-333_A1,0,0,1,1,0,2
AAGCGGCGTCATGGGT-1_V12N28-333_A1,1,5,0,0,0,6
ACTAATACGTCAGGCG-1_V12N28-333_A1,0,4,2,0,0,6
GGCTGAGCATCGTAAG-1_V12N28-333_A1,0,0,0,1,0,1
CGGTTGGGTTCAAGTT-1_V12N28-333_A1,1,1,2,0,0,4
GACTGATTGGTCACAA-1_V12N28-333_A1,0,4,4,0,0,8
AGACGGGCCGATTTAA-1_V12N28-333_A1,0,0,0,0,0,0
ACCAGTGCCCGGTCAA-1_V12N28-333_A1,0,4,1,0,0,5
GTCCTTTAATGACTTC-1_V12N28-333_A1,0,2,4,0,0,6
CCTACAAGTCCGGAAT-1_V12N28-333_A1,0,0,1,0,0,1
GCCTGCTACACTGAGA-1_V12N28-333_A1,1,1,0,0,0,2
GACTCGGTCGGCGGAT-1_V12N28-333_A1,0,3,3,0,0,6
CTAGACATATATGTAG-1_V12N28-333_A1,0,2,2,0,0,4
TCGCCCAACTGACTCC-1_V12N28-333_A1,0,2,2,0,0,4
AAACTAACGTGGCGAC-1_V12N28-333_A1,1,0,0,0,0,1
AACTGAGGTCAGCGTC-1_V12N28-333_A1,0,1,1,0,0,2
ACAATGATTCTTCTAC-1_V12N28-333_A1,0,0,2,0,0,2
ATAAGTACCCGATTGT-1_V12N28-333_A1,0,2,5,0,0,7
ATTGGGAGTTCTGTAA-1_V12N28-333_A1,0,3,1,0,1,5
CGAACATAGTCAGAAA-1_V12N28-333_A1,0,1,4,0,0,5
TAGCTCAGATCCTAGT-1_V12N28-333_A1,0,0,1,0,0,1
GTGTCGTATTCACCTT-1_V12N28-333_A1,0,0,4,0,0,4
CTCACCGATCCAAACT-1_V12N28-333_A1,0,0,1,0,0,1
ATATGTGCACAAACCA-1_V12N28-333_A1,0,0,2,0,0,2
CAGTCCAACGCCTTCT-1_V12N28-333_A1,0,0,1,0,0,1
TCGTCCGGGTACACTC-1_V12N28-333_A1,0,1,0,0,1,2
GCAGAAACGTAATCCA-1_V12N28-333_A1,0,0,1,0,0,1
TTCGAGCCGGCGCTAC-1_V12N28-333_A1,1,0,0,0,0,1
GGAAGATAAGACTGTA-1_V12N28-333_A1,0,0,0,0,0,0
ATAAGCAAACACCGAG-1_V12N28-333_A1,0,0,0,0,0,0
GCATAAATTGAACGCC-1_V12N28-333_A1,1,0,2,0,0,3
CGCCGGTGTCGCAGTA-1_V12N28-333_A1,0,0,2,0,2,4
GACCTGGTCTGGGCGT-1_V12N28-333_A1,2,0,2,0,0,4
AGCCGCTTGATTAGCG-1_V12N28-333_A1,2,0,0,0,0,2
CCCGGCTAGGTGAGAA-1_V12N28-333_A1,0,1,1,0,0,2
CGAGCCGAGCACTCGA-1_V12N28-333_A1,1,0,2,0,0,3
TAGTGCTTGAATCCTT-1_V12N28-333_A1,0,2,1,0,0,3
CAACCGCACCTAGACA-1_V12N28-333_A1,1,0,4,0,0,5
ACCACTGTTCAAGAAG-1_V12N28-333_A1,0,2,2,0,0,4
AGATGCTATAACGAGC-1_V12N28-333_A1,2,1,0,0,0,3
AATTACTCGTACGCTC-1_V12N28-333_A1,0,0,1,0,0,1
CGTCAATCTTTAACAT-1_V12N28-333_A1,2,0,0,0,0,2
CCAAAGCAGTTGGTTG-1_V12N28-333_A1,1,1,0,0,0,2
CCATATTGGATCATGA-1_V12N28-333_A1,1,1,3,0,0,5
CGTACCGAAAGTCTAG-1_V12N28-333_A1,1,1,3,0,0,5
CTCGAGATCCAAAGCA-1_V12N28-333_A1,1,2,1,0,0,4
TGGATAGAGTAACAGA-1_V12N28-333_A1,1,4,1,0,0,6
TCACAGATCCTCAAAC-1_V12N28-333_A1,0,2,2,0,0,4
AGAGCTACGAAAGCAT-1_V12N28-333_A1,0,0,3,0,0,3
TGCGTGATTGGGTGTC-1_V12N28-333_A1,4,0,1,0,0,5
CACATGTTTGGACATG-1_V12N28-333_A1,2,1,1,0,0,4
TTCGCATCCGGAAGCA-1_V12N28-333_A1,0,2,1,0,0,3
CCCTAGTGTCAGGTGT-1_V12N28-333_A1,0,0,3,0,0,3
TTACCGCCTTAGGGAA-1_V12N28-333_A1,1,0,1,0,0,2
CCAGTCCATTATTCGA-1_V12N28-333_A1,0,0,0,0,0,0
CGTAAACGCTTGAGTG-1_V12N28-333_A1,1,1,0,0,0,2
ATTCCTTCCAGGCGGT-1_V12N28-333_A1,1,0,0,0,0,1
TTCCTTTCTGTGTTGC-1_V12N28-333_A1,0,0,3,0,0,3
AGTTGACATCGGCTGG-1_V12N28-333_A1,0,1,0,0,0,1
AACTCGATGGCGCAGT-1_V12N28-333_A1,0,0,3,0,0,3
GATAAGGCAGATGCAA-1_V12N28-333_A1,1,0,0,0,1,2
GGCTGGCTAGCTTAAA-1_V12N28-333_A1,1,1,1,0,0,3
CCTCATGCAGCTACGA-1_V12N28-333_A1,1,1,0,0,0,2
GACGCCTGTTGCAGGG-1_V12N28-333_A1,4,1,0,0,0,5
TAATTAGATGGATATG-1_V12N28-333_A1,2,0,0,0,0,2
GAGGGCATCGCGTATC-1_V12N28-333_A1,3,0,0,0,0,3
CTTGTGAGTCTTTGAC-1_V12N28-333_A1,2,2,0,0,0,4
TCAACACATTGGGTAA-1_V12N28-333_A1,2,1,0,0,0,3
ACTGTATACGCGAGCA-1_V12N28-333_A1,1,2,0,0,1,4
GTGAAACGTGCTCCAC-1_V12N28-333_A1,3,2,0,0,0,5
CGAGTGCTATAGTTCG-1_V12N28-333_A1,1,0,0,0,0,1
GTACTGCATGAAGCGT-1_V12N28-333_A1,5,1,0,0,1,7
GTAACTTGCGGCAGTC-1_V12N28-333_A1,3,3,0,0,0,6
GAATCGCCGGACACGG-1_V12N28-333_A1,4,2,0,0,0,6
GGGAGTAATGGCTGGC-1_V12N28-333_A1,4,3,0,0,0,7
CATGAACCGACATTTG-1_V12N28-333_A1,2,2,0,0,0,4
TCTGTCATACAAGAGC-1_V12N28-333_A1,6,2,0,0,0,8
GTCGTCAATTATAAGG-1_V12N28-333_A1,3,1,0,0,0,4
TAAAGAGCCCGAAACC-1_V12N28-333_A1,0,3,0,0,0,3
GTACTGAGGTCGTAAC-1_V12N28-333_A1,1,1,0,0,0,2
AAAGACCCAAGTCGCG-1_V12N28-333_A1,3,3,0,0,0,6
CGTCAGTGCGCACAAG-1_V12N28-333_A1,1,3,0,0,0,4
TGTATCCTTATTCCAT-1_V12N28-333_A1,2,0,0,0,0,2
ATTCTCGTCTCTTTAG-1_V12N28-333_A1,1,1,1,0,0,3
AAAGTCACTGATGTAA-1_V12N28-333_A1,1,1,0,0,0,2
TGTCTACAGTTTCTGT-1_V12N28-333_A1,1,2,0,3,0,6
TTAACGTCGCAAGACC-1_V12N28-333_A1,1,3,0,0,0,4
CTATGTCTATTGAAAC-1_V12N28-333_A1,1,3,0,0,0,4
TCGGGTGAAACTGCTA-1_V12N28-333_A1,4,2,0,0,0,6
TGTCCCGACATAGCAC-1_V12N28-333_A1,2,2,0,0,0,4
ACAGCATAGAGCCAGT-1_V12N28-333_A1,0,3,0,0,0,3
ATATTCCCACAGGTCA-1_V12N28-333_A1,1,0,1,2,0,4
TTGGATCGACTTCTGG-1_V12N28-333_A1,1,1,1,0,0,3
CACCATCGGAGGAGAC-1_V12N28-333_A1,0,1,1,0,0,2
TCGTTCGTTATTATGT-1_V12N28-333_A1,1,1,2,0,0,4
CTTAACTTCGAAGTAC-1_V12N28-333_A1,0,2,1,0,0,3
GCACAAGTGTCGGAAG-1_V12N28-333_A1,1,2,0,0,0,3
TACCAGCTAGGTTTAA-1_V12N28-333_A1,0,1,3,0,0,4
ACGTACAGATTTCTCT-1_V12N28-333_A1,0,0,1,0,0,1
AATTTGGTTCCAAAGA-1_V12N28-333_A1,0,2,3,0,0,5
GTAAGGATTTGTCGGA-1_V12N28-333_A1,0,0,4,0,0,4
CATCATCTACCCGGAC-1_V12N28-333_A1,1,3,3,0,0,7
ACGATGGATCCGATGC-1_V12N28-333_A1,0,3,1,0,0,4
CACTCAGCTCTTGAGG-1_V12N28-333_A1,0,5,0,0,0,5
TAGATCCGAAGTCGCA-1_V12N28-333_A1,0,2,1,0,0,3
TGAAACTTATGCAAGC-1_V12N28-333_A1,0,1,2,0,0,3
GCGATTCTGGAAGCAG-1_V12N28-333_A1,0,3,1,0,1,5
CAAACTATTGAGCTTC-1_V12N28-333_A1,0,0,2,0,0,2
TAGAATTAAGGGCAAC-1_V12N28-333_A1,0,0,0,0,0,0
CGAAACATAGATGGCA-1_V12N28-333_A1,0,1,2,0,0,3
GATGGTGCCCTAGGCA-1_V12N28-333_A1,0,3,3,0,0,6
CCCGCAGGGCCCAAAG-1_V12N28-333_A1,0,0,3,0,0,3
ACAGCGCACCCGCAGC-1_V12N28-333_A1,0,1,1,0,0,2
GGTAAATGTGCGTTAC-1_V12N28-333_A1,0,2,3,0,0,5
GTCCTTCTAGTGGGTT-1_V12N28-333_A1,0,0,2,0,0,2
GGAAGCTCGCTTACAG-1_V12N28-333_A1,0,1,1,0,0,2
CACCGATACACCGAGC-1_V12N28-333_A1,0,2,1,1,0,4
CAGCCGGGCCCTCTAT-1_V12N28-333_A1,0,2,2,0,0,4
CGGAGCTTATAACACC-1_V12N28-333_A1,0,2,1,0,0,3
ATTACAACTACCGGCC-1_V12N28-333_A1,0,2,0,0,0,2
TCCTCTGGCCCATTAG-1_V12N28-333_A1,1,1,1,1,0,4
CGGCACCGTTAGCGCC-1_V12N28-333_A1,2,3,2,0,0,7
TCGGTCCCTGACTCCA-1_V12N28-333_A1,1,3,1,1,0,6
TGGTTGGAGGATCCTG-1_V12N28-333_A1,0,5,1,0,0,6
CTGCGGTAGTCACGTG-1_V12N28-333_A1,1,2,1,0,0,4
GTGCCTCAGTGTACGG-1_V12N28-333_A1,2,0,1,0,0,3
ATCGTTCACTTTCGCC-1_V12N28-333_A1,0,2,2,1,0,5
ACTTACCGGGCGCGCA-1_V12N28-333_A1,1,1,1,0,0,3
CTAGACTGCATTTCGT-1_V12N28-333_A1,3,2,1,0,0,6
TTGCCGGTGATCCCTC-1_V12N28-333_A1,1,1,0,0,0,2
CTGTCACGCCAGGCGC-1_V12N28-333_A1,0,1,3,0,0,4
CGGTATAGGTATTAGC-1_V12N28-333_A1,1,0,6,1,0,8
CCAACGCTTGCCAGGG-1_V12N28-333_A1,1,1,3,0,0,5
CGTTGAGTAATTGCGT-1_V12N28-333_A1,0,3,2,0,0,5
TGTATTTACCTAATGC-1_V12N28-333_A1,2,1,2,0,0,5
TAAATGCCGTCTCATG-1_V12N28-333_A1,0,2,2,0,0,4
CGGTTTATGAAGGAAC-1_V12N28-333_A1,0,0,2,0,0,2
GCAAGATGTGTTCGCG-1_V12N28-333_A1,0,1,5,0,0,6
AAAGGTAAGCTGTACC-1_V12N28-333_A1,0,2,2,0,0,4
GTACGTCACGTATTAA-1_V12N28-333_A1,1,2,1,0,0,4
AGTACCTTCGAGTGCT-1_V12N28-333_A1,0,0,0,0,0,0
ATTGTGACTTCGCTGC-1_V12N28-333_A1,0,1,5,0,0,6
TGTATCAGACTGAAGC-1_V12N28-333_A1,0,2,1,0,0,3
GAGACCCTGCAACGCC-1_V12N28-333_A1,0,2,3,0,0,5
TGGGTGGGATGTCATT-1_V12N28-333_A1,0,0,1,0,0,1
GGCTAATGATTGAAAT-1_V12N28-333_A1,0,0,0,0,0,0
ATAACGTTACCTCCAC-1_V12N28-333_A1,0,1,0,0,0,1
TGCGAGATGGCGGCCA-1_V12N28-333_A1,0,0,0,0,0,0
CACACTTGTATTGCGA-1_V12N28-333_A1,1,0,2,0,0,3
GCTGGTGACTCGTAGT-1_V12N28-333_A1,0,0,1,0,1,2
CGACACCGCTTAAGGA-1_V12N28-333_A1,1,0,1,0,1,3
GTAACAACTGACCTTG-1_V12N28-333_A1,0,0,2,0,1,3
CAACTGAGGGTATGAC-1_V12N28-333_A1,1,1,1,0,1,4
CTAATTATGAAGCGTA-1_V12N28-333_A1,0,0,2,0,1,3
CCGATCTTAAGAGGCT-1_V12N28-333_A1,0,0,3,0,0,3
CGACTCGGTACACGGT-1_V12N28-333_A1,0,0,0,0,0,0
TGCTGCGTCAGAGTTA-1_V12N28-333_A1,0,0,0,0,0,0
AGAGTTGCAGGCCTCC-1_V12N28-333_A1,0,0,0,0,0,0
ACTGGCGAACCTGCGT-1_V12N28-333_A1,0,0,1,0,2,3
ACTAAGGACGCACACC-1_V12N28-333_A1,0,1,1,0,1,3
CGTCCAGATGGCTCCA-1_V12N28-333_A1,1,0,0,0,0,1
ACTATCGCCGGCTAAA-1_V12N28-333_A1,3,2,3,0,0,8
GATAGCGTACCACGCG-1_V12N28-333_A1,3,2,0,0,0,5
AGGACTTATAGGAGAA-1_V12N28-333_A1,2,1,1,0,1,5
TAGTCGGGATTCTTCG-1_V12N28-333_A1,1,0,3,0,0,4
ACCATTAAGGGTGTCA-1_V12N28-333_A1,0,2,0,0,0,2
TTAATGTGTTTGCAGG-1_V12N28-333_A1,1,1,3,0,0,5
TCCGCAGCCACCTAGC-1_V12N28-333_A1,0,1,3,0,1,5
GAGGAGATCCTCATGC-1_V12N28-333_A1,0,0,3,0,2,5
GGTCCTTCATACGACT-1_V12N28-333_A1,0,1,4,0,0,5
CCCTGTTGGCAAAGAC-1_V12N28-333_A1,0,2,2,0,0,4
GTGCCTAGCTATGCTT-1_V12N28-333_A1,0,0,4,0,0,4
GTCATCTCCTACAGCT-1_V12N28-333_A1,0,0,0,0,0,0
GCGAGAAACGGGAGTT-1_V12N28-333_A1,1,0,2,0,0,3
CGTCGCGGCGGGATTT-1_V12N28-333_A1,1,1,4,0,0,6
CATTGTGTGCTAGATC-1_V12N28-333_A1,0,1,3,0,0,4
CGCGGCAGTATTACGG-1_V12N28-333_A1,0,1,1,0,0,2
GAAATGGGATGTAAAC-1_V12N28-333_A1,1,0,4,0,0,5
CATTCCCTAAGTACAA-1_V12N28-333_A1,0,0,3,0,0,3
AGTTCTGCGTTGTATC-1_V12N28-333_A1,1,2,3,0,0,6
ACCCTATAGGACTGAG-1_V12N28-333_A1,0,1,1,0,0,2
TTAGATAGGTCGATAC-1_V12N28-333_A1,0,1,2,0,0,3
ATTGATAGCAACGAGA-1_V12N28-333_A1,0,0,3,0,0,3
TCTCGGCTCCAGGACT-1_V12N28-333_A1,0,0,4,0,0,4
CTTGAGGTTATCCCGA-1_V12N28-333_A1,1,1,0,0,0,2
AAGAAGGATCAGTTAG-1_V12N28-333_A1,1,1,2,0,0,4
GTACGACGGCGCTGCG-1_V12N28-333_A1,1,1,0,0,1,3
CTTATGTTGACTACCA-1_V12N28-333_A1,1,1,0,0,2,4
CGGCACTCAAGAAAGT-1_V12N28-333_A1,0,0,3,0,0,3
GTCAAAGTTTACATAG-1_V12N28-333_A1,0,0,0,0,0,0
CTCCTAAGTTATGTCT-1_V12N28-333_A1,1,2,0,0,0,3
ACTGTGCTAGTAGATC-1_V12N28-333_A1,3,1,0,0,0,4
GTTTGGCCGCTCAGCG-1_V12N28-333_A1,0,1,0,0,0,1
TTATCCAATCGAACTC-1_V12N28-333_A1,3,0,0,0,0,3
CCGTACCCAAGCGCCA-1_V12N28-333_A1,0,0,0,0,0,0
CATACAAAGCCGAACC-1_V12N28-333_A1,1,1,1,0,0,3
GGTCGGTAATTAGACA-1_V12N28-333_A1,3,2,0,0,0,5
AGCGGGAAGGGTCCAT-1_V12N28-333_A1,3,2,0,0,0,5
GCCCACCAAGGCTGTC-1_V12N28-333_A1,1,2,0,0,1,4
GTAGACGTCGTTACAT-1_V12N28-333_A1,2,2,0,0,0,4
GAGCATCATCCCTGGG-1_V12N28-333_A1,2,1,0,0,0,3
AGGTAACCTCCTATTC-1_V12N28-333_A1,3,1,1,0,0,5
GGTTTGAGTGCTGGAA-1_V12N28-333_A1,0,3,1,0,0,4
GCACTAGTCGCGCTAT-1_V12N28-333_A1,3,1,1,0,0,5
GGTAACTATGTATCTG-1_V12N28-333_A1,1,2,0,0,0,3
GCGGTCCCTAGACGCA-1_V12N28-333_A1,3,2,0,0,0,5
CGAGCGTTGATCAGCC-1_V12N28-333_A1,6,2,0,1,0,9
AATCCAAGGGCCTGAG-1_V12N28-333_A1,2,2,0,0,0,4
CCGTGCCCATGACGGC-1_V12N28-333_A1,3,0,2,0,0,5
GAAATTCACATCGCTG-1_V12N28-333_A1,3,0,2,0,0,5
CTCTGCGAAGCAAGCA-1_V12N28-333_A1,1,2,0,0,0,3
AGTAGGTAACATACAT-1_V12N28-333_A1,3,2,0,0,0,5
ATTGGGAATATCTTGG-1_V12N28-333_A1,0,2,0,0,0,2
TAGAGCTACGAAGAAC-1_V12N28-333_A1,1,1,0,0,0,2
TGCGGCATAGTTCAAC-1_V12N28-333_A1,3,1,1,0,0,5
CCGCCGGTCAACACAC-1_V12N28-333_A1,1,4,0,0,0,5
TCGTATAGTGCAATTA-1_V12N28-333_A1,2,2,0,0,0,4
TAGTTTATTCTTGCTT-1_V12N28-333_A1,1,1,0,0,0,2
GATATCTCATGCAATA-1_V12N28-333_A1,3,0,0,1,0,4
CGTTTAAGCGGAGCAC-1_V12N28-333_A1,2,3,0,0,0,5
CATGCTGGCTCCAATT-1_V12N28-333_A1,0,4,0,0,0,4
GAAACAGCCATGCAGT-1_V12N28-333_A1,1,4,0,0,0,5
AGTTTCGCAGGTCGGA-1_V12N28-333_A1,0,0,3,0,0,3
CTCATGGCTCACAATC-1_V12N28-333_A1,2,1,1,0,0,4
AACCGTTGTGTTTGCT-1_V12N28-333_A1,3,0,1,0,0,4
ACCCTTCATCTGCGAA-1_V12N28-333_A1,1,3,2,0,0,6
TGCGGTGAAATTTCAT-1_V12N28-333_A1,2,2,1,0,0,5
CAAATTGTCAGCAAGC-1_V12N28-333_A1,0,1,0,0,0,1
GAGGTACATCCATCTT-1_V12N28-333_A1,0,3,0,0,0,3
AAATGGCATGTCTTGT-1_V12N28-333_A1,0,1,0,0,0,1
TCATCCCAGAGGGTGG-1_V12N28-333_A1,2,0,0,0,0,2
CGTAGCGAATTGTCAG-1_V12N28-333_A1,1,1,1,0,0,3
CCTAGTTAGTCGCATG-1_V12N28-333_A1,0,2,1,0,0,3
GAAACTCTAATGAAGG-1_V12N28-333_A1,0,0,2,1,0,3
TTGTATCACACAGAAT-1_V12N28-333_A1,0,2,1,0,0,3
TTCAAGCCGAGCTGAG-1_V12N28-333_A1,0,4,1,0,0,5
AGGTACGATATTGCCA-1_V12N28-333_A1,0,3,1,0,0,4
TTAAGCCGACAACTTC-1_V12N28-333_A1,0,1,4,0,0,5
GTCTTAGTACAGCCGG-1_V12N28-333_A1,0,2,2,0,0,4
TGGGTAAGGTTCCCGC-1_V12N28-333_A1,1,2,1,1,0,5
CTACGCCATTTCCGAT-1_V12N28-333_A1,0,2,1,0,0,3
GACCGTCAGGTCGTGA-1_V12N28-333_A1,0,5,1,0,0,6
TAGTTAAGATAGGATA-1_V12N28-333_A1,1,0,1,0,0,2
GAATATTCGGAGTCCC-1_V12N28-333_A1,0,0,1,0,0,1
CAAACTACGATAGAGA-1_V12N28-333_A1,1,0,2,0,0,3
CAGGAAGACTTTATAT-1_V12N28-333_A1,1,1,4,0,0,6
TTCGTAATCCCAGCGG-1_V12N28-333_A1,0,1,5,0,0,6
GTGAGGAGCGGTTGAG-1_V12N28-333_A1,0,2,1,0,1,4
CAATCCCTATACCAGC-1_V12N28-333_A1,0,2,3,0,0,5
AGGGAAACGAGGTACT-1_V12N28-333_A1,0,1,3,0,0,4
TCCTGCCAACTGGAGA-1_V12N28-333_A1,0,1,2,0,0,3
AATTTGGGACATAGTA-1_V12N28-333_A1,0,0,0,1,0,1
AACTCCTAATCCCATG-1_V12N28-333_A1,0,2,2,1,0,5
GCTCATTACTGCATGT-1_V12N28-333_A1,1,3,3,0,0,7
TCTCGAACGAGGTCAC-1_V12N28-333_A1,2,3,1,0,0,6
TCACTACGACCAATGC-1_V12N28-333_A1,2,2,0,0,0,4
GTGATGCACAACATCT-1_V12N28-333_A1,0,2,1,1,0,4
CCGACGTAAACACAAC-1_V12N28-333_A1,1,3,0,1,0,5
TGGGATGCACTCATTC-1_V12N28-333_A1,0,1,2,0,0,3
TTCCATCATGCGGTGA-1_V12N28-333_A1,1,2,1,0,0,4
TGCACAGTGAAGTTAT-1_V12N28-333_A1,1,1,4,1,0,7
CTATTGTGTTTGGTCA-1_V12N28-333_A1,0,0,3,0,0,3
TGCGAGCCCTTCCGCG-1_V12N28-333_A1,1,2,1,0,1,5
TTGAAAGGTGTAAAGG-1_V12N28-333_A1,0,5,3,0,0,8
GGTGCAGAGCCTATCG-1_V12N28-333_A1,0,2,2,0,0,4
ACTATATGCTGTGTTC-1_V12N28-333_A1,0,2,4,0,0,6
TCCTGGCGCTGCCTGG-1_V12N28-333_A1,0,2,2,0,0,4
GAGCCGAGCGTTTATT-1_V12N28-333_A1,0,2,2,0,0,4
AGAATGCGGGTTCGGA-1_V12N28-333_A1,0,1,2,0,0,3
ATGCGACAATTGGTCC-1_V12N28-333_A1,0,2,1,0,0,3
TTCCGGCTCGACTTCT-1_V12N28-333_A1,0,0,2,0,0,2
TGATTATGGCACGCAG-1_V12N28-333_A1,0,1,4,0,0,5
GGTTTGACAAGAAGCT-1_V12N28-333_A1,0,0,2,0,1,3
GCAGCTATGGACAGGT-1_V12N28-333_A1,0,2,2,0,0,4
CACCATGATCGCAAAG-1_V12N28-333_A1,0,0,4,0,0,4
GTCGGAAGGATACCAG-1_V12N28-333_A1,0,0,1,0,0,1
GGCCCAGTTATCAGCA-1_V12N28-333_A1,0,0,1,0,0,1
GGGCCTATTTAAGTAT-1_V12N28-333_A1,0,1,0,0,1,2
GTTGTTACATTGCGCT-1_V12N28-333_A1,0,1,2,0,0,3
CAACTCCGTAACTTGC-1_V12N28-333_A1,0,0,2,0,1,3
GATCTTTGCTCAAAGA-1_V12N28-333_A1,0,0,1,0,0,1
TCGCTTAATTACGAAG-1_V12N28-333_A1,0,0,1,0,1,2
CGATCATTAGAGGCAC-1_V12N28-333_A1,0,0,2,0,0,2
TGTTCTCTACTCCCTA-1_V12N28-333_A1,0,1,2,0,0,3
GCTTAGGGAAGCGGTA-1_V12N28-333_A1,0,0,0,0,2,2
CAGGTTTAGTACTACA-1_V12N28-333_A1,0,0,4,0,0,4
AAGCGGAGTGCGCGCA-1_V12N28-333_A1,0,1,2,0,0,3
TCAGATGGAGACGTAG-1_V12N28-333_A1,0,0,2,0,0,2
TCGCACTAACGTTTGT-1_V12N28-333_A1,4,0,0,0,0,4
CACGTCGGGTTCTAGA-1_V12N28-333_A1,4,1,0,0,1,6
GGAGTACACATGAGCT-1_V12N28-333_A1,0,1,2,0,0,3
GTGTGTCGACGTCGCT-1_V12N28-333_A1,3,2,0,0,0,5
GAAGCTCTTTGCTTAG-1_V12N28-333_A1,2,0,4,0,0,6
ACACCGAGCGCTCTTT-1_V12N28-333_A1,0,1,1,0,0,2
CGTAATAATTACGAGT-1_V12N28-333_A1,0,0,1,0,0,1
CATCAACACCTACTAA-1_V12N28-333_A1,7,0,0,0,0,7
CCAAGTTTCTACAGAT-1_V12N28-333_A1,1,0,3,0,0,4
ACGGGTCATGTGACTT-1_V12N28-333_A1,1,4,0,0,0,5
AGTGTGCTAAGATCGC-1_V12N28-333_A1,0,2,0,0,0,2
GGCGGTTTGCCGGTGC-1_V12N28-333_A1,0,3,1,0,0,4
GTATAATCTCCCGGAT-1_V12N28-333_A1,0,1,4,0,0,5
TAGTCCGTATGCATAA-1_V12N28-333_A1,0,0,4,0,0,4
CACTTCGTCTTATCTC-1_V12N28-333_A1,0,1,2,0,0,3
CATCCGCAGGCCCGAA-1_V12N28-333_A1,0,0,1,0,0,1
CCCTGATGTAACTCGT-1_V12N28-333_A1,0,0,2,0,0,2
CCATAGTCAGTAACCC-1_V12N28-333_A1,1,0,3,0,0,4
CGGGCCATAGCCGCAC-1_V12N28-333_A1,1,1,1,0,0,3
CTCCGGCTTGTAGACA-1_V12N28-333_A1,2,0,1,0,0,3
AACTTGCGTTCTCGCG-1_V12N28-333_A1,0,2,0,0,0,2
AATGAGTTCGCATATG-1_V12N28-333_A1,0,0,1,0,0,1
CGAGGCCAGGCATTGG-1_V12N28-333_A1,0,0,2,0,0,2
TCTGCGTCCGGTTTCT-1_V12N28-333_A1,0,1,3,0,1,5
CAATCCTGCCGTGGAG-1_V12N28-333_A1,0,0,2,0,0,2
CTGAGCAAGTAACAAG-1_V12N28-333_A1,0,1,2,0,0,3
GGGTACCCACGGTCCT-1_V12N28-333_A1,0,0,1,0,2,3
ACGGAATTTAGCAAAT-1_V12N28-333_A1,1,1,0,0,1,3
GGGCGGTCCTATTGTC-1_V12N28-333_A1,0,0,3,0,0,3
ATGTTACGAGCAATAC-1_V12N28-333_A1,0,0,0,0,0,0
AACCATGGGATCGCTA-1_V12N28-333_A1,0,0,0,0,0,0
TCGCATCCCTAAGTGT-1_V12N28-333_A1,0,1,1,0,0,2
ACTTAGTACGACAAGA-1_V12N28-333_A1,0,0,3,0,0,3
GAGCTCTCGGACCTAA-1_V12N28-333_A1,0,1,1,0,0,2
TCTATTACGCTGGCGA-1_V12N28-333_A1,0,2,0,0,1,3
AGATACGACTTCATAT-1_V12N28-333_A1,3,0,0,0,0,3
CGCTATACCGCCCACT-1_V12N28-333_A1,4,0,0,0,0,4
CAGTGTCCGCAGAATG-1_V12N28-333_A1,1,0,0,0,0,1
CCATCCATACCAAGTC-1_V12N28-333_A1,1,1,1,0,0,3
AACCCAGAGACGGAGA-1_V12N28-333_A1,0,1,2,0,0,3
GAAGAACGGTGCAGGT-1_V12N28-333_A1,2,0,1,0,0,3
GATAAATCGGTGGATG-1_V12N28-333_A1,0,0,0,0,0,0
CAGCTCGTGCTTGTGT-1_V12N28-333_A1,3,2,3,0,0,8
GAGTACGGGTATACAA-1_V12N28-333_A1,0,0,0,0,0,0
CATCGCCCGCGGCCAA-1_V12N28-333_A1,0,2,1,0,0,3
TCTTACAGAGGTACCG-1_V12N28-333_A1,2,1,0,0,0,3
TGGAAGACGAACACCA-1_V12N28-333_A1,2,1,0,0,0,3
GTTGTCGTGTTAGTTG-1_V12N28-333_A1,0,2,2,0,0,4
CCAAGGAACAGAGAGG-1_V12N28-333_A1,2,0,0,0,0,2
CTGCACCTGGAACCGC-1_V12N28-333_A1,3,1,0,0,0,4
CGCTTTCATACCGGTG-1_V12N28-333_A1,4,2,1,0,0,7
GTTCTTCCCTCGATGT-1_V12N28-333_A1,1,1,0,0,0,2
ATTTAACTCGTATTAC-1_V12N28-333_A1,2,0,0,0,0,2
AACGATAGAAGGGCCG-1_V12N28-333_A1,0,2,0,0,0,2
TATCCTGCATGGGAAT-1_V12N28-333_A1,1,4,0,0,0,5
AGGCCCATTGTACAGG-1_V12N28-333_A1,1,1,0,0,0,2
CCGGCGCATATTGGAT-1_V12N28-333_A1,2,1,1,0,0,4
ATCTGTAATTGTACCC-1_V12N28-333_A1,4,1,0,0,0,5
GAGCGAGGGAGTACCG-1_V12N28-333_A1,2,1,0,0,0,3
TTATTAGGGAAGCATC-1_V12N28-333_A1,1,2,1,0,0,4
CTTCTTACGTCGTATA-1_V12N28-333_A1,2,3,0,0,0,5
GAAGTGCTGGATAGCT-1_V12N28-333_A1,2,1,0,0,0,3
GTGCAACAAATGTGGC-1_V12N28-333_A1,1,3,0,0,0,4
CATGCGTTAGACAGAA-1_V12N28-333_A1,2,2,1,0,0,5
ACACACTTTCTACACG-1_V12N28-333_A1,1,1,0,0,0,2
AGCCCTAAGCGAAGTT-1_V12N28-333_A1,0,2,2,0,0,4
ATTAATTCGGTCACTC-1_V12N28-333_A1,0,4,0,0,0,4
AACAGGAAATCGAATA-1_V12N28-333_A1,1,2,2,0,0,5
ACGTTTAGTTGTGATC-1_V12N28-333_A1,0,0,2,0,0,2
TCCTTCAGTGGTCGAA-1_V12N28-333_A1,2,2,0,0,0,4
CGAACGCCCAGTGCCG-1_V12N28-333_A1,2,3,0,0,0,5
CCTCGAAGTGGACGGG-1_V12N28-333_A1,0,5,1,0,1,7
CTCTGTTTGAGGATTC-1_V12N28-333_A1,0,2,0,0,0,2
TGGGCACGTTCTATGG-1_V12N28-333_A1,0,0,1,0,0,1
ACTATTCGTCCGTGGT-1_V12N28-333_A1,1,2,0,0,0,3
CCTCTGGCCTAGACGG-1_V12N28-333_A1,0,2,1,0,0,3
CCATAAACAACCCGAC-1_V12N28-333_A1,0,1,2,0,0,3
CATAGTACATTGAGAG-1_V12N28-333_A1,1,5,0,0,0,6
ATTTCATTATTTCGCG-1_V12N28-333_A1,0,4,5,0,0,9
CAACTATATCGAATGC-1_V12N28-333_A1,0,5,1,0,0,6
CTAGTATTCGGAATTA-1_V12N28-333_A1,1,3,0,0,0,4
GTGGAACCTACATGCG-1_V12N28-333_A1,2,3,1,0,0,6
CCTAAAGGCTGACGCT-1_V12N28-333_A1,0,2,5,0,0,7
CGTGACATTGGGTCGT-1_V12N28-333_A1,0,2,3,1,0,6
CCAATCGGTAGATCGA-1_V12N28-333_A1,0,1,1,0,0,2
ATTGTCGCAATACCTT-1_V12N28-333_A1,0,2,1,0,0,3
AAATTACACGACTCTG-1_V12N28-333_A1,1,3,5,0,0,9
CACTCCTCTCGGTCGG-1_V12N28-333_A1,1,0,4,0,0,5
AAATAACCATACGGGA-1_V12N28-333_A1,0,0,2,0,0,2
AGTTACTCTATCGTGG-1_V12N28-333_A1,0,1,1,0,0,2
CGTTAGCTCACAACTG-1_V12N28-333_A1,0,2,1,0,0,3
GAATGTATGGCAGGTC-1_V12N28-333_A1,0,2,1,0,0,3
GCAACCACCAGACCGG-1_V12N28-333_A1,0,2,3,0,0,5
TCACTCGTGCAACGGC-1_V12N28-333_A1,1,0,3,0,0,4
AAACAGAGCGACTCCT-1_V12N28-333_A1,1,3,1,0,0,5
CAGCCTCTCCTCAAGA-1_V12N28-333_A1,3,1,0,0,0,4
TTGCGTGAACGCTTAG-1_V12N28-333_A1,0,1,0,0,0,1
CCGCCTGCGAATTGGT-1_V12N28-333_A1,0,3,2,0,0,5
AGATGAGGGTTGCGAT-1_V12N28-333_A1,1,1,0,0,0,2
CGGTGGGCTCCAGCCT-1_V12N28-333_A1,0,2,1,0,0,3
GGCAGCGGTAATCCTA-1_V12N28-333_A1,2,0,3,1,0,6
GCTAGCAGGGAGTGGG-1_V12N28-333_A1,0,1,3,0,0,4
CTCAAGACATTAGCGC-1_V12N28-333_A1,0,3,2,0,0,5
CACGGCGCGCCAAAGG-1_V12N28-333_A1,0,2,1,1,0,4
TGCAATTTGGGCACGG-1_V12N28-333_A1,0,3,0,0,0,3
ATGCCAATCGCTCTGC-1_V12N28-333_A1,0,1,1,0,0,2
GCTGGACCCAAAGTGG-1_V12N28-333_A1,0,1,1,0,0,2
ATTCCTAAGACGTGGA-1_V12N28-333_A1,0,1,3,0,0,4
TCCGGAGGAAGGGCTG-1_V12N28-333_A1,0,2,1,0,0,3
TCGGTGACCGCTCCGG-1_V12N28-333_A1,0,0,1,0,0,1
TCCGAAGTAGTCACCA-1_V12N28-333_A1,0,1,2,0,0,3
CATGTAGGAGCGCCAA-1_V12N28-333_A1,0,1,1,0,1,3
CACAAGAAAGATATTA-1_V12N28-333_A1,0,0,3,0,0,3
AGGGTCAGTAACCCTA-1_V12N28-333_A1,0,1,0,0,0,1
TAAGCCCTTACGACCA-1_V12N28-333_A1,0,2,2,0,0,4
ATACCGTCATCCATAA-1_V12N28-333_A1,0,0,1,0,0,1
GGACGTCCATAGTTGG-1_V12N28-333_A1,0,1,0,0,1,2
CATCAAACTGGCGCCC-1_V12N28-333_A1,0,0,2,0,0,2
AAACGTGTTCGCCCTA-1_V12N28-333_A1,0,1,2,0,1,4
AAATTGGTGAGAAGCA-1_V12N28-333_A1,0,0,0,0,3,3
GGTCATTGTAGTCATA-1_V12N28-333_A1,0,1,0,0,0,1
TGCAGTGAGGCTCGGG-1_V12N28-333_A1,0,1,1,0,1,3
GAACATTAGTATGTTA-1_V12N28-333_A1,0,0,2,0,0,2
GGTTTGCGAACACGTA-1_V12N28-333_A1,0,0,0,0,0,0
ACACAAATATTCCTAG-1_V12N28-333_A1,0,1,2,0,0,3
TTGGGTTTATTCAGCG-1_V12N28-333_A1,0,0,1,0,0,1
ATTCGCAGAGGACACT-1_V12N28-333_A1,0,0,2,0,0,2
GATTTAGTGCGTACTG-1_V12N28-333_A1,0,0,2,0,0,2
TAGAAACACAATAGTG-1_V12N28-333_A1,2,1,0,0,0,3
CAGTAGATGATGTCCG-1_V12N28-333_A1,3,1,0,0,0,4
TCTTAACTCGGATGTA-1_V12N28-333_A1,2,1,0,0,0,3
TACATCTTGTTTCTTG-1_V12N28-333_A1,1,0,1,0,0,2
TTCATAGGGTGTCCAT-1_V12N28-333_A1,1,1,0,0,0,2
TGAAGTAGCTTACGGA-1_V12N28-333_A1,2,0,1,0,0,3
GCACAAGTGGATCATA-1_V12N28-333_A1,1,0,0,0,0,1
GGGCGAATTTCTCCAC-1_V12N28-333_A1,2,2,1,0,0,5
ATGTTCCTGCCCACCT-1_V12N28-333_A1,0,2,3,0,0,5
GCTCAACCTCTTAGAG-1_V12N28-333_A1,3,0,0,0,0,3
ATAGCTGCTCTTGTTA-1_V12N28-333_A1,0,4,2,0,0,6
CGTCAGCTATTTACTC-1_V12N28-333_A1,3,1,6,0,0,10
ATCTGATAGTGTCTTA-1_V12N28-333_A1,1,3,0,0,0,4
TGCACTATGTGAGTGC-1_V12N28-333_A1,1,0,0,0,0,1
CCGACAAACACATGAG-1_V12N28-333_A1,0,0,0,0,0,0
GCCTTGTATATGCAGT-1_V12N28-333_A1,0,1,2,0,0,3
ATAATACCGTTAGCCG-1_V12N28-333_A1,1,1,1,0,0,3
ACACTCCAATGTCACT-1_V12N28-333_A1,0,1,1,0,0,2
AGTTGCTGACTGATAT-1_V12N28-333_A1,0,1,2,0,0,3
GGCGCTCCTCATCAAT-1_V12N28-333_A1,0,0,0,0,1,1
TGCCTGACATCGGTCA-1_V12N28-333_A1,0,0,1,0,1,2
TTGGCCATCTTGCGCT-1_V12N28-333_A1,0,0,5,0,0,5
CAGTGGTTGCACATGA-1_V12N28-333_A1,0,2,1,0,1,4
AGAATTGTTTGACATA-1_V12N28-333_A1,0,0,1,0,0,1
AAATGCTCGTTACGTT-1_V12N28-333_A1,0,1,1,0,0,2
CACCTAATAGAGTCGT-1_V12N28-333_A1,0,1,1,0,2,4
CATTTCTAGCAGACTA-1_V12N28-333_A1,0,3,2,0,1,6
CCGAAAGTGGTGAGCA-1_V12N28-333_A1,0,1,3,0,0,4
AGTCAGCCACCGCCTG-1_V12N28-333_A1,0,1,2,0,1,4
TCATCACTCGAGCTCG-1_V12N28-333_A1,0,0,2,0,0,2
CTCAGGACTCACCTGT-1_V12N28-333_A1,0,1,0,0,0,1
CGGTGTACTTGATCCC-1_V12N28-333_A1,0,0,1,0,0,1
CCTACGGCTCAGTCGA-1_V12N28-333_A1,1,0,3,0,0,4
GTACTTGGGCACTTCT-1_V12N28-333_A1,0,0,1,0,0,1
TGATTTCCTCCTGACG-1_V12N28-333_A1,0,1,1,0,0,2
CCTCACCAATCTTGAC-1_V12N28-333_A1,0,1,1,0,0,2
GGTGAGATGCAGATAA-1_V12N28-333_A1,0,1,4,0,0,5
GCTAGTTTCATTGAGG-1_V12N28-333_A1,1,2,1,0,0,4
AGGACATCGCACGTCG-1_V12N28-333_A1,0,1,2,0,0,3
GTGGACGTGCTGAGAC-1_V12N28-333_A1,2,2,0,0,1,5
TAAGGAACTTGTGGGA-1_V12N28-333_A1,1,1,0,0,0,2
TCGCTGTGCGTAAATC-1_V12N28-333_A1,2,1,1,0,0,4
GCATCCCTAACTTTGA-1_V12N28-333_A1,3,0,0,0,0,3
CACCCACACGTCACCC-1_V12N28-333_A1,3,0,0,0,0,3
CCCTCATTCTGGAATT-1_V12N28-333_A1,1,2,2,0,0,5
AGGGCGTGATCGGCTA-1_V12N28-333_A1,2,1,0,0,0,3
GGTGCGGATAAGTGGC-1_V12N28-333_A1,0,4,1,0,0,5
TAATATTGAAATTCGC-1_V12N28-333_A1,2,1,0,0,0,3
CTTACACTGGGAAATA-1_V12N28-333_A1,2,2,1,0,0,5
ACCAAGAACGCGTGTC-1_V12N28-333_A1,1,1,1,0,0,3
GCCTTCAGCCCTACCG-1_V12N28-333_A1,1,1,1,0,0,3
GATGCTACAAGCGCCT-1_V12N28-333_A1,2,4,0,0,0,6
CCGGGACCCGCAGAGA-1_V12N28-333_A1,1,2,0,0,0,3
GTTCCAGTCTGACCAT-1_V12N28-333_A1,1,3,0,0,0,4
ATGATCGGGAATAGAC-1_V12N28-333_A1,2,1,0,0,0,3
TTGGATTGGGTACCAC-1_V12N28-333_A1,3,0,1,0,0,4
TACCTCACGCTTGTAC-1_V12N28-333_A1,1,1,0,0,0,2
CATGGCAGGAAGATCG-1_V12N28-333_A1,1,2,0,0,0,3
ATGACGCCGGCTCTAA-1_V12N28-333_A1,1,2,1,0,0,4
AGCGACATCCCATTCA-1_V12N28-333_A1,0,3,2,0,0,5
AGTAATGTCTTGCCGC-1_V12N28-333_A1,1,1,2,0,0,4
TTCTTAGTGGCTCAGA-1_V12N28-333_A1,1,6,0,0,0,7
CGTCTGGAAGGGCCCG-1_V12N28-333_A1,2,1,2,0,0,5
ACGTGCGCCTCGTGCA-1_V12N28-333_A1,2,1,0,0,0,3
AGAGCGGGCTAATCAT-1_V12N28-333_A1,1,0,0,0,0,1
GCGTCGAAATGTCGGT-1_V12N28-333_A1,1,2,2,0,0,5
AACTGATATTAGGCCT-1_V12N28-333_A1,0,0,0,0,0,0
CGAGCTGGGCTTTAGG-1_V12N28-333_A1,0,0,2,0,0,2
GGGTGTTTCAGCTATG-1_V12N28-333_A1,0,0,2,0,0,2
TTAATTTCAGACGCGG-1_V12N28-333_A1,1,5,2,1,0,9
ACTGCCGTCGTAACTC-1_V12N28-333_A1,0,2,3,0,0,5
GTGCACGAAAGTGACT-1_V12N28-333_A1,1,2,2,0,0,5
ATCTCCCTGCAATCTA-1_V12N28-333_A1,2,1,1,0,0,4
ACGCCAGATGATTTCT-1_V12N28-333_A1,0,2,2,0,0,4
AGCTATTTAATCCAAC-1_V12N28-333_A1,0,1,1,1,0,3
CCACGAGAAGAGAATC-1_V12N28-333_A1,1,0,2,0,0,3
GATTCCGCGTTTCCGT-1_V12N28-333_A1,0,5,2,0,0,7
GTCGGATGTAGCGCGC-1_V12N28-333_A1,0,0,3,0,0,3
TATTTATACCGAGTAG-1_V12N28-333_A1,0,1,0,0,0,1
GTAGGTGATCCGTGTA-1_V12N28-333_A1,0,1,2,0,0,3
AGTTAAGCGGTCCCGG-1_V12N28-333_A1,0,3,1,0,0,4
CTGGCGACATAAGTCC-1_V12N28-333_A1,0,2,2,0,0,4
TTGGCCTAGAATTTCG-1_V12N28-333_A1,0,2,2,0,0,4
GGCATATCGGTTCTGC-1_V12N28-333_A1,0,5,3,0,0,8
GGGCGTCCACTGGCTC-1_V12N28-333_A1,0,3,1,0,0,4
TTACCCATTGCCGGGT-1_V12N28-333_A1,0,1,1,0,0,2
TTAGACACGATCGTTG-1_V12N28-333_A1,1,3,2,0,0,6
GCGCTGATCCAGACTC-1_V12N28-333_A1,0,0,4,0,0,4
TTCGGCAACCCGCTGA-1_V12N28-333_A1,0,1,2,0,0,3
GATATTTCCTACATGG-1_V12N28-333_A1,0,2,2,2,0,6
CTGCGTTACGATATAA-1_V12N28-333_A1,0,5,1,1,0,7
TAATAAACAAGGAGAT-1_V12N28-333_A1,0,3,2,0,0,5
AACCTTTACGACGTCT-1_V12N28-333_A1,0,5,0,0,0,5
AGTCCCGCCTTTAATT-1_V12N28-333_A1,1,2,2,1,0,6
TGAGATTAGGCCCTAA-1_V12N28-333_A1,0,5,2,1,1,9
AGTGTATTGCGCATTG-1_V12N28-333_A1,0,0,2,0,0,2
GTTGGATTCAGTGGCT-1_V12N28-333_A1,0,2,0,1,0,3
TAAAGCTGCAATAGGG-1_V12N28-333_A1,1,1,2,0,0,4
AGTAGGAAGGAAGTTG-1_V12N28-333_A1,0,2,2,0,0,4
TATCACTTCGAGTAAC-1_V12N28-333_A1,0,0,3,0,0,3
TGATCTACGCTGATCT-1_V12N28-333_A1,1,5,2,0,0,8
GGATCATCCCGTACGC-1_V12N28-333_A1,0,4,2,1,0,7
TGACACTTCTCTTTGC-1_V12N28-333_A1,1,1,1,1,1,5
AGCCCTTCTAATCCGA-1_V12N28-333_A1,0,2,2,0,0,4
CACCGCGTCCACTCTA-1_V12N28-333_A1,0,2,0,0,0,2
TAATTGGAATCGGGAA-1_V12N28-333_A1,0,3,3,0,0,6
TCGTAAGCTCCGAGGA-1_V12N28-333_A1,0,0,1,1,0,2
TATATTACAAATGTCG-1_V12N28-333_A1,0,0,5,1,0,6
CGCGAGAGGGACTTGT-1_V12N28-333_A1,0,2,1,0,1,4
GGACCTACGGTAACGT-1_V12N28-333_A1,0,1,2,1,0,4
GAAATATGCTTGAATG-1_V12N28-333_A1,0,2,2,0,0,4
CCGTATTAGCGCAGTT-1_V12N28-333_A1,0,2,3,0,1,6
AGGCGTCTATGGACGG-1_V12N28-333_A1,0,1,1,0,1,3
AACATCGATACGTCTA-1_V12N28-333_A1,0,0,2,0,0,2
TGAATATGCTATAAAC-1_V12N28-333_A1,0,1,1,0,0,2
ACCAAACACCCAGCGA-1_V12N28-333_A1,0,1,2,0,0,3
TGGCTTGTACAAGCTT-1_V12N28-333_A1,0,2,1,0,0,3
GAATGAAGGTCTTCAG-1_V12N28-333_A1,0,0,3,0,0,3
AGATACCAGCACTTCA-1_V12N28-333_A1,0,1,2,0,1,4
GCGGTCCCGGTGAAGG-1_V12N28-333_A1,0,0,1,0,0,1
GAGGCATTTGCAGCAG-1_V12N28-333_A1,0,0,0,0,0,0
GGCAAGCCAGGGATAG-1_V12N28-333_A1,0,0,1,0,0,1
TCTACGGGCTCAGTTG-1_V12N28-333_A1,0,0,0,0,0,0
TCTGCGAATCGTTCGC-1_V12N28-333_A1,0,1,3,0,0,4
AGCTCGTTGATGGAAA-1_V12N28-333_A1,0,0,0,0,0,0
TGAATGAGATACAGCA-1_V12N28-333_A1,0,0,0,0,1,1
ACCCTTGCCTGGGTCG-1_V12N28-333_A1,0,0,1,0,1,2
GGCGAACCGTTCTGAT-1_V12N28-333_A1,0,0,2,0,0,2
GCGATGTCTGTGCTTG-1_V12N28-333_A1,1,0,1,0,1,3
ATTAACACCTGAGATA-1_V12N28-333_A1,3,1,0,0,0,4
GAAATCTGACCAAGTT-1_V12N28-333_A1,3,1,0,0,1,5
CCTGACAAACTCGCGC-1_V12N28-333_A1,3,1,0,0,0,4
ATGTCATTTCCCATTG-1_V12N28-333_A1,3,1,0,0,0,4
GCGGTGCGGAGCATCG-1_V12N28-333_A1,5,0,0,0,0,5
CGGAAAGCAAATGTGC-1_V12N28-333_A1,2,0,0,0,0,2
GCTGAGCAACGGTTCT-1_V12N28-333_A1,3,0,0,0,0,3
TCACTCTTCGTCTGTC-1_V12N28-333_A1,3,1,0,0,0,4
GATCTTCATTGTCCTC-1_V12N28-333_A1,1,1,1,0,0,3
ACTCGATGTATTTCAT-1_V12N28-333_A1,1,1,1,0,0,3
TGAAGAGCGGTCCTAG-1_V12N28-333_A1,0,0,4,0,0,4
TAAACGTCGTCAATGA-1_V12N28-333_A1,0,0,3,0,0,3
ACGTTATTGGTCACTC-1_V12N28-333_A1,0,1,1,0,0,2
ATAGCCTCAGTACCCA-1_V12N28-333_A1,1,2,1,0,0,4
CGGGAGTATACCGCCG-1_V12N28-333_A1,0,0,3,0,0,3
GTCCTACAGGCGGCTC-1_V12N28-333_A1,0,0,2,0,1,3
CGGATAAGCGGACATG-1_V12N28-333_A1,0,0,1,0,0,1
AACTTCTGCGTCTATC-1_V12N28-333_A1,0,0,0,0,0,0
GGGTTCAGACGAACAA-1_V12N28-333_A1,0,0,1,0,1,2
AGTCTGGACATCCTTG-1_V12N28-333_A1,0,0,2,0,0,2
TTGAACGAATCCTTTG-1_V12N28-333_A1,0,0,0,0,1,1
GAAATACTAAACGTTT-1_V12N28-333_A1,0,0,2,0,0,2
CCCGCGCAATGCACCC-1_V12N28-333_A1,0,1,1,0,1,3
TTCGGCTAGAGATGGT-1_V12N28-333_A1,0,0,4,0,1,5
GACACGAGTTAGAGGA-1_V12N28-333_A1,0,0,0,0,0,0
GAGGTCCCAAAGATCT-1_V12N28-333_A1,0,1,0,0,0,1
TAACTCCATGGAGGCT-1_V12N28-333_A1,0,0,0,0,0,0
CTTGTTTATGTAGCCA-1_V12N28-333_A1,0,0,2,0,0,2
GATGGCGCACACATTA-1_V12N28-333_A1,0,0,2,0,0,2
ATAATAGTGTAGGGAC-1_V12N28-333_A1,0,0,2,0,1,3
CGCTATTCAATGTATG-1_V12N28-333_A1,0,0,2,0,0,2
ATATTGCTGTCAAAGT-1_V12N28-333_A1,0,0,0,0,2,2
GGATTCAGTACGGTGG-1_V12N28-333_A1,1,0,0,0,0,1
TTCTTAGTGAACGGTG-1_V12N28-333_A1,0,0,1,0,0,1
AATGGTTCTCACAAGC-1_V12N28-333_A1,0,2,1,0,1,4
TATACACGCAAAGTAT-1_V12N28-333_A1,0,3,2,0,1,6
CTTCATAGCTCAAGAA-1_V12N28-333_A1,0,0,0,0,0,0
CAACGGTTCTTGATAC-1_V12N28-333_A1,0,0,0,0,1,1
ACACCCGAGAAATCCG-1_V12N28-333_A1,0,1,2,0,0,3
TCTATCATGCAGTTAC-1_V12N28-333_A1,1,0,0,0,2,3
CCCGCCATGCTCCCGT-1_V12N28-333_A1,1,0,1,0,0,2
CGCTTCCACTGAAATC-1_V12N28-333_A1,0,0,1,0,0,1
CACTGTCCAAGTGAGA-1_V12N28-333_A1,2,3,0,0,0,5
ATTACTAGCCTCTTGC-1_V12N28-333_A1,1,4,0,0,1,6
CATAGTAGCATAGTAG-1_V12N28-333_A1,0,0,1,0,0,1
CAACTCCTTGATCCCG-1_V12N28-333_A1,1,0,1,0,0,2
GCGGGAACCAGGCCCT-1_V12N28-333_A1,3,0,0,0,0,3
TGGCTTTGGGTAGACA-1_V12N28-333_A1,0,0,0,0,0,0
TATCCATATCATGCGA-1_V12N28-333_A1,1,2,0,0,0,3
GGAGTGCCGCCCTGGA-1_V12N28-333_A1,1,5,1,0,1,8
TGAGAATGCTTTACCG-1_V12N28-333_A1,0,0,1,0,0,1
TTAACCAACCCTCCCT-1_V12N28-333_A1,1,2,2,0,0,5
TGTTTCGGTACTTCTC-1_V12N28-333_A1,1,1,0,0,1,3
TTGCTGAAGGAACCAC-1_V12N28-333_A1,2,2,1,0,0,5
TATTTAGTCTAGATCG-1_V12N28-333_A1,1,1,1,0,0,3
CTCCGGCCTAATATGC-1_V12N28-333_A1,3,1,0,0,0,4
TTGTGGCCCTGACAGT-1_V12N28-333_A1,1,4,1,2,0,8
TCGCCGGTCGATCCGT-1_V12N28-333_A1,0,0,3,0,0,3
CCATAGGTTGGCGTGG-1_V12N28-333_A1,1,1,0,0,0,2
GAACGACCGAATGATA-1_V12N28-333_A1,0,1,2,0,0,3
TCCGATAATTGCCATA-1_V12N28-333_A1,1,1,1,0,0,3
CATTACGTCGGCCCGT-1_V12N28-333_A1,0,1,1,0,0,2
CAAGCACCAAATGCCT-1_V12N28-333_A1,0,1,3,0,0,4
TGCATGGATCGGATCT-1_V12N28-333_A1,0,2,0,0,0,2
GAAATCGCGCGCAACT-1_V12N28-333_A1,0,2,2,0,0,4
CTGAAAGAGATCCGAC-1_V12N28-333_A1,1,1,1,0,0,3
CACCTCGATGGTGGAC-1_V12N28-333_A1,0,0,1,0,0,1
ATTTGTTCCAGGGCTC-1_V12N28-333_A1,1,3,3,0,0,7
TGGGCCACAAGAGCGC-1_V12N28-333_A1,0,1,2,0,0,3
CCTTCTTGATCCAGTG-1_V12N28-333_A1,0,4,2,0,0,6
CCTCGCCAGCAAATTA-1_V12N28-333_A1,0,1,3,0,0,4
TTCATGGCGCAACAGG-1_V12N28-333_A1,1,4,1,0,0,6
TTAATCAGTACGTCAG-1_V12N28-333_A1,0,1,2,0,0,3
CCTATCTATATCGGAA-1_V12N28-333_A1,1,0,2,0,0,3
ATTATACTTTGCTCGT-1_V12N28-333_A1,0,3,2,0,0,5
ATGGATCCGGCGTCCG-1_V12N28-333_A1,0,1,3,0,1,5
CGCCCGCTTCCGTACA-1_V12N28-333_A1,0,1,3,0,0,4
GGATTCCGCTATACCC-1_V12N28-333_A1,0,3,2,0,1,6
CGGTCTATCAACCCGT-1_V12N28-333_A1,0,1,4,0,0,5
ATGCCGGTTGATGGGA-1_V12N28-333_A1,0,1,1,0,0,2
TCATGCAGGTTCTCAT-1_V12N28-333_A1,0,2,0,0,0,2
TGAGCTTTAATGACGC-1_V12N28-333_A1,0,1,2,1,1,5
TCCCTTAGATTACTCG-1_V12N28-333_A1,0,5,3,0,0,8
ATATCTCCCTCGTTAA-1_V12N28-333_A1,1,3,4,0,0,8
AGCTCTTCCCAGTGCA-1_V12N28-333_A1,0,2,2,1,0,5
TCGCTAAACCGCTATC-1_V12N28-333_A1,0,1,2,2,0,5
CACATTCTTTCGATGG-1_V12N28-333_A1,0,1,0,0,0,1
GATATGCGGTAGCCAA-1_V12N28-333_A1,0,2,0,0,0,2
CGTTTCACTTCGGGCG-1_V12N28-333_A1,1,1,3,0,0,5
CCAATTACGGGTCGAG-1_V12N28-333_A1,0,0,2,0,0,2
GCAGGTAGAGTATGGT-1_V12N28-333_A1,0,2,3,0,0,5
GTCGTATTGGCGTACA-1_V12N28-333_A1,0,3,2,0,0,5
GAAATTAGCACGGATA-1_V12N28-333_A1,0,1,1,0,0,2
AATGCACCAAGCAATG-1_V12N28-333_A1,0,2,3,0,0,5
AGGACGCTCGATGTTG-1_V12N28-333_A1,0,3,3,0,0,6
GGCTAAAGGGCGGGTC-1_V12N28-333_A1,0,1,2,0,0,3
CATCTATCCCGTGTCT-1_V12N28-333_A1,0,2,3,0,0,5
CAGTAACTATTTATTG-1_V12N28-333_A1,0,1,2,0,0,3
CATATACTACTGATAA-1_V12N28-333_A1,1,2,0,1,0,4
GCGTTCGGAGACCGGG-1_V12N28-333_A1,0,2,2,0,0,4
AAGTTCAGTCTGCGTA-1_V12N28-333_A1,0,4,1,0,0,5
CGAAGCTATAAATTCA-1_V12N28-333_A1,0,2,5,0,0,7
CGCGGTCACAAACCAA-1_V12N28-333_A1,0,2,2,0,1,5
GGGAATGAGCCCTCAC-1_V12N28-333_A1,0,1,1,0,0,2
ACGGAGCGCAAATTAC-1_V12N28-333_A1,0,2,2,0,0,4
CGTTCTTCGCACACCT-1_V12N28-333_A1,0,1,2,0,1,4
GAATAGCCCTGCGGTC-1_V12N28-333_A1,0,1,0,0,0,1
AATAGCTACCGCGTGC-1_V12N28-333_A1,0,0,2,1,0,3
CCGAGCTGTGCTTGTC-1_V12N28-333_A1,0,2,2,0,0,4
GATGACGATGATCGCG-1_V12N28-333_A1,0,2,2,1,0,5
GCCTATGCTGGGCCTT-1_V12N28-333_A1,0,2,2,0,2,6
TTACTGTCTAGAGCTC-1_V12N28-333_A1,0,0,0,0,0,0
AGCGGTTGCCGCTCTG-1_V12N28-333_A1,0,2,1,0,2,5
GCTTGCAGCACAATTG-1_V12N28-333_A1,0,0,15,0,0,15
CCGGAGGTCTTATGGT-1_V12N28-333_A1,0,1,2,0,0,3
ACAGTATACCGTGGGA-1_V12N28-333_A1,0,0,0,0,0,0
GGGATCCCAATACAAA-1_V12N28-333_A1,0,1,1,0,0,2
ATTACGACTCCACAGT-1_V12N28-333_A1,0,0,2,0,0,2
CTCACACGCAAGCCTA-1_V12N28-333_A1,0,0,1,0,0,1
CCAGATGTAAATGGGT-1_V12N28-333_A1,0,0,1,0,0,1
GAACTTGTGCACGGGA-1_V12N28-333_A1,1,1,2,0,0,4
AAGCCGCTTTACCTTG-1_V12N28-333_A1,0,0,0,0,0,0
TCCATTCCCACTAGAG-1_V12N28-333_A1,0,0,3,0,0,3
AGAGCGCTTGTAACGG-1_V12N28-333_A1,0,0,2,0,0,2
TGGGTTCCCGGACGGA-1_V12N28-333_A1,3,0,1,1,0,5
GCTGCGCCTCCCACGT-1_V12N28-333_A1,2,1,0,0,0,3
CTGTTGGCTCTTCTGA-1_V12N28-333_A1,8,0,0,0,0,8
TTGTTCTAGATACGCT-1_V12N28-333_A1,3,0,0,0,0,3
CCCTCAAGCTCTTAGT-1_V12N28-333_A1,0,0,0,0,0,0
TGGTCTAGCTTACATG-1_V12N28-333_A1,1,0,0,0,0,1
ATGCACCTTCCTTAAT-1_V12N28-333_A1,1,2,0,0,0,3
GGGATACGGTAATAAT-1_V12N28-333_A1,0,0,3,0,0,3
AGTTCACCGGTTGGAC-1_V12N28-333_A1,2,0,0,0,0,2
GACATACTGTCGCAGA-1_V12N28-333_A1,0,1,3,0,1,5
TGGACACCGTTGCTTG-1_V12N28-333_A1,0,0,3,0,0,3
TGCGATGCTAATGGCT-1_V12N28-333_A1,0,0,3,0,0,3
TTCTGTTTCCTGTCGC-1_V12N28-333_A1,0,2,1,0,0,3
CGTTGTAAACGTCAGG-1_V12N28-333_A1,0,0,3,0,2,5
GATCGGCGATAAGTCG-1_V12N28-333_A1,0,0,1,0,0,1
AGCCTTAAAGCGGAAG-1_V12N28-333_A1,0,0,2,0,0,2
TCCGTAACCACAATCC-1_V12N28-333_A1,0,0,3,0,0,3
GAATGCCGAAATGACC-1_V12N28-333_A1,0,0,1,1,0,2
TATACTCATGCGGCAA-1_V12N28-333_A1,0,1,4,0,0,5
TAGTGTCAGAAACGGC-1_V12N28-333_A1,0,0,1,0,0,1
CGTCATACCATATCCA-1_V12N28-333_A1,5,0,3,0,0,8
TAGTACCTTAGTGGTC-1_V12N28-333_A1,0,1,2,0,0,3
CTGGCGGGAATAAGTA-1_V12N28-333_A1,0,1,0,0,0,1
AGTGTGGTCTATTGTG-1_V12N28-333_A1,0,0,1,0,0,1
GCTATCGCGGCGCAAC-1_V12N28-333_A1,0,0,3,0,0,3
CAGTAATCCCTCCCAG-1_V12N28-333_A1,0,1,1,0,0,2
GTATTAAGGCGTCTAA-1_V12N28-333_A1,0,0,1,0,0,1
CTAATTTCAACAACAC-1_V12N28-333_A1,0,0,1,0,0,1
TTAGCAACATGGATGT-1_V12N28-333_A1,0,0,0,0,0,0
ATGCTCAGTGTTGCAT-1_V12N28-333_A1,0,0,1,0,0,1
GATGTTTGTGCGAGAT-1_V12N28-333_A1,0,0,1,0,0,1
CACTTCGCCACAGGCT-1_V12N28-333_A1,0,0,3,0,0,3
CTGTATGGTGTAGAAA-1_V12N28-333_A1,0,1,0,0,2,3
TACGTGCACTATGCTG-1_V12N28-333_A1,0,0,3,0,0,3
GTATCAGCTTGGGTTC-1_V12N28-333_A1,0,0,1,0,0,1
TAACAAAGGGAGAAGC-1_V12N28-333_A1,0,0,0,0,0,0
TTACATCGTGGCCTGG-1_V12N28-333_A1,0,0,1,0,0,1
TCTGAACCGGTCGGCT-1_V12N28-333_A1,0,2,5,0,0,7
GGCTCGTGCCACCAGC-1_V12N28-333_A1,0,0,0,0,0,0
TATAAGTGAGGATAGC-1_V12N28-333_A1,0,1,1,0,1,3
GCCCGCGCGTTTGACA-1_V12N28-333_A1,1,1,1,1,0,4
TGCTGGTTGGACAATT-1_V12N28-333_A1,1,1,1,0,0,3
GCCTAGCGATCTGACC-1_V12N28-333_A1,2,0,0,0,0,2
CCATGCTCTGCAGGAA-1_V12N28-333_A1,0,1,1,0,1,3
TATAAATCCACAAGCT-1_V12N28-333_A1,3,2,1,0,1,7
CGCTCGACATAATGAT-1_V12N28-333_A1,3,1,0,0,0,4
CCAATTGAATGTTAAT-1_V12N28-333_A1,0,0,0,0,0,0
GCTAATACCGAATGCC-1_V12N28-333_A1,0,0,0,0,0,0
TTCCTCGAGGGTGTCT-1_V12N28-333_A1,0,0,0,0,0,0
CAACGACCCGTTTACA-1_V12N28-333_A1,0,0,0,0,0,0
CTTGTACTTGTTGACT-1_V12N28-333_A1,1,4,0,0,0,5
TCTCTAATAGCTGGTA-1_V12N28-333_A1,1,1,0,0,0,2
ATTATGCCATAGGGAG-1_V12N28-333_A1,1,1,0,0,0,2
GACAACGCAGCTTACG-1_V12N28-333_A1,0,1,3,0,0,4
AGATGACTCGCCCACG-1_V12N28-333_A1,2,1,1,0,0,4
GTGCGGGTCTCCAAAT-1_V12N28-333_A1,0,0,3,0,0,3
GTACGAGATTGCGACA-1_V12N28-333_A1,0,0,1,0,0,1
GTATAGGACTCAGTAG-1_V12N28-333_A1,0,1,1,0,0,2
TTGCACGGAGCAGCAC-1_V12N28-333_A1,1,4,0,0,0,5
CACAGCTAGGGAGTGA-1_V12N28-333_A1,0,1,1,0,0,2
ATACTAGCATGACCCT-1_V12N28-333_A1,1,0,2,0,0,3
CCAAGACTTCTGCGAA-1_V12N28-333_A1,0,0,2,0,0,2
ACATAATAAGGCGGTG-1_V12N28-333_A1,1,2,0,0,0,3
TAATACACAGTAGTAT-1_V12N28-333_A1,1,1,0,2,0,4
TCTTGGTAACACCAAA-1_V12N28-333_A1,1,1,2,0,0,4
AACTGGGTCCCGACGT-1_V12N28-333_A1,0,1,2,0,0,3
ATCACTTCATCCTCGC-1_V12N28-333_A1,0,5,2,0,0,7
TGGAAGGATAAAGATG-1_V12N28-333_A1,0,1,2,0,0,3
CATGATGCACAATTCT-1_V12N28-333_A1,1,4,1,0,0,6
TGCCTGATCAAACGAT-1_V12N28-333_A1,0,0,3,0,0,3
ATAGGGATATCCTTGA-1_V12N28-333_A1,0,4,1,0,0,5
CACCTAATCAGTTTAC-1_V12N28-333_A1,0,3,3,0,0,6
TGTGACTACGCCAGTC-1_V12N28-333_A1,0,2,1,0,0,3
CCCGACCATAGTCCGC-1_V12N28-333_A1,0,2,2,0,0,4
CGCGCCCGACTTAATA-1_V12N28-333_A1,1,1,2,0,1,5
TGCCACCTGGCGAAAC-1_V12N28-333_A1,1,4,0,0,0,5
CTGCCAAGGTTGGAAG-1_V12N28-333_A1,0,2,3,0,0,5
TCTCCAACGTAGGTTA-1_V12N28-333_A1,0,0,2,1,0,3
TTCTTGGAGTAATGAG-1_V12N28-333_A1,0,2,3,1,0,6
GTCTCGATCTGCTTTC-1_V12N28-333_A1,0,5,2,0,0,7
TACTCTCCGAACAAAT-1_V12N28-333_A1,1,3,3,0,0,7
ATCACATTAGAATATC-1_V12N28-333_A1,1,3,2,0,0,6
AGCTGAAGTAAACCAA-1_V12N28-333_A1,0,1,2,0,0,3
CACCCACGAGGCAATT-1_V12N28-333_A1,0,1,2,1,0,4
TGCCATTACTAAAGAA-1_V12N28-333_A1,0,2,4,0,0,6
CCGTTACGTTAGAACA-1_V12N28-333_A1,0,1,1,0,0,2
GCCAGGAGTAACCGAT-1_V12N28-333_A1,0,3,2,0,1,6
GGAAAGTGCCCATGCC-1_V12N28-333_A1,0,1,2,1,0,4
TCTTACCGGAACTCGT-1_V12N28-333_A1,0,1,1,0,0,2
TATGTCAAGACCGACT-1_V12N28-333_A1,0,2,3,0,0,5
CCTAACTAAGGCTCTA-1_V12N28-333_A1,0,4,1,0,0,5
GCGGTGAACTGCGCTC-1_V12N28-333_A1,0,0,1,1,0,2
CCTCGCGCGATATAGG-1_V12N28-333_A1,0,1,1,0,0,2
ATCGGCAAGCAGTCCA-1_V12N28-333_A1,0,6,1,0,0,7
AGATCGTGCATAAGAT-1_V12N28-333_A1,0,3,3,0,0,6
ATTCAGGACCTATTTC-1_V12N28-333_A1,1,4,3,1,0,9
AGCTAGAAGCAGAAGT-1_V12N28-333_A1,0,4,0,0,0,4
TTCGCTATCTGACGTG-1_V12N28-333_A1,0,1,2,0,1,4
TTCCGCAGAGAAATAT-1_V12N28-333_A1,0,0,2,0,0,2
CAGTACATTCTCTAAA-1_V12N28-333_A1,0,3,1,0,0,4
GTGAAGATTTCAAGTG-1_V12N28-333_A1,0,1,1,0,0,2
AACGCATGATCTGGGT-1_V12N28-333_A1,0,2,2,0,0,4
CCCAGAGGAGGGCGTA-1_V12N28-333_A1,0,1,1,0,0,2
GGAAACCTTGTTGAAT-1_V12N28-333_A1,0,3,2,0,0,5
GTGAAGCCGTATAGTC-1_V12N28-333_A1,0,1,3,0,0,4
GAGCTGTCGTCTCGGA-1_V12N28-333_A1,0,1,1,0,0,2
TGTCATTTGTTGGGAA-1_V12N28-333_A1,0,0,4,0,0,4
ACCAACACCACACACT-1_V12N28-333_A1,0,1,2,0,1,4
AAATGATTCGATCAGC-1_V12N28-333_A1,0,0,1,0,2,3
CTGCTTTATGTCCGCG-1_V12N28-333_A1,0,1,2,1,1,5
GCGAGAGGCCATGTAA-1_V12N28-333_A1,0,2,3,0,0,5
ATTGACCGGCGATGAC-1_V12N28-333_A1,0,0,2,0,0,2
ACCCTGGTAACGCCCT-1_V12N28-333_A1,0,1,3,0,0,4
GTTGGACCGCATCAGG-1_V12N28-333_A1,0,0,0,0,0,0
CGTTTACAAGGCAGCT-1_V12N28-333_A1,0,1,3,0,0,4
CGGTCCATGAGACTCC-1_V12N28-333_A1,0,1,1,0,2,4
GTTCGTCTGGGTCCCT-1_V12N28-333_A1,0,0,1,0,0,1
TGTACTACTCTCACGG-1_V12N28-333_A1,0,2,3,0,0,5
AGTGAAGATGGTGTCC-1_V12N28-333_A1,0,0,0,0,1,1
GAGGGCCATAATATTA-1_V12N28-333_A1,0,1,1,0,0,2
ACTCCCGTAGACTAGG-1_V12N28-333_A1,0,0,4,0,0,4
CGTCAAATGGTCGCAG-1_V12N28-333_A1,0,0,1,0,0,1
AAGTCTAGTAGCTGCC-1_V12N28-333_A1,0,0,1,0,1,2
AAGAAATCACCAGATT-1_V12N28-333_A1,0,0,2,0,1,3
GAGTGCACGGACAACA-1_V12N28-333_A1,0,0,2,0,1,3
GTTCAAATCAGATGTC-1_V12N28-333_A1,5,0,0,0,0,5
CATGGCTCCCTATGTC-1_V12N28-333_A1,0,1,0,0,0,1
GGCCACACGAAAGCCT-1_V12N28-333_A1,3,0,0,0,0,3
GAAGCCGGGTAAGCTC-1_V12N28-333_A1,3,0,1,0,0,4
TTGCGCTCTCTCGCTT-1_V12N28-333_A1,0,1,2,0,0,3
TACATGACCTTATCCG-1_V12N28-333_A1,3,0,0,0,2,5
GTCCTTCTACAACCCA-1_V12N28-333_A1,0,0,3,0,0,3
TATATGCTGGGTTGCC-1_V12N28-333_A1,0,0,4,0,0,4
GTTTATGGGATTTAGA-1_V12N28-333_A1,0,0,5,0,0,5
GGAACCCGAACAAGAA-1_V12N28-333_A1,0,1,2,0,1,4
AACGTTATCAGCACCT-1_V12N28-333_A1,0,1,0,0,0,1
CATCGTCCGGTTACTA-1_V12N28-333_A1,0,1,3,0,0,4
AGACAGCTCAGAATCC-1_V12N28-333_A1,0,0,2,0,0,2
GCAGATCCTCGCAAAT-1_V12N28-333_A1,0,0,4,0,0,4
GGGTCATGCGTACCAT-1_V12N28-333_A1,0,1,2,0,1,4
CTGGTCATTCCAATCC-1_V12N28-333_A1,0,0,1,0,0,1
TCAGGGCGCAAACTCG-1_V12N28-333_A1,0,0,1,0,0,1
GATGCCAGCAGAAGGC-1_V12N28-333_A1,0,1,1,0,0,2
GTTATTAACGTGGGAG-1_V12N28-333_A1,0,0,3,0,0,3
AATACAATGTTTCAGG-1_V12N28-333_A1,0,1,2,0,0,3
TTGCTGCACCTATCCA-1_V12N28-333_A1,0,0,2,0,0,2
CCAGAGACAAAGCCGG-1_V12N28-333_A1,0,1,2,0,1,4
CCGAAGTATATTGTTC-1_V12N28-333_A1,0,1,0,0,1,2
GCTAAACCTGAGGTGA-1_V12N28-333_A1,0,1,2,0,1,4
TCATACTTACAGATCC-1_V12N28-333_A1,0,2,5,0,0,7
CGAGCACTTCAAGTTT-1_V12N28-333_A1,0,0,1,0,0,1
TAGCAACCTGTCACAA-1_V12N28-333_A1,0,0,2,0,0,2
TGGGAAATGCCTTTCC-1_V12N28-333_A1,0,0,0,0,0,0
AGACCATGGGATACAA-1_V12N28-333_A1,0,1,1,0,0,2
TAAATGAATCCGTTTC-1_V12N28-333_A1,0,0,1,0,1,2
ACAACGGTCCCTGCGA-1_V12N28-333_A1,0,0,1,0,0,1
GTCACTCTCCAAATCT-1_V12N28-333_A1,0,1,2,0,0,3
TTCTACTTGCGAGGGC-1_V12N28-333_A1,0,0,0,0,0,0
CGCAATTACTTTCGGT-1_V12N28-333_A1,0,0,0,0,0,0
CTGTTCATCTCACGGG-1_V12N28-333_A1,9,0,0,0,0,9
TTCTTGTAACCTAATG-1_V12N28-333_A1,0,1,2,0,0,3
GCTTGATGATAATCAG-1_V12N28-333_A1,0,3,1,0,0,4
TTGGCTCGCATGAGAC-1_V12N28-333_A1,0,0,0,0,1,1
GCCCAGTTGGTATGCC-1_V12N28-333_A1,2,0,3,0,0,5
ATTCCTCCGCCAGTGC-1_V12N28-333_A1,0,0,1,0,0,1
TCGTCCGCTGGCGTCT-1_V12N28-333_A1,0,0,2,0,1,3
GGAGAAGTCATTGGCA-1_V12N28-333_A1,0,2,2,0,3,7
TTGTTAGCAAATTCGA-1_V12N28-333_A1,1,0,0,0,1,2
TCTAGCATCTTCGATG-1_V12N28-333_A1,1,0,0,0,0,1
TTCTAGGCCAATTGTG-1_V12N28-333_A1,2,0,0,0,1,3
TCACGGTCATCGCACA-1_V12N28-333_A1,2,0,2,0,0,4
ATGAAGCCAAGGAGCC-1_V12N28-333_A1,2,2,0,0,0,4
AATGACTGTCAGCCGG-1_V12N28-333_A1,1,1,0,0,1,3
CCAAACAGAACCCTCG-1_V12N28-333_A1,1,0,0,0,0,1
TATCGATGATTAAACG-1_V12N28-333_A1,2,0,0,0,0,2
GAACACACATCAACCA-1_V12N28-333_A1,1,1,0,0,0,2
CCCGTCAGCGTCTGAC-1_V12N28-333_A1,1,3,1,0,0,5
AGCATCGTCGATAATT-1_V12N28-333_A1,0,0,1,0,0,1
GACTAAGATCATGCAC-1_V12N28-333_A1,0,3,3,0,0,6
TAGGGTGTTTCAAGAG-1_V12N28-333_A1,1,1,1,1,0,4
TGGTTCGTAGCAAAGG-1_V12N28-333_A1,2,1,1,0,0,4
CTGTTCACTGCCTGTG-1_V12N28-333_A1,2,3,1,1,0,7
ATGTGCATCCGACGCA-1_V12N28-333_A1,1,1,1,0,0,3
TTGTCGTTCAGTTACC-1_V12N28-333_A1,2,1,1,0,0,4
CGGGATCAATGTAAGA-1_V12N28-333_A1,0,2,1,0,0,3
TTATCTGTATCATAAC-1_V12N28-333_A1,0,3,1,0,0,4
ATCGACTCTTTCCGTT-1_V12N28-333_A1,0,2,2,0,0,4
CTCATTTGATGGGCGG-1_V12N28-333_A1,0,3,1,1,0,5
GTAAGCGGGCAGTCAG-1_V12N28-333_A1,0,1,3,0,0,4
TCTATCGGTCGCAACA-1_V12N28-333_A1,0,1,2,0,0,3
AACGCGGTCTCCAGCC-1_V12N28-333_A1,0,3,1,0,0,4
ATTAATACTACGCGGG-1_V12N28-333_A1,0,1,2,0,0,3
CTTTAACTTTCAAAGG-1_V12N28-333_A1,0,4,1,1,0,6
CGTACCTGATAGGCCT-1_V12N28-333_A1,0,3,2,0,0,5
GAATGTTGGGTAATCT-1_V12N28-333_A1,2,2,3,0,1,8
TGCGGAGTAAAGGTGC-1_V12N28-333_A1,0,5,0,0,0,5
CCTGAATATTTACATA-1_V12N28-333_A1,0,0,2,0,0,2
TTGCTCCCATACCGGA-1_V12N28-333_A1,1,2,2,0,0,5
CCTCTAATCTGCCAAG-1_V12N28-333_A1,0,2,1,2,0,5
AGGTTGAGGCACGCTT-1_V12N28-333_A1,1,5,1,1,0,8
TCCCGTCAGTCCCGCA-1_V12N28-333_A1,0,2,2,0,0,4
TCCGATGACTGAGCTC-1_V12N28-333_A1,0,2,1,0,0,3
CAGCCTCCTGCAGAGG-1_V12N28-333_A1,0,5,1,0,0,6
CTTAGCCTTCCACATG-1_V12N28-333_A1,1,4,1,0,0,6
ATTAATGAACCAGTCG-1_V12N28-333_A1,0,2,2,0,0,4
ACGATACATAGAACTA-1_V12N28-333_A1,0,4,1,0,0,5
AGCCACTCCCGTGCTT-1_V12N28-333_A1,0,2,0,0,0,2
ATACGGGTTTCGATTG-1_V12N28-333_A1,0,0,0,0,0,0
ATCAGTAGGCAGGGAT-1_V12N28-333_A1,0,0,0,0,0,0
TATCGATCTATGCATA-1_V12N28-333_A1,0,2,3,0,0,5
CGACTCAGGATGTTAT-1_V12N28-333_A1,0,2,1,1,0,4
GCCATATTGCACACAG-1_V12N28-333_A1,0,4,1,0,0,5
AATTCATAAGGGATCT-1_V12N28-333_A1,0,2,1,0,0,3
CGGTAGAGGTGCAGGT-1_V12N28-333_A1,0,1,3,0,0,4
AATGATGATACGCTAT-1_V12N28-333_A1,0,2,3,0,0,5
CTTGTGCTCACCGATT-1_V12N28-333_A1,0,2,3,0,0,5
TTCCAATCAGAGCTAG-1_V12N28-333_A1,0,3,1,0,0,4
CGATGGACCCTACGCC-1_V12N28-333_A1,0,3,1,0,0,4
GGTCGGATAAACGGCG-1_V12N28-333_A1,0,0,1,0,0,1
TTAGCTAATACGATCT-1_V12N28-333_A1,0,4,2,0,0,6
CTCGATATTTGCGAGC-1_V12N28-333_A1,0,6,2,0,0,8
ATTACTTACTGGGCAT-1_V12N28-333_A1,0,1,2,0,0,3
CTAGCCGATGTTATGA-1_V12N28-333_A1,0,4,0,0,0,4
TACTGCAATCAATTAC-1_V12N28-333_A1,0,3,1,1,0,5
TAGTCTGTGACGTTGC-1_V12N28-333_A1,0,6,1,0,0,7
CTCGTTTCTAATGTTT-1_V12N28-333_A1,0,4,2,0,0,6
TTCGTTCAACGAAGTT-1_V12N28-333_A1,0,2,1,1,0,4
CTGAATTTATTGCCAG-1_V12N28-333_A1,0,2,2,0,0,4
TGGAATATCCTTGACC-1_V12N28-333_A1,0,3,2,0,1,6
CAGATCATTTAAAGTC-1_V12N28-333_A1,0,0,2,0,0,2
CTCCTTTACGCAAGTC-1_V12N28-333_A1,0,3,3,0,0,6
TCCCAAACAGACAACG-1_V12N28-333_A1,0,1,1,0,0,2
ATCGCTGCGTGCAGCA-1_V12N28-333_A1,0,1,3,0,0,4
TTAGTTCAAGTGTTCG-1_V12N28-333_A1,0,4,1,0,0,5
AAACTCGTGATATAAG-1_V12N28-333_A1,0,2,0,0,1,3
TTAACGAACAAGCAGT-1_V12N28-333_A1,0,0,2,0,0,2
GTTATATCAGGAGCCA-1_V12N28-333_A1,0,1,0,0,0,1
CAAATTGGATTATGCC-1_V12N28-333_A1,0,1,0,0,0,1
CGAGGAGCTTCCATAT-1_V12N28-333_A1,0,1,3,0,0,4
GGAGACCAATGTGCTT-1_V12N28-333_A1,0,0,0,0,1,1
CATTGATGAACACGCC-1_V12N28-333_A1,0,3,1,0,0,4
GTCAATGCTATAATTT-1_V12N28-333_A1,0,1,2,0,0,3
ACCACCCTCTCTTCTA-1_V12N28-333_A1,0,1,0,0,0,1
TGGAGGGAAACACCTC-1_V12N28-333_A1,0,0,2,0,0,2
CACGGACGTGGATGGC-1_V12N28-333_A1,0,0,4,0,0,4
AACTTTCTCGATCATG-1_V12N28-333_A1,0,1,1,0,3,5
CGTATTGTTTCCTAAT-1_V12N28-333_A1,0,1,1,0,1,3
CCTACTGCGGCGGCCA-1_V12N28-333_A1,0,0,1,0,0,1
CTTAGGTCCCAATCGT-1_V12N28-333_A1,0,0,2,0,1,3
CGCAATCGATCATTAG-1_V12N28-333_A1,1,1,1,0,0,3
TGGTTATGCTTGCGGT-1_V12N28-333_A1,2,2,0,0,0,4
GGCTTGGCTCTCACCT-1_V12N28-333_A1,1,0,0,0,0,1
ATTGGTAGGATCCGCT-1_V12N28-333_A1,4,1,1,0,0,6
TCAGGGCGACTTCCTT-1_V12N28-333_A1,1,1,0,0,0,2
TCTGCAGATTCGAGTC-1_V12N28-333_A1,0,0,3,0,0,3
CTCTCGCTGTACTATG-1_V12N28-333_A1,0,0,2,0,0,2
AATAGTCGCGAGTCGG-1_V12N28-333_A1,0,1,2,0,0,3
AGTTACCCTTAAGACT-1_V12N28-333_A1,0,0,3,0,0,3
CTTAAATAAGACCCAT-1_V12N28-333_A1,0,0,4,0,1,5
GGTTGTGCTCTTGTCC-1_V12N28-333_A1,0,1,6,0,0,7
GTGAGTCTAAGACGGA-1_V12N28-333_A1,0,0,2,0,0,2
CGCGACACTGCGCAGC-1_V12N28-333_A1,0,0,5,0,0,5
GCTCGCGGTTCCGCTC-1_V12N28-333_A1,0,0,1,0,0,1
TTAACTCACGCGTGGA-1_V12N28-333_A1,0,0,1,0,0,1
GGAACGGCCTGCAGCC-1_V12N28-333_A1,0,0,5,0,0,5
GTAGAAACGGGTGGAG-1_V12N28-333_A1,0,0,1,0,1,2
TAATGAAAGACCCTTG-1_V12N28-333_A1,0,0,0,0,0,0
AGGCTTGCTAGACACC-1_V12N28-333_A1,0,0,2,0,0,2
TTGCGTAGTTTGAGGA-1_V12N28-333_A1,0,3,3,0,0,6
CGCCCTTGAAGGCTGA-1_V12N28-333_A1,0,1,2,0,0,3
CCCGGTGGAAGAACCT-1_V12N28-333_A1,0,0,1,0,0,1
TTAACACCTCGAACAT-1_V12N28-333_A1,0,1,2,0,0,3
GATTCCTATACGGCGC-1_V12N28-333_A1,0,0,1,0,1,2
TTACCCTAACAGTCCT-1_V12N28-333_A1,0,1,3,0,0,4
ACCCACCTACATGCTC-1_V12N28-333_A1,0,0,0,0,0,0
AAAGGGCAGCTTGAAT-1_V12N28-333_A1,0,0,0,0,0,0
CACACAGGGATAGATT-1_V12N28-333_A1,0,0,1,0,0,1
AGAGCGTACAAGCTCG-1_V12N28-333_A1,0,0,4,0,0,4
TCTTACGGCATCCGAC-1_V12N28-333_A1,0,0,1,0,1,2
GCCTATTCCGATATAG-1_V12N28-333_A1,0,1,2,0,1,4
GAAAGTGACTAACTGC-1_V12N28-333_A1,0,0,0,0,2,2
CCGGAATGGTTTCAGT-1_V12N28-333_A1,0,0,1,0,0,1
AGTATAATACTAGGCA-1_V12N28-333_A1,0,0,0,0,0,0
TAACTATCGAAGGTCC-1_V12N28-333_A1,0,0,1,0,0,1
ATGAGGAGTGTTAATC-1_V12N28-333_A1,0,0,3,0,0,3
TGTGTCGCGAGTTGCA-1_V12N28-333_A1,0,1,2,0,0,3
ATCCAACGCAGTCATA-1_V12N28-333_A1,0,1,3,0,0,4
AAGGCGCGTAAAGCTT-1_V12N28-333_A1,0,0,1,0,1,2
AGTCGGCCCAAACGAC-1_V12N28-333_A1,0,0,1,0,0,1
AACGTCAGACTAGTGG-1_V12N28-333_A1,0,1,1,0,0,2
ACTACCAGCTCTCTGG-1_V12N28-333_A1,0,0,1,0,0,1
GCAAGTGCACAGAGAA-1_V12N28-333_A1,0,0,0,0,0,0
ACACCTTAAGTAGGGC-1_V12N28-333_A1,0,1,0,0,0,1
TTCGACGGGAAGGGCG-1_V12N28-333_A1,0,0,0,0,0,0
TTCGCACTCGCGTGCT-1_V12N28-333_A1,2,0,3,0,0,5
TATTTGTTACCCTTTA-1_V12N28-333_A1,2,2,1,0,0,5
CGCTGTGACGCCGCAC-1_V12N28-333_A1,1,0,0,1,2,4
GTTGCACGGAGTTTCG-1_V12N28-333_A1,1,0,0,0,0,1
GTTTCCTGGAGGGTGA-1_V12N28-333_A1,0,0,1,0,1,2
ACACCCAGCATGCAGC-1_V12N28-333_A1,2,1,1,0,0,4
TCAACCATGTTCGGGC-1_V12N28-333_A1,1,1,0,0,0,2
TTACAACTACGCATCC-1_V12N28-333_A1,0,2,1,0,0,3
TCCGATGGTGCGACAT-1_V12N28-333_A1,2,1,0,0,0,3
GGGCGTACATTTATAT-1_V12N28-333_A1,2,0,1,0,0,3
AGCGACCAACGATATT-1_V12N28-333_A1,3,1,1,0,0,5
ACACAAAGACGGGTGG-1_V12N28-333_A1,1,1,1,0,0,3
ATCGCACGCCGGGAGA-1_V12N28-333_A1,2,2,0,0,0,4
GCTCTAAACCCTGACG-1_V12N28-333_A1,0,0,3,0,1,4
AATGCAACCGGGTACC-1_V12N28-333_A1,2,0,1,0,0,3
TCAAACAACCGCGTCG-1_V12N28-333_A1,3,4,1,0,0,8
TATGCTCCCTACTTAC-1_V12N28-333_A1,0,3,2,0,0,5
AAAGGGATGTAGCAAG-1_V12N28-333_A1,1,0,3,0,0,4
ACGATCATACATAGAG-1_V12N28-333_A1,0,1,4,0,0,5
TTGTTCAGTGTGCTAC-1_V12N28-333_A1,0,1,2,0,0,3
ATGCATGATCCAGGAT-1_V12N28-333_A1,3,0,0,1,1,5
AGTCTTCTCCTCAAAT-1_V12N28-333_A1,0,0,4,0,0,4
GATTCCCTTGTCGCAG-1_V12N28-333_A1,2,0,3,0,1,6
CTCGCACCTATATAGT-1_V12N28-333_A1,0,5,2,0,0,7
ACTCAATAAAGGCACG-1_V12N28-333_A1,0,0,1,1,0,2
AACCGAGCTTGGTCAT-1_V12N28-333_A1,1,3,3,0,0,7
TAAGGCAACATAAGAT-1_V12N28-333_A1,0,0,3,0,0,3
CACGCACAGCGCAGCT-1_V12N28-333_A1,0,3,1,0,0,4
GGTTTACAATCTCAAT-1_V12N28-333_A1,0,3,5,0,0,8
TGCAGGATCGGCAAAG-1_V12N28-333_A1,0,4,1,0,0,5
ATAACGGAGTCCAACG-1_V12N28-333_A1,0,1,1,0,0,2
AACGATATGTCAACTG-1_V12N28-333_A1,0,0,3,0,0,3
GACAACGACCATTGAA-1_V12N28-333_A1,1,0,2,0,0,3
TTGACCATGTTCTCCG-1_V12N28-333_A1,0,1,2,0,0,3
AGTACGGGCACCTGGC-1_V12N28-333_A1,0,1,0,0,0,1
CGCCATCCGATTATGA-1_V12N28-333_A1,0,3,2,1,0,6
AAGGTATCCTAATATA-1_V12N28-333_A1,0,0,2,0,0,2
TGTTGTCAAGAAGTCT-1_V12N28-333_A1,0,0,0,0,0,0
CAGTGAATAAATGACT-1_V12N28-333_A1,0,0,0,0,0,0
GTGAAACGGCGCCACC-1_V12N28-333_A1,0,0,0,0,0,0
GGGCTCATCGAACCCA-1_V12N28-333_A1,0,0,3,0,0,3
TTGATGTGTAGTCCCG-1_V12N28-333_A1,0,4,1,0,0,5
CAGTAGCCCACGCGGT-1_V12N28-333_A1,0,0,2,0,0,2
AGCGCGGGTGCCAATG-1_V12N28-333_A1,0,2,1,0,0,3
TAATCGATCCGTACGT-1_V12N28-333_A1,0,2,2,0,0,4
AGTGGCGGCAATTTGA-1_V12N28-333_A1,0,3,3,0,0,6
CCTTTCAATGAAGAAA-1_V12N28-333_A1,0,2,2,0,0,4
CTCAGTCACGACAAAT-1_V12N28-333_A1,0,5,1,0,0,6
ATAGGCTAGCTTCGCA-1_V12N28-333_A1,0,1,0,0,0,1
CGGTTCAAGTAGGTGT-1_V12N28-333_A1,0,4,4,1,0,9
CAGTCGAGGATGCAAT-1_V12N28-333_A1,0,0,3,0,0,3
TATCACCCAACCGACC-1_V12N28-333_A1,0,1,3,0,0,4
AATGATGCGACTCCTG-1_V12N28-333_A1,0,2,3,0,0,5
TGGAACCACTGACACA-1_V12N28-333_A1,0,2,2,0,0,4
GCCAATAGGGCATCTC-1_V12N28-333_A1,0,4,1,0,0,5
TTCTTTGGTCGCGACG-1_V12N28-333_A1,0,0,1,1,1,3
ATTAGATTCCTCAGCA-1_V12N28-333_A1,0,1,1,0,0,2
CCGTGGAACGATCCAA-1_V12N28-333_A1,0,1,3,0,0,4
GGGTCGTGGCAAGTGT-1_V12N28-333_A1,0,2,2,0,0,4
TCGCTCGGCACCAGCG-1_V12N28-333_A1,0,1,1,0,0,2
ACGCAATCACTACAGC-1_V12N28-333_A1,0,0,2,0,0,2
CTCTAATGCATTGATC-1_V12N28-333_A1,0,1,2,0,1,4
GTCTCGACTAAGTTTG-1_V12N28-333_A1,0,0,1,0,0,1
TGGTTTAAACGTGGGT-1_V12N28-333_A1,0,0,2,0,0,2
CGCAGATCTTCACCCG-1_V12N28-333_A1,0,0,1,0,0,1
TCCAGATGTACGCCAA-1_V12N28-333_A1,0,0,0,0,0,0
CATTGCGGGTCAATTC-1_V12N28-333_A1,0,0,3,0,0,3
GACGTTCGTAAATACA-1_V12N28-333_A1,0,0,1,1,1,3
TACACCGTCGTTAGTC-1_V12N28-333_A1,0,0,0,0,0,0
ACGGGCGTATGCGACA-1_V12N28-333_A1,0,0,2,0,0,2
GAAGGCTACCATTGTT-1_V12N28-333_A1,0,2,2,0,0,4
TAAATCTTTACACCTC-1_V12N28-333_A1,0,2,1,0,1,4
AGTTTATGTAAAGACA-1_V12N28-333_A1,0,0,1,0,0,1
AGGAGACATCCACAGT-1_V12N28-333_A1,0,0,1,0,0,1
CAACCTGAACCTGCCA-1_V12N28-333_A1,0,1,2,0,0,3
AGTCCCTCGCAGAAAG-1_V12N28-333_A1,0,0,1,0,1,2
TGTATACGGATGATGA-1_V12N28-333_A1,0,0,0,0,0,0
TTGTGGTATAGGTATG-1_V12N28-333_A1,0,0,3,0,0,3
TCTGCACCATTAGTAA-1_V12N28-333_A1,0,0,0,0,1,1
AAATGTATCTTATCCC-1_V12N28-333_A1,3,2,1,0,0,6
ACTCTAAACCTGGGAT-1_V12N28-333_A1,6,0,0,0,0,6
GCTGGCAGGTGCCGTG-1_V12N28-333_A1,1,0,0,0,0,1
CTCATTCGTGAACATC-1_V12N28-333_A1,3,0,0,0,0,3
TCGCCGGATGGGCAAG-1_V12N28-333_A1,2,0,0,0,0,2
GGACTAAGTCAGGAGT-1_V12N28-333_A1,4,0,2,0,0,6
TATCAAAGGTCTGTAA-1_V12N28-333_A1,0,1,0,0,0,1
TTCAGTTTGTGGCAGC-1_V12N28-333_A1,0,1,4,0,0,5
TGTTCATAAATGTGCT-1_V12N28-333_A1,0,0,2,0,1,3
CTTAGCCCGGATAGTG-1_V12N28-333_A1,0,1,7,0,0,8
GATGCGAATGGTATTA-1_V12N28-333_A1,0,0,6,0,0,6
TCTAACTGTATGTAAA-1_V12N28-333_A1,0,0,2,0,0,2
TTAAACCTGGTTCCTT-1_V12N28-333_A1,0,0,4,0,0,4
GCTAAGTAAAGGCGAT-1_V12N28-333_A1,0,0,1,0,1,2
AGTTACCGCACATGGT-1_V12N28-333_A1,0,0,0,0,0,0
GACTGCGGCACGTGTA-1_V12N28-333_A1,0,0,1,0,0,1
TGGTGATCGTATTTGT-1_V12N28-333_A1,0,0,1,0,0,1
TTATCGCCTGCGAAGC-1_V12N28-333_A1,0,1,3,0,0,4
TGGAATTAGACGCTTT-1_V12N28-333_A1,0,0,3,0,0,3
TCGTCACACTGTTAGC-1_V12N28-333_A1,0,0,2,0,2,4
TTATGTTTGCGATAGA-1_V12N28-333_A1,0,0,3,0,0,3
GGTGCTGATCACAAAG-1_V12N28-333_A1,0,1,0,0,0,1
CATAGCCGCCCGGGAT-1_V12N28-333_A1,0,0,3,0,0,3
GGTTAGTTACGGCGCC-1_V12N28-333_A1,0,1,4,0,1,6
ATTCCCACATAAACAA-1_V12N28-333_A1,0,2,1,0,0,3
ATTCAGTAGCAGGGTC-1_V12N28-333_A1,0,1,4,0,0,5
CAGTTCCGCGGGTCGA-1_V12N28-333_A1,0,0,0,0,0,0
AAGAGATGAATCGGTA-1_V12N28-333_A1,0,0,2,0,0,2
CGCAATTCTACAATAA-1_V12N28-333_A1,0,1,1,0,0,2
TAACGCTTTGAGAGCG-1_V12N28-333_A1,0,0,4,0,0,4
AGGCTATGGTTAGCTT-1_V12N28-333_A1,0,0,1,0,1,2
GAGGAATGGAGAGGTT-1_V12N28-333_A1,0,0,2,0,0,2
TCCTCTACGAGATGGC-1_V12N28-333_A1,0,1,1,0,0,2
TTGATTATGCAGATGA-1_V12N28-333_A1,0,0,0,0,0,0
TCAGTACTGACCCGCG-1_V12N28-333_A1,0,0,3,0,1,4
TTATGACAAACTGGAT-1_V12N28-333_A1,0,0,0,0,0,0
GTAAGTAGGGTATACC-1_V12N28-333_A1,0,1,2,0,0,3
CGCAAACACGAGTTAC-1_V12N28-333_A1,0,0,1,0,0,1
TGGCCGTATATTGACC-1_V12N28-333_A1,0,0,4,0,1,5
ACTGTAGCACTTTGGA-1_V12N28-333_A1,0,0,3,0,0,3
GCTCTATGTTACGTGC-1_V12N28-333_A1,0,1,0,0,0,1
TGCGCGATTAACGGAG-1_V12N28-333_A1,0,2,1,0,0,3
GAATCGACATGGTCAC-1_V12N28-333_A1,0,1,2,0,0,3
GACTAAGTAGGCTCAC-1_V12N28-333_A1,0,0,1,0,1,2
ATCTTGACCTGCAACG-1_V12N28-333_A1,0,1,1,0,0,2
ATGCACTACCGCATTG-1_V12N28-333_A1,2,0,2,0,0,4
CAGATACTAACATAGT-1_V12N28-333_A1,1,0,2,0,0,3
GATCGACACTATCTGA-1_V12N28-333_A1,0,0,3,0,0,3
ATAGAGTACTGGGACA-1_V12N28-333_A1,0,0,2,0,0,2
CCTACTGCTTACACTT-1_V12N28-333_A1,0,0,1,0,1,2
CCTGCTATTTGAGAAG-1_V12N28-333_A1,2,1,1,0,1,5
CGCGTTCATGAAATAC-1_V12N28-333_A1,0,1,0,0,1,2
CATTATGCTTGTTGTG-1_V12N28-333_A1,0,0,1,0,0,1
CCAGGGACGTGGCCTC-1_V12N28-333_A1,0,1,0,0,0,1
TATGGATGTGCTACGC-1_V12N28-333_A1,1,0,3,0,0,4
GTACTAAGATTTGGAG-1_V12N28-333_A1,1,2,2,0,1,6
AGACCCGCCCTCCTCG-1_V12N28-333_A1,0,4,1,0,0,5
CGCATTAGCTAATAGG-1_V12N28-333_A1,2,1,2,0,1,6
GCTCTCGGGTACCGAA-1_V12N28-333_A1,1,0,0,0,0,1
CACCGCCAGAAGGTTT-1_V12N28-333_A1,0,2,1,0,1,4
TCCCAAAGACGAAGGA-1_V12N28-333_A1,0,1,0,0,0,1
ATGGATTGACCAAACG-1_V12N28-333_A1,1,1,2,0,1,5
GTCATGGACATGACTA-1_V12N28-333_A1,2,3,5,0,0,10
CTACTGCCACCTGACC-1_V12N28-333_A1,1,2,2,0,0,5
TTATATTTGGCAATCC-1_V12N28-333_A1,0,1,2,0,0,3
AGCACCAGTACTCACG-1_V12N28-333_A1,1,4,0,0,0,5
CATGGTCTAGATACCG-1_V12N28-333_A1,0,1,2,0,0,3
TCTACCGTCCACAAGC-1_V12N28-333_A1,0,1,4,0,0,5
CTAGTTGGGCCCGGTA-1_V12N28-333_A1,0,1,1,1,0,3
TCCCGCGTACTCCTGG-1_V12N28-333_A1,0,0,0,1,0,1
CAGAGCATGAGCTTGC-1_V12N28-333_A1,0,1,2,0,0,3
ACACGGGAACTTAGGG-1_V12N28-333_A1,0,0,1,1,0,2
GGCTCTGCTCCAACGC-1_V12N28-333_A1,0,3,4,0,0,7
AGAACGTGGTACATTC-1_V12N28-333_A1,0,0,2,0,0,2
CAATAAACCTTGGCCC-1_V12N28-333_A1,0,0,2,0,0,2
ACTTCGCCATACGCAC-1_V12N28-333_A1,0,2,5,0,0,7
ATCTGGTTAAGACTGT-1_V12N28-333_A1,0,2,1,0,0,3
TCGTAAGACGACATTG-1_V12N28-333_A1,0,3,2,0,0,5
GTGTACCTTGGCTACG-1_V12N28-333_A1,0,3,0,0,0,3
GCCCGTAATACCTTCT-1_V12N28-333_A1,0,3,2,0,0,5
CGGTCAAGTGGGAACC-1_V12N28-333_A1,0,3,3,0,0,6
TTGTAAGGCCAGTTGG-1_V12N28-333_A1,0,0,3,0,0,3
GGAGCACCAAGAACTA-1_V12N28-333_A1,0,4,1,0,0,5
TAATAGTGACGACCAG-1_V12N28-333_A1,0,3,2,0,0,5
CTAAATCCTATTCCGG-1_V12N28-333_A1,0,0,1,0,0,1
CGAGTTCTGTCCCACC-1_V12N28-333_A1,0,3,0,0,1,4
AAGGATGAGGGACCTC-1_V12N28-333_A1,0,0,4,0,0,4
AGAGAACCGTCTAGGA-1_V12N28-333_A1,0,1,1,0,0,2
GAGGGCGCAGCTCTGC-1_V12N28-333_A1,0,2,3,0,0,5
AAGATTGGCGGAACGT-1_V12N28-333_A1,0,0,6,0,0,6
CCAGTAGTCTGATCCA-1_V12N28-333_A1,0,2,1,0,0,3
AAGGGACAGATTCTGT-1_V12N28-333_A1,0,2,0,1,0,3
ATAGAGTTATCAACTT-1_V12N28-333_A1,0,2,2,0,0,4
AAATTACCTATCGATG-1_V12N28-333_A1,0,4,1,0,1,6
GATCCTAAATCGGGAC-1_V12N28-333_A1,0,2,3,0,0,5
TTACAGACCTAAATGA-1_V12N28-333_A1,0,2,1,0,1,4
CCTCACCTTAGCATCG-1_V12N28-333_A1,0,1,0,0,0,1
CATGCGACCAGTTTAA-1_V12N28-333_A1,0,1,3,0,0,4
AACATATCAACTGGTG-1_V12N28-333_A1,0,4,3,1,0,8
CTATAAGAGCCAATCG-1_V12N28-333_A1,0,2,3,0,0,5
AATATCGAGGGTTCTC-1_V12N28-333_A1,0,2,2,0,0,4
GTACTCCTGGGTATGC-1_V12N28-333_A1,0,0,3,0,0,3
ATAAGTAGGATTCAGA-1_V12N28-333_A1,0,3,3,1,0,7
AGGTCGCGGAGTTACT-1_V12N28-333_A1,0,1,4,0,0,5
CTAATTCTCAGATATT-1_V12N28-333_A1,0,2,0,0,0,2
GCCAACCATTTCCGGA-1_V12N28-333_A1,0,3,4,0,0,7
TGATCCCAGCATTAGT-1_V12N28-333_A1,0,3,2,0,0,5
CGTTGTAAGATTGATT-1_V12N28-333_A1,0,2,3,0,0,5
GAAACCATGGTGCGCT-1_V12N28-333_A1,0,1,1,0,0,2
AATCTATGCCGGAGCC-1_V12N28-333_A1,0,0,0,1,1,2
GACTCCCAGAATAAGG-1_V12N28-333_A1,0,0,5,0,0,5
TATGATCCGGCACGCC-1_V12N28-333_A1,0,2,2,0,0,4
CCGCTTGCTGACATGG-1_V12N28-333_A1,0,1,0,0,0,1
TGGTTAAGGGCGCTGG-1_V12N28-333_A1,0,3,3,0,0,6
TTGATAGTCAATACAT-1_V12N28-333_A1,0,1,0,0,0,1
GGTTTAATTGAGCAGG-1_V12N28-333_A1,0,0,2,0,0,2
CATTACATAGATTGTG-1_V12N28-333_A1,0,3,2,0,1,6
GGTACACCAGATTTAT-1_V12N28-333_A1,0,1,3,0,0,4
GGCCCGTATACCATGC-1_V12N28-333_A1,0,0,2,0,0,2
ATCTTTCGTATAACCA-1_V12N28-333_A1,0,1,2,0,1,4
GAGATGACAATCCTTA-1_V12N28-333_A1,0,1,0,0,0,1
AAAGCTTGCCTACATA-1_V12N28-333_A1,0,0,1,0,0,1
GAACGATAAGTTAAAG-1_V12N28-333_A1,0,0,1,0,0,1
TAATAGCTAAATGATG-1_V12N28-333_A1,0,0,3,0,2,5
TATGGCTAGGCTAATT-1_V12N28-333_A1,0,0,0,0,1,1
AGGAGAGTCTGGCTAC-1_V12N28-333_A1,0,0,0,0,0,0
TGCTCTGCCGGTTCAC-1_V12N28-333_A1,0,0,0,0,2,2
CCAATAGATTTCATCT-1_V12N28-333_A1,3,0,0,0,0,3
GGGCACGAATTGGCCG-1_V12N28-333_A1,3,0,0,0,0,3
TCGTTGACAGGGTCCC-1_V12N28-333_A1,3,1,1,0,0,5
ATCGTATTCCGAGAAC-1_V12N28-333_A1,1,0,1,0,1,3
GGGAATTCTGTCCAGT-1_V12N28-333_A1,2,0,0,0,0,2
ACGCGTTTCTTAAGAG-1_V12N28-333_A1,2,1,0,0,1,4
GAGAGCGCAGTCCCTG-1_V12N28-333_A1,0,0,0,0,0,0
GTCCTATTGTTGTGGT-1_V12N28-333_A1,0,0,1,0,0,1
CATCTGCAGGATCATT-1_V12N28-333_A1,0,0,4,0,0,4
GAGTCGACAGACCCTC-1_V12N28-333_A1,0,0,4,0,0,4
AAGTGCAAAGGTAGAC-1_V12N28-333_A1,0,0,1,0,0,1
AGGGTGGATAGTGCAT-1_V12N28-333_A1,0,0,3,0,0,3
TGATAGCGGGATTCTA-1_V12N28-333_A1,0,0,1,0,0,1
GTCAGTTTGGTAGTCG-1_V12N28-333_A1,0,0,1,0,0,1
GCATTCGAAATGAACA-1_V12N28-333_A1,0,0,1,0,0,1
AAAGACTGGGCGCTTT-1_V12N28-333_A1,0,0,0,0,0,0
TAACAATATTTGTTGC-1_V12N28-333_A1,0,0,0,0,0,0
CCAGCTTCCGCCCGCA-1_V12N28-333_A1,0,0,1,0,0,1
GATATGGATTACGCGG-1_V12N28-333_A1,0,0,0,0,0,0
AGAGCAGTTATGAGAC-1_V12N28-333_A1,0,0,2,0,0,2
TCACATCTTATCTGAT-1_V12N28-333_A1,0,0,1,0,0,1
TATGAAGACAGGTGCG-1_V12N28-333_A1,0,0,1,0,0,1
TACCTGCTGCACTGTG-1_V12N28-333_A1,0,1,2,0,0,3
TAGGTCCAAGTAAGGA-1_V12N28-333_A1,0,1,1,0,0,2
GAAACTCGTGCGATGC-1_V12N28-333_A1,0,0,3,0,2,5
AACAATTACTCTACGC-1_V12N28-333_A1,0,0,4,0,0,4
CCGCACGTGACCTCGG-1_V12N28-333_A1,0,1,2,0,0,3
AACTTGCCCGTATGCA-1_V12N28-333_A1,0,0,2,0,0,2
GGGTATGTATGCACTT-1_V12N28-333_A1,0,0,1,0,1,2
TTCGTACTCCAGAACG-1_V12N28-333_A1,0,0,1,0,1,2
GAATTTCTCGCTGCAG-1_V12N28-333_A1,0,0,1,0,0,1
AACAGGATGGGCCGCG-1_V12N28-333_A1,0,1,2,0,0,3
GACGTGTAGGGATTAT-1_V12N28-333_A1,0,0,0,0,2,2
TAGGTGAGCCCTACTC-1_V12N28-333_A1,0,1,0,0,0,1
CTAATTCGCACGCGCT-1_V12N28-333_A1,0,0,2,0,0,2
GAAGCTTGCTGACCGC-1_V12N28-333_A1,0,0,2,0,1,3
GGTTAGGCTTGGAGAA-1_V12N28-333_A1,0,1,1,0,0,2
ACAAGGACAAGAGGTT-1_V12N28-333_A1,0,0,1,0,0,1
AGGCCACCCGTTATGA-1_V12N28-333_A1,0,1,2,0,1,4
GTGGGCTTAGACACAC-1_V12N28-333_A1,0,1,1,0,0,2
CGTGTCCCATTCGCGA-1_V12N28-333_A1,0,1,0,0,0,1
TGGAGTGATGCGATGA-1_V12N28-333_A1,0,0,4,0,1,5
AACAACTGGTAGTTGC-1_V12N28-333_A1,0,1,2,0,0,3
CCTGGCTAGACCCGCC-1_V12N28-333_A1,0,3,3,0,0,6
CGCAATTAGGGTAATA-1_V12N28-333_A1,0,1,1,0,0,2
TCGAAATTTAGGACCA-1_V12N28-333_A1,0,0,0,0,0,0
AGACTAGCCTTCCAGA-1_V12N28-333_A1,0,0,2,0,1,3
TTGATCTAACTTTGTC-1_V12N28-333_A1,0,1,1,0,1,3
AAGGAGCGGTTGGTGC-1_V12N28-333_A1,0,0,2,0,0,2
ACTTGGGACCCGGTGG-1_V12N28-333_A1,0,0,0,0,1,1
TGATCTCCGGCGCCAG-1_V12N28-333_A1,0,0,1,0,1,2
CAGTTCAAATTGACAC-1_V12N28-333_A1,0,1,2,0,1,4
GTCCGGCTGAATTGCG-1_V12N28-333_A1,1,0,0,0,1,2
CTGGAAATGGATGCTT-1_V12N28-333_A1,1,2,1,0,0,4
TGATCGGTTTGACCCT-1_V12N28-333_A1,1,0,4,0,0,5
TAGAGTCTAAGCGAAC-1_V12N28-333_A1,0,1,2,0,0,3
GAGACTGATGGGTAGA-1_V12N28-333_A1,0,0,1,0,0,1
TAGCTAAGTCCGGGAG-1_V12N28-333_A1,1,0,0,0,0,1
GGGCGATATGTGTGAA-1_V12N28-333_A1,0,2,1,0,0,3
CTCGAGGTCGAACAGT-1_V12N28-333_A1,0,1,2,0,0,3
GATCCCTTTATACTGC-1_V12N28-333_A1,0,1,0,0,0,1
GTCATGCACCTCCGTT-1_V12N28-333_A1,0,0,4,0,0,4
ACTTTCCTATAGCTTC-1_V12N28-333_A1,0,1,1,0,0,2
TCGCTCGATATATTCC-1_V12N28-333_A1,0,4,2,0,0,6
ATAGGTTGGGCAGATG-1_V12N28-333_A1,0,2,1,0,0,3
CAATTAAGGGTGATGA-1_V12N28-333_A1,0,0,4,0,0,4
ACCGACTGAGTCCCAC-1_V12N28-333_A1,2,1,2,0,0,5
CCTGTCACCCGGGCTC-1_V12N28-333_A1,0,0,2,0,0,2
GATCGGTGGCCATAAC-1_V12N28-333_A1,0,1,2,0,0,3
CCTATGGGTTACCGTC-1_V12N28-333_A1,1,0,1,0,0,2
TTGGGACACTGCCCGC-1_V12N28-333_A1,0,2,0,0,0,2
CGAGGCTAAATATGGC-1_V12N28-333_A1,0,1,2,0,0,3
TCAGGGTGTAACGTAA-1_V12N28-333_A1,0,3,2,1,0,6
CGAGAGATGTGAACCT-1_V12N28-333_A1,0,2,2,0,0,4
TCGCTGGGCGGATTGT-1_V12N28-333_A1,0,0,1,0,1,2
AGATCTCAGGTGTGAT-1_V12N28-333_A1,1,1,1,0,0,3
TGGCCAAACTGAAGTA-1_V12N28-333_A1,0,4,5,1,1,11
GCTTCCGTCCCTAGAC-1_V12N28-333_A1,0,3,1,1,0,5
CAGCAGCCCGTTCCTT-1_V12N28-333_A1,0,1,0,0,0,1
TGTATAACAGATCCTG-1_V12N28-333_A1,0,2,1,0,0,3
CGCGGGAATTAGGCAG-1_V12N28-333_A1,0,1,0,0,0,1
TGCATGTGGTAATCTA-1_V12N28-333_A1,0,3,2,0,0,5
ACAATTTGAGCAGTGG-1_V12N28-333_A1,0,1,2,1,0,4
GAGCTAAGGGCATATC-1_V12N28-333_A1,0,4,1,0,0,5
CCAGATAGTTGAGTGA-1_V12N28-333_A1,0,0,4,0,0,4
CCACAATGTACGTCTT-1_V12N28-333_A1,0,1,4,0,0,5
CAATGGATCTCTACCA-1_V12N28-333_A1,0,3,1,1,0,5
TGTGGCAAAGCGTATG-1_V12N28-333_A1,0,0,3,0,0,3
TAAAGCGTTAGGAGAA-1_V12N28-333_A1,0,0,5,0,0,5
TCCGTTTAGCCTTGAA-1_V12N28-333_A1,0,1,2,0,1,4
CAGCTCGACAAGTTAA-1_V12N28-333_A1,0,0,1,0,1,2
GCCTATAGTGTCAGGG-1_V12N28-333_A1,0,4,3,1,0,8
ATAGACAACGGGACCT-1_V12N28-333_A1,0,2,2,0,0,4
CTACTATCTTTCAGAG-1_V12N28-333_A1,0,1,1,0,0,2
GCGCTGCTTTGCATTT-1_V12N28-333_A1,0,0,1,0,0,1
GCGCATCCAGTCAGCA-1_V12N28-333_A1,0,1,4,1,0,6
GACTCGCGGGAATGAC-1_V12N28-333_A1,0,3,1,1,0,5
CTGGTAACGAGCTCTT-1_V12N28-333_A1,0,3,2,0,0,5
TCCGGCCTAGCGTACA-1_V12N28-333_A1,0,1,1,0,0,2
TCTAGGTGGCGACGCT-1_V12N28-333_A1,0,1,1,0,0,2
ACGCTAGTGATACACT-1_V12N28-333_A1,0,0,3,1,0,4
ATCTGCACCTCTGCGA-1_V12N28-333_A1,0,3,2,1,0,6
CCTCACCTGAGGGAGC-1_V12N28-333_A1,0,6,2,1,0,9
AGTGAGCCTCGCCGCC-1_V12N28-333_A1,0,1,2,0,0,3
ACGAGTACGGATGCCC-1_V12N28-333_A1,0,2,0,0,0,2
GGTACCATTAAGACGG-1_V12N28-333_A1,0,1,4,0,0,5
TTCTGCTAGACTCCAA-1_V12N28-333_A1,0,2,2,0,0,4
TAACTATTACGCCAAA-1_V12N28-333_A1,0,0,3,0,0,3
GCATTCAAGGCAACGC-1_V12N28-333_A1,0,2,1,0,1,4
AGTACATCATTTATCA-1_V12N28-333_A1,0,0,3,0,0,3
GTCGTGTCTGGTCATC-1_V12N28-333_A1,0,0,4,0,0,4
AGTCTAAAGTATACTC-1_V12N28-333_A1,0,2,2,0,1,5
CGGCCCAACCTGTAGT-1_V12N28-333_A1,0,2,0,0,0,2
AGGGAGACATACTTCG-1_V12N28-333_A1,0,1,2,0,0,3
TCCCTAGATCAATAGG-1_V12N28-333_A1,0,1,5,0,0,6
TCCCGTCGCGTCATAG-1_V12N28-333_A1,0,1,3,0,0,4
CGCATCCATCAGCCAG-1_V12N28-333_A1,0,0,0,0,0,0
CTGCACCTAGTCCACA-1_V12N28-333_A1,0,1,2,0,0,3
CGAGGATCGGGAACGA-1_V12N28-333_A1,0,2,1,0,1,4
CAATGAGGTTCGACTA-1_V12N28-333_A1,0,2,2,0,1,5
TCTGACGGGCTAACCC-1_V12N28-333_A1,0,0,1,0,1,2
TTCTATGCCTTTCGCA-1_V12N28-333_A1,0,0,1,0,2,3
AGAGTATAGTGTTACG-1_V12N28-333_A1,0,0,3,0,0,3
CCATTGTTTCCTCCAT-1_V12N28-333_A1,0,0,2,0,0,2
CTCATCACTTAGTGAT-1_V12N28-333_A1,0,0,3,0,2,5
CCGAAGGGCGTACCGC-1_V12N28-333_A1,0,0,2,0,1,3
TCAAGCTGCCTTGAAA-1_V12N28-333_A1,0,0,0,0,0,0
CTCATTAACGTTGCCC-1_V12N28-333_A1,0,2,1,0,0,3
GTCTTCCTCACCTAAG-1_V12N28-333_A1,3,2,0,0,0,5
GGTGATGAAGGAAGTG-1_V12N28-333_A1,6,1,1,0,0,8
TCAATACAATTGCTGC-1_V12N28-333_A1,3,0,0,0,0,3
GCAACCCAAGTTGTTT-1_V12N28-333_A1,2,0,1,0,1,4
ATGAAGTGGACCCAGC-1_V12N28-333_A1,4,0,0,0,0,4
GAGAATCTCACGATCA-1_V12N28-333_A1,0,0,0,0,1,1
TATATCATTGATCAGT-1_V12N28-333_A1,1,0,0,0,1,2
AACTTTACGGGAGCTT-1_V12N28-333_A1,0,0,0,0,0,0
TTCTTGTGTCCATCAG-1_V12N28-333_A1,0,0,2,0,0,2
ACAATTTAGGAGGCTC-1_V12N28-333_A1,0,0,2,0,0,2
ATACTTGTTCTCGAGC-1_V12N28-333_A1,0,0,7,0,0,7
CACGGGATTGAGGGTT-1_V12N28-333_A1,0,0,4,0,1,5
GTTAATGTCTATCTTA-1_V12N28-333_A1,0,0,1,0,0,1
GCGTTATATTTGGAAC-1_V12N28-333_A1,0,1,0,0,0,1
CGTCAAGGCTATAAAT-1_V12N28-333_A1,0,0,0,0,0,0
TTAGCTCTGTAATCCG-1_V12N28-333_A1,0,0,2,0,0,2
AATGGTCCACCGTTCA-1_V12N28-333_A1,0,1,4,0,1,6
GTCATTGCATTGACCC-1_V12N28-333_A1,0,0,1,0,0,1
TGTCCGTGGCGCCTTT-1_V12N28-333_A1,0,0,0,0,1,1
TCAACTAACGTATAAC-1_V12N28-333_A1,0,0,0,0,0,0
TCCTCTCCAGTTGTCC-1_V12N28-333_A1,0,0,0,0,0,0
TGTGTTCGTATCCAAG-1_V12N28-333_A1,1,2,1,0,0,4
CCGCGTAGGTAAGGGC-1_V12N28-333_A1,0,0,1,0,0,1
CTGCGGGTGAAATGTT-1_V12N28-333_A1,0,1,2,0,0,3
TATCTACAGAGGTAAT-1_V12N28-333_A1,0,0,2,0,0,2
CTACTCTAGGCCCGGC-1_V12N28-333_A1,0,1,3,0,2,6
ACAAGCAGTGCCTAGC-1_V12N28-333_A1,0,0,2,0,0,2
TACAAGTCTCGTGCAT-1_V12N28-333_A1,0,1,2,0,0,3
TCGGAATGCGCTCTGA-1_V12N28-333_A1,0,1,4,0,0,5
TCGCGTCCAGAAGGTC-1_V12N28-333_A1,0,1,2,0,1,4
TATGGCCCGGCCTCGC-1_V12N28-333_A1,0,0,0,0,1,1
GCTGGCATATTCACCT-1_V12N28-333_A1,0,0,1,0,1,2
GTCAGAATAGTCTATG-1_V12N28-333_A1,0,1,2,0,0,3
GGCGTCCTATCCGCTG-1_V12N28-333_A1,0,0,2,0,1,3
CGGAGTTTGAGAGACA-1_V12N28-333_A1,0,0,0,0,0,0
AGCACTTAAGGACGCC-1_V12N28-333_A1,0,1,5,0,0,6
TCCACAATGGTTTACG-1_V12N28-333_A1,0,0,2,0,0,2
CCAACGATGCACTGAT-1_V12N28-333_A1,0,1,2,0,0,3
ATTTACAGTTTACTGG-1_V12N28-333_A1,0,1,3,0,0,4
CCCTGAAATGAGTTGA-1_V12N28-333_A1,0,0,2,0,0,2
CAAACGGTCGCACTTT-1_V12N28-333_A1,0,0,1,1,0,2
TGATTCGTCTATCACT-1_V12N28-333_A1,0,1,5,0,1,7
TCAGGTTCTTTGAGAA-1_V12N28-333_A1,0,1,0,0,1,2
CACGCAGCGAGGCTTT-1_V12N28-333_A1,0,0,3,0,0,3
TTAAGCGCCTGACCCA-1_V12N28-333_A1,0,0,1,0,0,1
CTTACACGGTATTCCA-1_V12N28-333_A1,0,0,1,0,1,2
AAGGCTGTGCTCATCG-1_V12N28-333_A1,0,2,3,0,0,5
GACCAGAGCCCTGTAG-1_V12N28-333_A1,0,0,1,0,0,1
TCCCAGGCTTAGCTAA-1_V12N28-333_A1,0,3,2,0,0,5
ATTGAAGATCTTAGTG-1_V12N28-333_A1,0,1,2,0,0,3
AGTTCCTACAGAATTA-1_V12N28-333_A1,0,0,4,0,0,4
GGGCTGGTTAGTCGCG-1_V12N28-333_A1,0,0,0,0,0,0
GAAATGGCGGTGTTAG-1_V12N28-333_A1,0,0,4,0,0,4
TACGAACACGACTTCA-1_V12N28-333_A1,1,1,2,0,1,5
ACCACAAGTTTCTATC-1_V12N28-333_A1,0,0,2,0,0,2
ATATTTAACCCTCAAG-1_V12N28-333_A1,0,1,1,0,0,2
GATCATTCCAAACATT-1_V12N28-333_A1,1,0,1,0,0,2
TCCAGGCGAGTACGGT-1_V12N28-333_A1,1,3,1,0,1,6
GTTTGACCAAATCCTA-1_V12N28-333_A1,1,3,0,0,0,4
CACAGCACCCACGGCA-1_V12N28-333_A1,1,0,1,0,1,3
TGCAAGAATGACGTAA-1_V12N28-333_A1,0,1,1,0,0,2
GCGAAGCCATACCCGT-1_V12N28-333_A1,0,0,3,0,0,3
TCCTTTCTTACGCTTA-1_V12N28-333_A1,0,5,0,0,2,7
GCTGCTCTCCGGACAC-1_V12N28-333_A1,0,1,2,0,0,3
ACTGTCTTCTTTAGAA-1_V12N28-333_A1,0,1,2,0,0,3
TCAAACTTAGATTGTT-1_V12N28-333_A1,3,0,0,0,0,3
CTATGTCACTAGCCCA-1_V12N28-333_A1,1,1,2,0,0,4
TGCGCAAAGCATTTGG-1_V12N28-333_A1,1,1,2,0,0,4
TTAATGTAGACCAGGT-1_V12N28-333_A1,0,0,2,0,0,2
GGCGGTAGGATCATTG-1_V12N28-333_A1,0,2,4,0,0,6
GGCAATAGTCAATGAG-1_V12N28-333_A1,0,0,0,0,0,0
ACACGAGACTCCTTCT-1_V12N28-333_A1,0,2,3,0,0,5
GACACAAGGGAAGAAA-1_V12N28-333_A1,1,3,4,0,0,8
TCAGCAAATGCATCTC-1_V12N28-333_A1,0,1,0,0,1,2
GAGATCTGTCACTCCG-1_V12N28-333_A1,0,2,4,0,0,6
ATGCCGGTCTTGCATA-1_V12N28-333_A1,0,1,1,0,0,2
TTGGGCGGCGGTTGCC-1_V12N28-333_A1,0,2,1,0,0,3
TTGTTGTGTGTCAAGA-1_V12N28-333_A1,0,1,3,1,0,5
ACTGTACGATACACAT-1_V12N28-333_A1,0,1,2,1,1,5
TCCACTTTATCTAGGT-1_V12N28-333_A1,0,5,1,0,0,6
GGTCTGAGAATCTGGA-1_V12N28-333_A1,0,0,1,0,0,1
TAGAAAGGTGGCGCTA-1_V12N28-333_A1,0,0,0,0,0,0
TATGTCTCATTGTGCC-1_V12N28-333_A1,0,0,3,0,0,3
GGATTTCACTTCTATA-1_V12N28-333_A1,0,0,5,0,0,5
TGAGTGGTCCGTGACG-1_V12N28-333_A1,0,1,2,0,0,3
CGCTTTCTTGCATTCG-1_V12N28-333_A1,0,0,5,1,0,6
ACCCAACGCCCGTGGC-1_V12N28-333_A1,0,3,2,0,0,5
GAACGTCTCATGGTCG-1_V12N28-333_A1,0,1,0,0,0,1
AGGGTTCCCTTTGGTT-1_V12N28-333_A1,0,2,4,0,0,6
GTAGCTTCCTCTTGTT-1_V12N28-333_A1,0,1,1,0,1,3
GCATGAGGGACGCGGC-1_V12N28-333_A1,0,2,3,0,0,5
CTACCCTAAGGTCATA-1_V12N28-333_A1,0,1,3,0,0,4
TCACCGCTCGGCACTC-1_V12N28-333_A1,0,2,3,0,0,5
GGCTCGCGTTGAGGTA-1_V12N28-333_A1,0,2,4,0,0,6
CTAACGAAACTTGCTG-1_V12N28-333_A1,0,2,2,0,0,4
TTAAACTCGAATTCAT-1_V12N28-333_A1,0,2,4,0,0,6
TACTTTACTGAGCCGG-1_V12N28-333_A1,0,0,1,0,0,1
GCTTGGATCGATTAGG-1_V12N28-333_A1,0,3,2,0,0,5
CGGTTATCCAACAGTG-1_V12N28-333_A1,0,4,0,0,0,4
CAGACCTGTAAGTGTT-1_V12N28-333_A1,0,2,3,0,0,5
GACGGTCAATAGAAGC-1_V12N28-333_A1,0,2,1,0,1,4
CTGACTGCGCAGCTCG-1_V12N28-333_A1,0,3,3,0,0,6
CCATACCTTTACTTGT-1_V12N28-333_A1,0,0,0,1,0,1
GTAATAAAGGGCTCCC-1_V12N28-333_A1,0,2,2,0,0,4
GTGAACTCCCATTCGA-1_V12N28-333_A1,0,3,1,0,0,4
GTGGTTACTTCTTTCG-1_V12N28-333_A1,0,1,1,1,0,3
TCAGAACCTCCACAGG-1_V12N28-333_A1,0,1,3,0,0,4
TCCCACTCTCTTCCGG-1_V12N28-333_A1,0,0,3,0,0,3
ATCTTGACTTGTCCAA-1_V12N28-333_A1,0,4,1,0,0,5
TCGGGAACGTGCCTAG-1_V12N28-333_A1,0,1,0,0,1,2
GTTAGCCGTAAATCAA-1_V12N28-333_A1,0,2,1,0,0,3
ATTTACTAAGTCCATT-1_V12N28-333_A1,0,0,1,0,1,2
GGGTGCATATGAAAGC-1_V12N28-333_A1,0,1,2,0,0,3
TCCGAATGGTCCTGAG-1_V12N28-333_A1,0,1,1,0,0,2
TGATGGCTGTTTCTGA-1_V12N28-333_A1,0,1,0,0,0,1
AAATAAGGTAGTGCCC-1_V12N28-333_A1,0,1,1,1,0,3
CCACTATCCGGGTCAC-1_V12N28-333_A1,0,1,1,0,1,3
ACACCACATAATTAGC-1_V12N28-333_A1,0,0,0,1,0,1
CGCGGTAAGTCTAGCT-1_V12N28-333_A1,0,0,1,0,0,1
GCGGGCATTACGATGC-1_V12N28-333_A1,0,0,1,0,0,1
AGGATTGCTTACGACA-1_V12N28-333_A1,0,1,2,0,0,3
CTCGGGATAACACCTA-1_V12N28-333_A1,0,0,0,0,0,0
GTCGTCTGGTTGGCTA-1_V12N28-333_A1,0,1,3,0,1,5
GCAATTAGTCGCACCG-1_V12N28-333_A1,0,0,0,1,0,1
GTGACCTAAAGAATAA-1_V12N28-333_A1,0,0,1,0,0,1
CTGAGCGAGACTTATT-1_V12N28-333_A1,0,0,0,0,0,0
CAAGACTCAGAAGCGC-1_V12N28-333_A1,0,1,2,0,1,4
ACTTCGCTAGCGAGTG-1_V12N28-333_A1,0,0,1,0,0,1
CCATACTCGCCTCTCC-1_V12N28-333_A1,11,0,3,0,0,14
ACGATACCTATCCTGA-1_V12N28-333_A1,5,0,4,0,0,9
CTCACCAGTACAAGTG-1_V12N28-333_A1,1,1,0,0,0,2
CGAAGACGGTGAGTGC-1_V12N28-333_A1,1,0,1,0,0,2
AAATTAATAAGCGCGA-1_V12N28-333_A1,2,1,1,0,1,5
GGGCCCTTATCTATAC-1_V12N28-333_A1,3,0,0,0,1,4
CTGCCCACGAAGCGTT-1_V12N28-333_A1,0,0,0,0,1,1
GGACAAGTTGCAGTGA-1_V12N28-333_A1,1,0,2,0,0,3
GTCCGAGAGCAATCAT-1_V12N28-333_A1,1,0,1,0,0,2
ATGGCAGCCGAGAAAC-1_V12N28-333_A1,0,0,2,0,1,3
CCTCGGATGCTACCTG-1_V12N28-333_A1,0,0,3,0,0,3
ATACGGTGAAGATGCA-1_V12N28-333_A1,0,0,1,0,0,1
ACATCAGCTGGGACGC-1_V12N28-333_A1,0,0,3,0,0,3
GGTTGTGTAGCCTGGC-1_V12N28-333_A1,0,0,5,0,1,6
CCTGCGTTCTACGCTT-1_V12N28-333_A1,0,0,0,0,0,0
GAACGTTAGGAAGACG-1_V12N28-333_A1,0,0,3,0,0,3
CTGATAGTGTATCTCA-1_V12N28-333_A1,0,0,1,0,0,1
TTCTGCGAGCGCCCTT-1_V12N28-333_A1,0,0,2,0,0,2
CTTTGGCGCTTTATAC-1_V12N28-333_A1,0,0,1,0,0,1
TCCGAACTTGGCTTAC-1_V12N28-333_A1,0,0,0,0,0,0
TAGATTCCTGGTTATT-1_V12N28-333_A1,0,1,2,0,0,3
CCGACAAAGGGAGTGC-1_V12N28-333_A1,0,0,1,0,2,3
CCATGGCCCTTGTACC-1_V12N28-333_A1,0,0,2,0,0,2
GAAATATCACCATCAG-1_V12N28-333_A1,0,0,3,0,0,3
ACGAAATGGGCGGCAC-1_V12N28-333_A1,0,0,3,0,0,3
GTGAGCGTGCTGCACT-1_V12N28-333_A1,0,0,2,0,0,2
CCGCGGGTACGAAGAA-1_V12N28-333_A1,0,0,3,0,0,3
TCCCTGGCTCGCTGGA-1_V12N28-333_A1,0,1,3,0,0,4
CAGCTTAGTAGGTAGC-1_V12N28-333_A1,0,1,4,0,1,6
CACGAAAGTTAGTCCC-1_V12N28-333_A1,0,0,0,0,1,1
ACCTAATCGACTTCCT-1_V12N28-333_A1,0,0,1,0,0,1
AAGTAGTGACGCGAGG-1_V12N28-333_A1,0,0,1,0,2,3
TCCGATTACATTGCCG-1_V12N28-333_A1,0,1,0,0,1,2
CCTCCGACAATTCAAG-1_V12N28-333_A1,0,0,3,0,2,5
GTTCACAGGAGTCTAG-1_V12N28-333_A1,0,0,1,0,0,1
CGAAGTTGCTCTGTGT-1_V12N28-333_A1,0,0,0,0,1,1
GTCGGATATCTCAGAC-1_V12N28-333_A1,0,0,0,2,1,3
CGCTCTCCGTAGATTA-1_V12N28-333_A1,0,1,3,0,1,5
CAAGCAACGTCGGAGT-1_V12N28-333_A1,0,2,2,0,0,4
CCATTCCCTGCCCACA-1_V12N28-333_A1,0,0,7,0,0,7
CTTTGGCTTTAGTAAA-1_V12N28-333_A1,0,0,4,0,0,4
GGCTATTAAGTTGTAT-1_V12N28-333_A1,0,1,3,0,1,5
CCATTAGCGATAATCC-1_V12N28-333_A1,0,1,0,0,1,2
TGTTCTTCCATTGACT-1_V12N28-333_A1,0,0,0,0,0,0
AGATAACTTCAGGGCC-1_V12N28-333_A1,0,2,1,0,0,3
ATAGACGAAGAGAAAG-1_V12N28-333_A1,0,1,0,0,1,2
GGCGGAGTAATATTAG-1_V12N28-333_A1,0,3,3,0,0,6
TGACCCACGTTAGACA-1_V12N28-333_A1,0,0,0,0,0,0
TCACAGGTTATTGGGC-1_V12N28-333_A1,0,2,1,0,0,3
TCACGCATTGTAGATC-1_V12N28-333_A1,0,1,2,0,0,3
TTGAAGAATTCCCAGG-1_V12N28-333_A1,0,0,4,0,0,4
AAATGGTCAATGTGCC-1_V12N28-333_A1,0,0,4,0,2,6
TAGTGCCCTCCAGAGT-1_V12N28-333_A1,0,0,1,0,0,1
GGTATTGCCGAGTTTA-1_V12N28-333_A1,0,0,1,0,0,1
CGTATTAAGAGATCTA-1_V12N28-333_A1,0,0,0,0,1,1
ACTGTCCAGGATTATA-1_V12N28-333_A1,0,0,1,0,0,1
CGGGCAGCTAAACCGC-1_V12N28-333_A1,0,1,1,0,0,2
TTGCTGATCATGTTCG-1_V12N28-333_A1,1,1,0,0,0,2
TATGGGTACGTATCGT-1_V12N28-333_A1,0,2,1,0,0,3
CAGCTCACTGAGACAT-1_V12N28-333_A1,4,0,1,0,0,5
GGGACTGCATAGATAG-1_V12N28-333_A1,1,2,1,0,1,5
ACGCATTCGTGAGTAC-1_V12N28-333_A1,1,1,0,0,0,2
CTCTGGACGCCTGGTG-1_V12N28-333_A1,2,0,1,0,0,3
AGGGTTTAGTTCGGGA-1_V12N28-333_A1,0,0,1,0,0,1
GGGAGAACTCACAGTA-1_V12N28-333_A1,0,0,0,0,0,0
ATCAATCTGGGCTGCA-1_V12N28-333_A1,0,2,1,0,0,3
TCTTCGATACCAATAA-1_V12N28-333_A1,2,0,0,0,0,2
ACGTAGATTGCTGATG-1_V12N28-333_A1,0,0,0,0,0,0
TCTTGATGCGTAGCGA-1_V12N28-333_A1,1,3,3,0,0,7
GGGCTGCCTAGGGCGA-1_V12N28-333_A1,1,3,1,0,0,5
CTCTCACAATCGATGA-1_V12N28-333_A1,0,1,1,0,0,2
CCAAGCGTAACTCGTA-1_V12N28-333_A1,1,3,0,0,0,4
ACAACAGCATGAGCTA-1_V12N28-333_A1,0,0,2,0,0,2
GTCCCAACGTAAAGTA-1_V12N28-333_A1,0,0,0,0,0,0
TCGGAGTACATGAGTA-1_V12N28-333_A1,1,2,1,0,0,4
GGGAGTTAATGAGGCG-1_V12N28-333_A1,1,0,1,0,0,2
CCGGGCGGTCTCGTCA-1_V12N28-333_A1,0,2,2,0,0,4
CCGTAAGTTGGTCCCA-1_V12N28-333_A1,1,2,1,0,0,4
GGAGGGCTTGGTTGGC-1_V12N28-333_A1,1,4,2,0,0,7
TCGGACGCCCAGCCCA-1_V12N28-333_A1,0,0,6,0,0,6
TCTGTGCCATCATAGT-1_V12N28-333_A1,0,2,1,1,1,5
GTACTGGAGTTAGACC-1_V12N28-333_A1,0,1,2,0,0,3
GGAATGCGCTAGCGTG-1_V12N28-333_A1,0,1,0,0,0,1
GTGTGAATAACTTAGG-1_V12N28-333_A1,0,1,2,0,0,3
GGTCGGCCAGGAGCTT-1_V12N28-333_A1,0,1,3,0,0,4
TAGCCGGCGGTCAGCG-1_V12N28-333_A1,0,2,1,0,1,4
CGGGTGTACCCATTTA-1_V12N28-333_A1,0,3,1,1,0,5
AGTGATTCAAGCAGGA-1_V12N28-333_A1,0,3,3,0,0,6
GTTGGATTGAGAACAC-1_V12N28-333_A1,0,0,1,0,0,1
CACACGCGCTGTCTTA-1_V12N28-333_A1,0,1,6,0,0,7
TAGACGCCCGTACCGG-1_V12N28-333_A1,0,1,3,0,0,4
GGTTTCAATCGGTCAG-1_V12N28-333_A1,0,1,1,0,1,3
AATCTGCGTTGGGACG-1_V12N28-333_A1,0,1,1,0,0,2
TTACGGATGGTTCGAG-1_V12N28-333_A1,0,2,1,0,0,3
CGGCAGGGTCGGGTTG-1_V12N28-333_A1,0,3,1,0,0,4
GCTTTCAGAGGAGGTG-1_V12N28-333_A1,0,5,2,0,0,7
TCTTCCCATGGGCACA-1_V12N28-333_A1,0,1,3,0,0,4
TACCGCGGACTTGCAG-1_V12N28-333_A1,0,0,3,0,0,3
AGAATTATGGATTCGA-1_V12N28-333_A1,0,0,2,0,0,2
ATTGATGAGTCCTAAC-1_V12N28-333_A1,0,2,1,0,0,3
TAGGTCGCCGGAACTG-1_V12N28-333_A1,0,1,2,0,0,3
TAACCTACCGTCCGAG-1_V12N28-333_A1,0,0,1,1,0,2
CTTAGTAGGCCTACAG-1_V12N28-333_A1,0,3,1,0,0,4
CTAGATGTGAGTGTAA-1_V12N28-333_A1,0,0,2,0,0,2
ACTCCCGAATTCGTTT-1_V12N28-333_A1,0,1,2,0,0,3
GTTCATCGTTTGGCTG-1_V12N28-333_A1,0,1,2,0,0,3
ACTTTACCCTCATGAA-1_V12N28-333_A1,0,3,2,0,0,5
GCGAGAGTTGCGTCCA-1_V12N28-333_A1,0,3,1,0,2,6
GTTCGGGCGTACCATT-1_V12N28-333_A1,0,2,0,0,0,2
CGACTTTGTATAGCCT-1_V12N28-333_A1,0,2,1,0,0,3
GCCATCGATGCTGCAT-1_V12N28-333_A1,0,2,2,0,0,4
GCATTTCCAAGGCTCC-1_V12N28-333_A1,0,1,1,0,0,2
ATGTAAGGCTGCTCTT-1_V12N28-333_A1,0,2,4,0,0,6
ACGTTCGCAATCAATT-1_V12N28-333_A1,0,1,3,0,0,4
GTGACGAGGGTGACCC-1_V12N28-333_A1,0,1,2,1,0,4
ATTATAGCTACTTTAC-1_V12N28-333_A1,0,0,2,0,0,2
CGTGTGTTAAACCCTG-1_V12N28-333_A1,0,1,3,0,0,4
TTGGTATGGCTTGTGT-1_V12N28-333_A1,0,1,1,0,0,2
CATTCCCATTCCGTCG-1_V12N28-333_A1,0,0,1,0,0,1
TGCCGAAAGCGTATTC-1_V12N28-333_A1,0,0,1,0,0,1
CAACACATCTCCTGCC-1_V12N28-333_A1,0,0,2,0,0,2
CTGCCTCATATGCAAC-1_V12N28-333_A1,0,0,0,0,0,0
TCCCGCCTATGTGCGT-1_V12N28-333_A1,0,0,0,0,0,0
GGTTACCCGACACTTT-1_V12N28-333_A1,0,0,3,0,0,3
CCAGCGGGATCACCAG-1_V12N28-333_A1,0,0,2,0,0,2
ATGTTTCGGCCCGGAG-1_V12N28-333_A1,0,0,1,0,1,2
GCGTCTAACCTCCTAA-1_V12N28-333_A1,0,1,0,0,0,1
ATCAGGTAGCTGACAG-1_V12N28-333_A1,0,1,2,0,0,3
GGTATGAAAGAACTGA-1_V12N28-333_A1,3,3,0,0,0,6
GTGGCCTAATATCATT-1_V12N28-333_A1,11,2,4,0,0,17
CCTGTGAAACCGTAAC-1_V12N28-333_A1,3,0,0,0,0,3
GGCAGAGAGATCGGGA-1_V12N28-333_A1,5,0,1,0,0,6
TAGCGTCGAATATTGA-1_V12N28-333_A1,1,0,0,0,2,3
CGCCGACTATTCGCTA-1_V12N28-333_A1,0,0,1,0,0,1
TCTGGCGCAAGCCGGG-1_V12N28-333_A1,1,0,1,0,0,2
AGTGGTTGCGTATAGG-1_V12N28-333_A1,0,0,5,0,1,6
ATCGGTTACCTAGTAA-1_V12N28-333_A1,0,0,4,0,0,4
CCTGCCCGTTGTCTAG-1_V12N28-333_A1,0,0,5,0,0,5
GCACACGCCCATGGTC-1_V12N28-333_A1,0,0,4,0,0,4
AGTACGGCCCGTATCG-1_V12N28-333_A1,0,0,2,0,0,2
TATCTAGCCTAAAGGA-1_V12N28-333_A1,0,0,2,0,1,3
CACTCGGTTAGGAGGA-1_V12N28-333_A1,0,0,1,0,0,1
ATGTTCGTCGACCCAC-1_V12N28-333_A1,0,0,1,0,0,1
TTCCTCTGCCCGAATA-1_V12N28-333_A1,0,2,2,0,3,7
TTACTATCGGCTTCTC-1_V12N28-333_A1,0,1,1,0,0,2
GCCGCATTAGTCCGGC-1_V12N28-333_A1,0,1,3,0,1,5
TAAGGGCTGGGAGAGG-1_V12N28-333_A1,0,1,4,0,0,5
TAAGCAGGCGACACGC-1_V12N28-333_A1,0,0,1,0,0,1
AGCACTACCGGCCTGT-1_V12N28-333_A1,0,0,4,0,0,4
GAAAGCCCTTTGGACC-1_V12N28-333_A1,0,0,2,0,0,2
GACCGACTGAAGCGTC-1_V12N28-333_A1,0,0,2,0,0,2
CGGTGAAGACTAAAGT-1_V12N28-333_A1,0,2,0,0,0,2
CCCTGCGCTACGCATA-1_V12N28-333_A1,0,0,2,0,1,3
TACTGGACAGCTCGGC-1_V12N28-333_A1,0,0,3,0,1,4
TTAGTAGGGCGGCGGG-1_V12N28-333_A1,0,2,4,0,1,7
GAGGCTATCAAAGTCG-1_V12N28-333_A1,0,0,0,0,0,0
TTACCATTGATTACCC-1_V12N28-333_A1,0,0,1,0,0,1
ATACCACGGGCAACTT-1_V12N28-333_A1,0,2,2,0,0,4
TGTCCTAAGTCACCGC-1_V12N28-333_A1,0,0,4,0,0,4
AGGTAGGTACAAAGCT-1_V12N28-333_A1,0,0,0,0,1,1
GGCATACAGGTAGCGG-1_V12N28-333_A1,0,0,0,0,0,0
TGTAGTGATCTATAAT-1_V12N28-333_A1,0,0,1,0,0,1
TCCCGGGTGTGCTGCT-1_V12N28-333_A1,0,1,0,0,1,2
TACGATGTTGATCATC-1_V12N28-333_A1,0,0,3,0,1,4
CCTCTCTCCCATCTAG-1_V12N28-333_A1,0,0,3,0,0,3
GCAGGACTATAGAATA-1_V12N28-333_A1,0,0,4,0,0,4
CTAGTGAAGGACAGGA-1_V12N28-333_A1,0,0,2,0,0,2
TACGAGAACTTCACGT-1_V12N28-333_A1,0,1,4,0,0,5
CGTTGTTTCAATTCCC-1_V12N28-333_A1,0,0,1,0,2,3
GCAAATATTACGCTTT-1_V12N28-333_A1,0,0,2,0,0,2
CCAATAGTGCCGTCGA-1_V12N28-333_A1,0,0,3,0,0,3
ATTGCTGCTCCTCCAT-1_V12N28-333_A1,0,2,1,0,0,3
GAGATCTGCTTGGCAT-1_V12N28-333_A1,0,0,0,0,1,1
GCCGAAATTCCTACGT-1_V12N28-333_A1,0,1,3,0,0,4
GGCACTCCACTGGGCA-1_V12N28-333_A1,0,1,1,0,0,2
GGGTCACCGTGACGGT-1_V12N28-333_A1,0,0,2,0,0,2
CACTTAATCAGACGGA-1_V12N28-333_A1,0,2,1,0,0,3
CGTTTCGCTCATTACA-1_V12N28-333_A1,0,0,1,0,1,2
ATAAAGGCTCGGTCGT-1_V12N28-333_A1,0,2,2,0,0,4
CACTAAAGTTGCCTAT-1_V12N28-333_A1,0,2,2,0,0,4
GTGCTCAAGTACTGTC-1_V12N28-333_A1,0,0,1,0,1,2
CCATGCCTGTTTAGTA-1_V12N28-333_A1,0,1,1,0,0,2
TCTAGTTATCAGAAGA-1_V12N28-333_A1,0,1,2,0,0,3
TTGTAATCCGTACTCG-1_V12N28-333_A1,3,1,0,0,0,4
TCCCAGCTTTAGTCTG-1_V12N28-333_A1,0,1,1,0,1,3
CTACGCACGGAGTACC-1_V12N28-333_A1,0,1,1,0,2,4
AAATTAACGGGTAGCT-1_V12N28-333_A1,7,0,1,0,0,8
CGGCCACGCACAAAGT-1_V12N28-333_A1,0,1,0,0,0,1
GAAGCGTGAGGAATTT-1_V12N28-333_A1,1,0,1,0,0,2
ATATCTTAGGGCCTTC-1_V12N28-333_A1,0,0,3,0,0,3
ACGCGGGCCAAGGACA-1_V12N28-333_A1,0,1,0,0,1,2
GCGAGTTCTGCAAAGA-1_V12N28-333_A1,1,1,3,0,0,5
TATTCGTGCCAGAATA-1_V12N28-333_A1,2,0,0,0,1,3
AGGGCTGCAGTTACAG-1_V12N28-333_A1,0,1,1,0,0,2
CTAGCATAGTATAATG-1_V12N28-333_A1,0,1,1,0,0,2
TAGGTTCGAGTTCGTC-1_V12N28-333_A1,1,1,1,0,1,4
GAATTATAGTGAAAGG-1_V12N28-333_A1,1,1,1,0,0,3
CTATCGGGTCTCAACA-1_V12N28-333_A1,2,0,2,0,0,4
GCGCTAATTGAATAGA-1_V12N28-333_A1,0,0,1,0,0,1
ATGCGACAGTCCCATT-1_V12N28-333_A1,0,0,0,0,0,0
GGTAGTGCTCGCACCA-1_V12N28-333_A1,0,1,9,0,0,10
AAGCTCGTGCCAAGTC-1_V12N28-333_A1,0,1,0,0,1,2
TATTCAATTCTAATCC-1_V12N28-333_A1,0,1,1,0,1,3
TTCAAAGTCTCTAGCC-1_V12N28-333_A1,0,2,2,0,0,4
TTGAATATGGACTTTC-1_V12N28-333_A1,0,0,3,0,1,4
AAGAGCTCTTTATCGG-1_V12N28-333_A1,0,3,2,0,0,5
TTACTCCGGCCGGGAA-1_V12N28-333_A1,0,3,4,0,0,7
AAACGAGACGGTTGAT-1_V12N28-333_A1,1,2,2,0,0,5
GCTAAGTAGTTTCTCT-1_V12N28-333_A1,1,0,5,0,0,6
ATAACGCCGGAGGGTC-1_V12N28-333_A1,0,2,0,0,0,2
GGATCCGGAATATACT-1_V12N28-333_A1,0,0,3,0,0,3
TGAAAGGACCTGACTC-1_V12N28-333_A1,0,1,0,0,1,2
TCCGCGGCAGCATCTG-1_V12N28-333_A1,0,3,3,0,0,6
TGCATATGTCTGTCAC-1_V12N28-333_A1,0,0,6,0,0,6
TGTAGGAGAAATTTCC-1_V12N28-333_A1,0,3,1,0,0,4
AGTGAGACTTCCAGTA-1_V12N28-333_A1,0,0,2,0,0,2
CCCAAACATGCTGCTC-1_V12N28-333_A1,0,2,0,0,0,2
GCTTATGAAGCAGGAA-1_V12N28-333_A1,0,0,4,0,0,4
TTCTAACCGAAGCTTA-1_V12N28-333_A1,0,3,2,0,0,5
GGATGTCCTTACCGCA-1_V12N28-333_A1,0,4,1,0,0,5
AGGGTGCTCTCGAGGG-1_V12N28-333_A1,0,1,2,0,0,3
AACTCTCAATAGAGCG-1_V12N28-333_A1,0,1,2,0,0,3
TCTGAATTCCGTACAA-1_V12N28-333_A1,0,1,2,0,1,4
GCGTGGTACTGGGTTA-1_V12N28-333_A1,0,2,5,0,0,7
CGTCGGATAGTGTTGA-1_V12N28-333_A1,0,1,2,0,0,3
ATATGTCTCCCTAGCC-1_V12N28-333_A1,0,1,1,0,1,3
TCTTTAAGACTATGAA-1_V12N28-333_A1,0,1,0,0,0,1
TCATTTAAGTCTCCGA-1_V12N28-333_A1,0,1,4,0,0,5
GATATTGAGATTGGCG-1_V12N28-333_A1,0,2,4,0,1,7
TGACATCGAGCGGACC-1_V12N28-333_A1,0,2,3,1,0,6
GCGTAAATGGCCATAA-1_V12N28-333_A1,0,0,3,0,0,3
ATTGTACAACTCGGCT-1_V12N28-333_A1,0,1,1,0,0,2
TACGCTATAGAAACCT-1_V12N28-333_A1,0,1,1,0,0,2
CACCCAAATCTTATGT-1_V12N28-333_A1,0,3,1,0,1,5
AGATGATGGAGTCTGG-1_V12N28-333_A1,0,1,4,0,0,5
CCACGGTGCCCGGTAG-1_V12N28-333_A1,0,0,0,0,0,0
TCAAGAAATACTAGCT-1_V12N28-333_A1,0,0,1,0,0,1
AGGTATAATTGATAGT-1_V12N28-333_A1,0,1,2,0,0,3
CAAGGTCCTATAGGCT-1_V12N28-333_A1,0,1,0,0,0,1
CCGGCACGACCGTTTC-1_V12N28-333_A1,0,0,1,0,0,1
ACCTCCGTTATTCACC-1_V12N28-333_A1,0,0,2,0,0,2
GCAGCCTATATCACAT-1_V12N28-333_A1,0,1,2,0,1,4
GGTATAGTGACACATA-1_V12N28-333_A1,0,0,0,0,0,0
AAATTCCAGGTCCAAA-1_V12N28-333_A1,0,2,3,1,0,6
TCTTTAGCAGGCGAAC-1_V12N28-333_A1,1,2,2,0,0,5
TATTGACATTTCTGCC-1_V12N28-333_A1,0,3,0,0,0,3
TCTGATCGGGTGCTAG-1_V12N28-333_A1,0,2,2,0,0,4
GGCCCGGAGCATGTCT-1_V12N28-333_A1,0,2,1,0,0,3
GGGCGCAGCGTTACTC-1_V12N28-333_A1,0,1,0,0,1,2
TTGGCGATCCGAATAT-1_V12N28-333_A1,0,0,2,0,0,2
CCACGTAAATTAGACT-1_V12N28-333_A1,0,1,0,1,0,2
TCTGATTGGAAATGGA-1_V12N28-333_A1,0,0,2,0,0,2
ATGGCGGAATAGTCGC-1_V12N28-333_A1,0,0,0,0,0,0
ATCGCTTTACGTCTCA-1_V12N28-333_A1,0,0,3,0,1,4
TACGTGCAAGGTTCCT-1_V12N28-333_A1,0,0,0,0,0,0
CAGGACAGCTGCCCTT-1_V12N28-333_A1,0,0,1,0,0,1
CAAACCAGGTCTGCAT-1_V12N28-333_A1,1,7,1,0,0,9
ACAAGCTATATGGAAG-1_V12N28-333_A1,4,2,0,0,0,6
TCGCCCACTGCGAGAG-1_V12N28-333_A1,10,0,5,0,0,15
AGCCGCAAATTCAAAT-1_V12N28-333_A1,2,0,1,0,0,3
TTAACGTTAAAGCCTG-1_V12N28-333_A1,3,0,1,0,0,4
CAGCGCCAACACGATA-1_V12N28-333_A1,0,0,0,0,0,0
ATCCAATGGTACCGAA-1_V12N28-333_A1,0,1,0,0,0,1
GTGCTGCAGATAAGGA-1_V12N28-333_A1,0,1,1,0,3,5
GGCCTTTGCAACTGGC-1_V12N28-333_A1,0,0,1,0,0,1
GTCGTACCTACGATTG-1_V12N28-333_A1,0,0,2,0,0,2
TAGAAATTCACGTATA-1_V12N28-333_A1,0,1,5,0,0,6
AGAATAAATCTTCAGG-1_V12N28-333_A1,0,0,0,0,0,0
CATTGCGAAATGGGCG-1_V12N28-333_A1,0,0,2,0,0,2
GTCTACTCAATTACAA-1_V12N28-333_A1,0,0,2,0,0,2
TGTAATGACCACAATA-1_V12N28-333_A1,0,1,1,0,0,2
AAAGTCGACCCTCAGT-1_V12N28-333_A1,0,0,2,0,0,2
TACTCGGCACGCCGGG-1_V12N28-333_A1,0,0,2,0,0,2
AGGTGTATCGCCATGA-1_V12N28-333_A1,0,1,0,0,0,1
TGTGCTTTACGTAAGA-1_V12N28-333_A1,0,1,1,0,0,2
AAACCTCATGAAGTTG-1_V12N28-333_A1,0,0,2,0,0,2
TATAGGGTACTCATGA-1_V12N28-333_A1,0,0,0,0,0,0
CCAGCTGATGGTACTT-1_V12N28-333_A1,0,0,4,0,0,4
AATATTGGAGTATTGA-1_V12N28-333_A1,0,0,1,0,0,1
GGCCCTCACCCACTTA-1_V12N28-333_A1,0,0,3,0,0,3
AACCAAGACTTCTCTG-1_V12N28-333_A1,0,0,1,0,1,2
TCGTATTACCCATTGC-1_V12N28-333_A1,0,0,4,0,0,4
ATTCGACGCCGGGCCT-1_V12N28-333_A1,0,1,2,0,0,3
GGCGCAGGACATCTTC-1_V12N28-333_A1,0,0,4,0,1,5
GTACTCCCTTATCGCT-1_V12N28-333_A1,0,2,3,0,0,5
TGGTCTGTTGGGCGTA-1_V12N28-333_A1,0,0,0,0,0,0
AATAACAACGCTCGGC-1_V12N28-333_A1,3,1,2,0,0,6
CATACCCGTACCCAGT-1_V12N28-333_A1,0,0,1,0,0,1
ACAATCCATTTAAACC-1_V12N28-333_A1,0,0,3,0,0,3
GTTACAATTGGTGACG-1_V12N28-333_A1,0,0,1,0,1,2
TTGCCCTGATCACGGG-1_V12N28-333_A1,0,0,1,0,0,1
CTAACCGCGCGCCCGT-1_V12N28-333_A1,0,0,0,0,0,0
CTAAAGAATGCCTACT-1_V12N28-333_A1,0,0,4,0,0,4
ACCCATCTTGAGGGTA-1_V12N28-333_A1,0,1,2,0,0,3
GATCTTTGCAGGGTAT-1_V12N28-333_A1,0,2,1,0,0,3
GGGTACTTCATGAACT-1_V12N28-333_A1,0,0,2,0,0,2
GCCGCTTGTGAGAAAC-1_V12N28-333_A1,0,1,4,0,0,5
CCTGTAAGACATGATA-1_V12N28-333_A1,0,0,1,0,0,1
CGACAGTTCGCGTTAT-1_V12N28-333_A1,0,0,0,0,0,0
ACGATGCATATGTTAT-1_V12N28-333_A1,0,0,0,0,0,0
TGTTCCGCTTCCATGA-1_V12N28-333_A1,0,1,1,0,1,3
GGATGACGCGAGTTTA-1_V12N28-333_A1,0,0,1,0,1,2
GAAGTTTCCACTCAAT-1_V12N28-333_A1,0,1,1,0,1,3
GCGAGGCCCGAGCAGA-1_V12N28-333_A1,0,0,1,1,0,2
CATACTATGTAATTGT-1_V12N28-333_A1,0,1,3,0,0,4
CCAATGTCACAGCAAG-1_V12N28-333_A1,0,1,5,0,0,6
GTTGGATTTGCGTTGG-1_V12N28-333_A1,0,1,2,0,0,3
GGGAGGATGCCCGAAA-1_V12N28-333_A1,0,0,4,0,0,4
GATCGCGGGCTCTCCA-1_V12N28-333_A1,0,0,5,0,0,5
GTTCGCCATAAGTGCC-1_V12N28-333_A1,0,0,3,0,0,3
AGATTATAGGACGTTT-1_V12N28-333_A1,0,2,0,0,0,2
TCGAGACCAACACCGT-1_V12N28-333_A1,0,0,1,0,1,2
TATGGGACCGAGCAGG-1_V12N28-333_A1,0,0,2,0,2,4
GATGCGTCCTGCATTC-1_V12N28-333_A1,0,0,1,0,0,1
TATGGTCTGAGTAACA-1_V12N28-333_A1,0,2,1,0,0,3
GCATAGAGCACTCAGG-1_V12N28-333_A1,0,0,0,0,0,0
CTTCATTGTCAGTGGA-1_V12N28-333_A1,0,0,1,0,0,1
GCAGATTAGGGATATC-1_V12N28-333_A1,0,0,2,0,0,2
CCTGTCGCCCGTAAAT-1_V12N28-333_A1,1,0,1,0,0,2
CAATTTCGTATAAGGG-1_V12N28-333_A1,0,0,1,0,0,1
GTACACTTACCTGAAG-1_V12N28-333_A1,0,0,3,0,1,4
CCAGCCTGGACCAATA-1_V12N28-333_A1,0,1,1,0,0,2
ATGGAGCAGGCCGTGA-1_V12N28-333_A1,2,2,2,0,0,6
AAGACTGCAAGCTACT-1_V12N28-333_A1,1,0,1,0,0,2
CTAGTCACGTCTTAAG-1_V12N28-333_A1,0,1,1,0,0,2
ATTAGGCGATGCTTTC-1_V12N28-333_A1,1,0,0,0,0,1
TTCGGGACTAATCGCG-1_V12N28-333_A1,0,0,2,0,0,2
TGGACTGTTCGCTCAA-1_V12N28-333_A1,0,0,2,0,0,2
AACGTGCGAAAGTCTC-1_V12N28-333_A1,0,1,2,0,0,3
CCACCCAAGGAAAGTG-1_V12N28-333_A1,0,0,0,0,0,0
CCGCACAAAGACCAAC-1_V12N28-333_A1,0,0,0,0,0,0
GCGATTGTTAACGTTA-1_V12N28-333_A1,0,0,3,0,0,3
ACTCGTCAGTAATCCC-1_V12N28-333_A1,0,1,2,0,0,3
GGTGATAAGGAGCAGT-1_V12N28-333_A1,0,2,1,0,0,3
AAGAGGCATGGATCGC-1_V12N28-333_A1,1,0,1,0,0,2
CACGTTCGTGCTCTAG-1_V12N28-333_A1,1,1,1,0,0,3
CTATTTGGTTACGGAT-1_V12N28-333_A1,0,0,1,0,0,1
GTACAGAGGCAAGGGT-1_V12N28-333_A1,0,0,1,0,0,1
GGGCCGGCCGAAGTAC-1_V12N28-333_A1,0,2,2,0,0,4
CCTGAACGATATATTC-1_V12N28-333_A1,0,0,0,0,0,0
CCGGGCTGCTCCATAC-1_V12N28-333_A1,1,1,3,0,0,5
TACTTGTTAGTAGTCC-1_V12N28-333_A1,0,0,3,1,0,4
CCTAGGCGTAGCGATC-1_V12N28-333_A1,0,3,2,0,0,5
CTGGCGCACAGGTCTG-1_V12N28-333_A1,0,2,2,0,2,6
ACTTATACTTACCCGG-1_V12N28-333_A1,0,0,1,0,0,1
GAAGTCTCCCTAGCGA-1_V12N28-333_A1,0,2,1,1,0,4
ACCGATGGTAGCATCG-1_V12N28-333_A1,0,0,1,0,0,1
CGAGTTTATCGGACTG-1_V12N28-333_A1,0,4,1,0,1,6
CATAACGGACAGTCGT-1_V12N28-333_A1,0,2,1,0,0,3
TGACGATGCACTAGAA-1_V12N28-333_A1,0,2,2,0,0,4
TAGGGAGCTTGGGATG-1_V12N28-333_A1,0,3,0,0,0,3
AGGGTCGATGCGAACT-1_V12N28-333_A1,0,1,0,0,0,1
TATATCCCTGGGAGGA-1_V12N28-333_A1,0,0,2,0,0,2
CATCTTACACCACCTC-1_V12N28-333_A1,0,1,2,0,0,3
GTGCGACAGGGAGTGT-1_V12N28-333_A1,0,1,1,0,0,2
CCGATCTCAACCTTAT-1_V12N28-333_A1,0,3,3,0,0,6
ACGATCATCTTGTAAA-1_V12N28-333_A1,0,1,2,0,0,3
GAAAGAACAGCGTTAT-1_V12N28-333_A1,0,1,3,0,0,4
CTAGGTCTGAAGGAAT-1_V12N28-333_A1,0,1,2,0,0,3
ATATCAACCTACAGAG-1_V12N28-333_A1,0,1,4,0,0,5
AAATAGCTTAGACTTT-1_V12N28-333_A1,0,1,2,1,0,4
GCGACATGTAAACATC-1_V12N28-333_A1,0,2,3,0,0,5
ATAAGTAGGGCGACTC-1_V12N28-333_A1,0,1,4,0,0,5
GCGAGCGCATGCTCCC-1_V12N28-333_A1,0,2,1,0,0,3
AGGGACCGGCTGCGTT-1_V12N28-333_A1,0,2,2,0,0,4
CCTATGAAGTGGTGCC-1_V12N28-333_A1,0,0,0,0,0,0
GCTTACGTAGTTAGTA-1_V12N28-333_A1,0,0,2,0,0,2
CATACTTAGGCAATAC-1_V12N28-333_A1,0,0,2,0,0,2
CCTGTCCCTCACGTTA-1_V12N28-333_A1,0,1,4,0,0,5
CAATGTGCCAACCCTT-1_V12N28-333_A1,0,0,1,0,1,2
GTTAAGTTAGAGTGGG-1_V12N28-333_A1,0,0,2,1,1,4
CTGGGATACGCTACCC-1_V12N28-333_A1,0,0,1,0,1,2
AACCTGTCACGGAATT-1_V12N28-333_A1,0,1,1,0,0,2
ACTGCGGACACACCGT-1_V12N28-333_A1,0,0,2,0,0,2
CCGTGAGGCATTCATG-1_V12N28-333_A1,0,1,2,0,0,3
GCCCAGATGCTGGAGA-1_V12N28-333_A1,0,0,1,0,1,2
TCTGGCCGTTCAAGTT-1_V12N28-333_A1,0,1,1,0,0,2
ATACGAAGGCTTTCCA-1_V12N28-333_A1,1,0,0,0,0,1
GATCCGAATATAAGTG-1_V12N28-333_A1,0,2,1,0,2,5
GTGGAGCATGTCGGCC-1_V12N28-333_A1,0,2,1,0,1,4
ACTCTTCAGCTCCCGC-1_V12N28-333_A1,0,0,1,0,1,2
CCCGATAGCCTCGCCT-1_V12N28-333_A1,0,1,1,0,2,4
ACAGGTGTGTTGTTGC-1_V12N28-333_A1,3,1,1,0,0,5
TGAACTGCTATGACTT-1_V12N28-333_A1,1,0,0,0,0,1
TGACATATATGACGAT-1_V12N28-333_A1,3,1,0,0,0,4
AAGTCTTCTGTGGCCT-1_V12N28-333_A1,0,0,0,0,0,0
ACCAGACCATAACAAC-1_V12N28-333_A1,2,0,0,0,0,2
TGAGACGTACCTCTCA-1_V12N28-333_A1,1,0,1,0,0,2
GACCGTTACATGCGAC-1_V12N28-333_A1,0,0,3,0,0,3
GGTTCGGATTATACTA-1_V12N28-333_A1,0,2,1,0,1,4
CCTCCTGAGCCCACAT-1_V12N28-333_A1,0,0,0,0,0,0
CCGCGATTTGGTAGGT-1_V12N28-333_A1,0,2,3,0,1,6
AATCTCTACTGTGGTT-1_V12N28-333_A1,0,0,0,0,0,0
ACTTTGACTGCATCCT-1_V12N28-333_A1,0,0,2,0,1,3
CCCTGACTAACAAATT-1_V12N28-333_A1,0,0,1,0,1,2
ACGCTGTGAGGCGTAG-1_V12N28-333_A1,0,0,0,0,0,0
GCATACGAGGTCTTTA-1_V12N28-333_A1,0,0,1,0,0,1
TCGGGATTCAAACATA-1_V12N28-333_A1,0,0,2,0,0,2
GGGCCCTACGAAAGGG-1_V12N28-333_A1,0,0,0,0,0,0
CGCCAAGAAGCCGAGT-1_V12N28-333_A1,0,1,4,0,0,5
GGTACATCTGGGACGA-1_V12N28-333_A1,0,0,2,0,0,2
GGATGCTGGCGTTCCT-1_V12N28-333_A1,0,0,2,0,1,3
CCGATTCGAGGGACCC-1_V12N28-333_A1,0,0,3,0,0,3
CCACTGGTGGCTGGTT-1_V12N28-333_A1,0,0,1,0,2,3
GACAGGCACACACTAT-1_V12N28-333_A1,0,1,2,0,0,3
TCAACGCGACCGGCAG-1_V12N28-333_A1,0,1,3,0,0,4
CTACGACTAGCTATAA-1_V12N28-333_A1,0,0,1,0,0,1
CGGTTGACCTGGCATA-1_V12N28-333_A1,0,0,1,0,0,1
ATCCTGAATCGCTGCG-1_V12N28-333_A1,0,1,0,0,0,1
GTTTCATATCGTCGCT-1_V12N28-333_A1,0,0,5,0,0,5
ATAAATATTAGCAGCT-1_V12N28-333_A1,0,0,1,0,0,1
AAGAGGATGTACGCGA-1_V12N28-333_A1,0,1,2,0,0,3
TCCTGCGTTGATACTC-1_V12N28-333_A1,0,0,1,0,1,2
CGTGCATTGTCGACGC-1_V12N28-333_A1,0,0,1,0,0,1
CCGGGTTCGAGGTTAC-1_V12N28-333_A1,0,0,0,0,1,1
CCCAATTTCACAACTT-1_V12N28-333_A1,0,0,2,0,1,3
TGATTTATTAGCTGTG-1_V12N28-333_A1,0,0,2,0,0,2
TGGAAGAAGGGAACGT-1_V12N28-333_A1,0,0,2,0,1,3
GACGCTTGCTTCTAAA-1_V12N28-333_A1,0,1,2,0,0,3
GGGAACGGGAGGTTAG-1_V12N28-333_A1,0,0,0,0,0,0
GCGGCTCTGACGTACC-1_V12N28-333_A1,0,0,0,0,1,1
ACGTTAGATTTGCCCG-1_V12N28-333_A1,0,0,3,0,0,3
GAGAGGGCGCGAGGTT-1_V12N28-333_A1,0,0,1,0,0,1
GCGTCTCTGCATTGGG-1_V12N28-333_A1,0,0,0,0,0,0
GCAGCACACAGCCCAG-1_V12N28-333_A1,1,3,2,0,0,6
CAGGCCGTTTGGGTGT-1_V12N28-333_A1,0,0,1,0,0,1
AACTCAAGTTAATTGC-1_V12N28-333_A1,0,1,2,0,1,4
CTTCGTAGATAGGTGA-1_V12N28-333_A1,0,0,3,0,0,3
TGCAGAGTACCGAGCA-1_V12N28-333_A1,0,1,4,0,0,5
GAAGTGATTTATCGTG-1_V12N28-333_A1,1,0,3,0,0,4
CGCTACGGGACATTTA-1_V12N28-333_A1,0,0,4,0,0,4
CCACACTGAGATATTA-1_V12N28-333_A1,0,0,5,0,0,5
CGATCCGACCCAGTGC-1_V12N28-333_A1,0,2,2,0,0,4
CTGTACTTCTTAGCAT-1_V12N28-333_A1,0,1,5,0,1,7
ACTTATTAGGATCGGT-1_V12N28-333_A1,1,0,0,0,3,4
TAGTCCGCAGAGAATG-1_V12N28-333_A1,0,0,1,0,0,1
TTCACGAAAGGATCAC-1_V12N28-333_A1,0,0,0,0,0,0
TACATTTCTAACGTGC-1_V12N28-333_A1,0,1,1,0,0,2
ACCATATCCGCAATAA-1_V12N28-333_A1,0,1,4,0,0,5
CACTCAAGAGCTATGG-1_V12N28-333_A1,0,0,2,0,0,2
TGTACGAACAAATCCG-1_V12N28-333_A1,0,2,1,0,0,3
ATCATCCAATATTTGT-1_V12N28-333_A1,0,3,3,0,0,6
CGCTATTCTTAGGCTC-1_V12N28-333_A1,0,0,2,0,0,2
TGGCAGCAGTAATAGT-1_V12N28-333_A1,0,0,1,0,0,1
TCACGTGCCCGATTCA-1_V12N28-333_A1,0,1,2,0,0,3
CATACGGCGTCTGGGC-1_V12N28-333_A1,0,3,4,0,0,7
CACATGATTCAGCAAC-1_V12N28-333_A1,4,1,0,0,1,6
GCTAGTAGAGCTTGTA-1_V12N28-333_A1,0,0,0,0,0,0
TGCTGTTGAAGAACTC-1_V12N28-333_A1,0,0,0,0,0,0
CGGAGCATGGCGATCC-1_V12N28-333_A1,0,0,0,0,0,0
TAGCGTTGGGTCTTAC-1_V12N28-333_A1,2,0,1,0,0,3
GTAGCGGCTATACACT-1_V12N28-333_A1,2,1,1,0,0,4
TAACATACAATGTGGG-1_V12N28-333_A1,1,3,0,0,0,4
TCTTCGAATAGACGTT-1_V12N28-333_A1,1,0,1,0,1,3
GATCGTGACTGATATC-1_V12N28-333_A1,2,2,1,0,0,5
GATCCGGGAATTAACA-1_V12N28-333_A1,0,0,2,0,1,3
TTATATACGCTGTCAC-1_V12N28-333_A1,1,1,2,0,0,4
GTCGCGTAACCCGTTG-1_V12N28-333_A1,0,1,5,0,1,7
AGCTCTAGACGTTCCA-1_V12N28-333_A1,0,1,0,0,2,3
GTCAAGCGGACTCGGG-1_V12N28-333_A1,0,0,0,0,0,0
CGAGGGACTGCGGTCG-1_V12N28-333_A1,0,1,3,0,0,4
AATCGCCTCAGCGCCA-1_V12N28-333_A1,0,1,4,0,1,6
CTTGTTGCTGAGTCAA-1_V12N28-333_A1,0,2,0,0,1,3
GATATGAGACACTAAC-1_V12N28-333_A1,1,1,2,0,0,4
TTATGATCTTAACGAA-1_V12N28-333_A1,1,0,2,0,0,3
CGCCGCCCATGCCTGT-1_V12N28-333_A1,1,5,0,0,0,6
CTGGGATAAATAATGG-1_V12N28-333_A1,0,1,2,0,0,3
GTGCCCGTTCGGATTC-1_V12N28-333_A1,0,0,2,0,0,2
TTCAATACTCTGAATC-1_V12N28-333_A1,1,1,2,0,0,4
CGCACATGTCCACTAC-1_V12N28-333_A1,1,0,1,0,0,2
AGAAGAGCGCCGTTCC-1_V12N28-333_A1,0,3,1,0,0,4
GATAACTCGCACTGTG-1_V12N28-333_A1,1,0,1,0,1,3
AGTCGACGGTCTCAAG-1_V12N28-333_A1,0,1,0,0,0,1
GTGACCGCACACTACG-1_V12N28-333_A1,0,0,2,0,2,4
GTATGTGGGTCTAGTT-1_V12N28-333_A1,0,1,3,0,0,4
CTTGAGTTAGGGTAAT-1_V12N28-333_A1,0,1,1,0,0,2
TTAGCTGATTTGCCGT-1_V12N28-333_A1,0,4,1,0,0,5
GCTGTTGCTACCGAAC-1_V12N28-333_A1,0,2,0,0,0,2
TATTACCATCCTGCTT-1_V12N28-333_A1,0,1,4,0,0,5
TTGAATTCACGTGAGG-1_V12N28-333_A1,1,0,2,0,0,3
CCATCTCACCAGTGAA-1_V12N28-333_A1,0,1,1,0,0,2
CGCACGTGCGCTATCA-1_V12N28-333_A1,0,0,1,0,0,1
ACCCGGATGACGCATC-1_V12N28-333_A1,0,0,4,0,0,4
CGCTAGAGACCGCTGC-1_V12N28-333_A1,0,1,1,0,1,3
ATAGTTCCACCCACTC-1_V12N28-333_A1,0,2,1,0,0,3
GCAGACCCAGCACGTA-1_V12N28-333_A1,0,1,1,0,0,2
TAGACTACCTAGCGTT-1_V12N28-333_A1,0,1,1,0,0,2
GGTTCTACTCGTCTGA-1_V12N28-333_A1,0,0,4,0,1,5
GACTCACCCACGTGAG-1_V12N28-333_A1,0,2,1,0,1,4
AGCTCTTCGTAACCTT-1_V12N28-333_A1,0,1,1,0,0,2
ACTATCCAGGGCATGG-1_V12N28-333_A1,0,0,1,0,0,1
AAGGATCGATCGCTTG-1_V12N28-333_A1,0,2,0,0,0,2
ATATCGGTAGGGAGAT-1_V12N28-333_A1,0,3,1,0,1,5
TTCCAGACGAGATTTA-1_V12N28-333_A1,0,1,1,0,0,2
GACCGACGTGAAAGCA-1_V12N28-333_A1,0,0,3,0,0,3
CCTGGAAACGTTCTGC-1_V12N28-333_A1,0,0,1,0,0,1
CCGGTAATGGCTAGTC-1_V12N28-333_A1,0,1,1,0,0,2
GCCGTGGAAGAAATGT-1_V12N28-333_A1,0,0,2,0,0,2
GTCTTGAGGAGCAGTG-1_V12N28-333_A1,0,1,2,0,0,3
TCCCAAAGCCCTAAAT-1_V12N28-333_A1,0,1,3,0,0,4
TTGAGCGCCACGTGAT-1_V12N28-333_A1,0,1,0,0,0,1
TTGAGTCCCGCTGCTG-1_V12N28-333_A1,0,3,3,0,0,6
ATGGAACCTTTGCACA-1_V12N28-333_A1,0,0,2,0,0,2
GCTAGCACCTGGGCCA-1_V12N28-333_A1,0,0,3,0,0,3
CGCCGTCTACCCATCG-1_V12N28-333_A1,0,1,0,0,0,1
GATAGGTGTCCCGGGC-1_V12N28-333_A1,1,0,0,0,0,1
AGGTATGCGGACATTA-1_V12N28-333_A1,0,0,2,0,2,4
TTGGTTCGCTCAAAGG-1_V12N28-333_A1,0,0,0,0,1,1
TCTGGAGCGTAAGAGT-1_V12N28-333_A1,0,1,0,0,3,4
TGCCTAAATTTAATAG-1_V12N28-333_A1,0,1,2,0,0,3
TAATTTCCGTCCAGTA-1_V12N28-333_A1,4,4,0,0,0,8
TCCTTCAATCCCTACG-1_V12N28-333_A1,3,1,0,0,0,4
TACCTATCCCTAGAGG-1_V12N28-333_A1,4,1,0,0,0,5
GCATGGGTACTGACGC-1_V12N28-333_A1,8,1,0,0,0,9
GTCGGGAACATGGTAG-1_V12N28-333_A1,4,0,0,0,0,4
GCAAATGAGGACACTT-1_V12N28-333_A1,1,0,0,0,0,1
GAATGGGCTTATCGAC-1_V12N28-333_A1,1,0,2,0,0,3
TGGTCGTGCAAGGCAA-1_V12N28-333_A1,0,1,4,0,0,5
CACCACGCCACACAGA-1_V12N28-333_A1,0,1,5,0,0,6
GAACCTCGACCTACAC-1_V12N28-333_A1,0,0,2,0,0,2
CAATACGCTCTGAGGC-1_V12N28-333_A1,0,1,0,0,0,1
TGGTAAGCAGGATTGA-1_V12N28-333_A1,0,0,5,0,0,5
AGTGGCTCCGTCGGCC-1_V12N28-333_A1,0,0,2,0,0,2
GATCGGATAGAACCAT-1_V12N28-333_A1,0,0,5,0,0,5
GCTACAGTACGGACCG-1_V12N28-333_A1,0,0,0,0,0,0
TCTATTACTAGAGGAT-1_V12N28-333_A1,0,0,2,0,0,2
TTCAGGCGTCAAAGCC-1_V12N28-333_A1,0,1,2,0,0,3
AGACCGGGAAACCCTG-1_V12N28-333_A1,0,0,4,0,0,4
AGAGATCTCTAAAGCG-1_V12N28-333_A1,0,0,0,0,0,0
CCCTGCCCAATCCGCT-1_V12N28-333_A1,0,0,0,0,0,0
GTGGCGGTCCCAGCGT-1_V12N28-333_A1,0,1,1,0,0,2
GCATTGTAATTCATAT-1_V12N28-333_A1,0,0,0,0,1,1
CCGTTCCGAATCTCGG-1_V12N28-333_A1,0,0,2,0,1,3
AGCTTGATCTTAACTT-1_V12N28-333_A1,0,0,1,0,0,1
CCTGTACTCACGCCCA-1_V12N28-333_A1,0,0,0,0,1,1
AAGTGACGACCGAATT-1_V12N28-333_A1,0,0,4,0,0,4
CTCACTTGGCTGGTAA-1_V12N28-333_A1,0,1,3,0,1,5
CGCCTGGCCTACGTAA-1_V12N28-333_A1,0,1,1,0,1,3
CCCGTAAGTCTAGGCC-1_V12N28-333_A1,0,0,1,0,2,3
TTGGACATGTGGCTTA-1_V12N28-333_A1,0,0,2,0,0,2
ATTACGCGCTGGCAGG-1_V12N28-333_A1,0,0,1,0,0,1
ACGCGCTACACAGGGT-1_V12N28-333_A1,0,1,1,0,1,3
TACGTTTACCGGCAAT-1_V12N28-333_A1,0,0,0,0,0,0
CGAAACGCAATTCATG-1_V12N28-333_A1,0,0,1,0,1,2
TAGTCTAACAACGAGA-1_V12N28-333_A1,0,0,1,0,0,1
TTGCATGCTGATCACG-1_V12N28-333_A1,0,0,1,0,1,2
TCTGGGTAGCGCTCAT-1_V12N28-333_A1,0,0,1,0,1,2
ACATCGGTCAGCCGCG-1_V12N28-333_A1,0,0,2,0,1,3
AGATACCGGTGTTCAC-1_V12N28-333_A1,0,0,3,0,0,3
GATTACTGAATTTGGG-1_V12N28-333_A1,0,1,5,0,0,6
TCCAACTTTAAATTCT-1_V12N28-333_A1,0,1,3,0,0,4
TCCTAGCAAAGAAGCT-1_V12N28-333_A1,0,0,2,0,0,2
GTCTATCTGAGTTTCT-1_V12N28-333_A1,0,0,0,0,1,1
GATGTTCAATCCACGA-1_V12N28-333_A1,1,1,2,0,1,5
AGTTAAACACTTGCGA-1_V12N28-333_A1,0,0,2,0,0,2
AGCTCTTTACTCAGTT-1_V12N28-333_A1,2,2,2,0,0,6
ATCCAGGATTCGTGAA-1_V12N28-333_A1,0,1,2,0,0,3
AGTCAACACCACCATC-1_V12N28-333_A1,0,2,0,0,0,2
CGATACCTCGCGGACA-1_V12N28-333_A1,1,1,1,0,0,3
TACAACGCACAACTCA-1_V12N28-333_A1,1,0,4,0,1,6
AATTAAAGGTCGGCGT-1_V12N28-333_A1,0,0,3,0,0,3
TACGCAGTTCTTTCCT-1_V12N28-333_A1,0,0,3,0,0,3
GACCGTGCTGACGGTG-1_V12N28-333_A1,0,1,2,0,0,3
GGCAAATTACTTTACT-1_V12N28-333_A1,0,1,1,0,0,2
GGTACAAACATGCTAT-1_V12N28-333_A1,0,0,2,0,1,3
CGGGCCTTCTTTGTAA-1_V12N28-333_A1,0,0,0,0,0,0
CGTGAAGTTAATTCAC-1_V12N28-333_A1,0,1,1,0,2,4
ATAGTGAAGCGTTCTC-1_V12N28-333_A1,0,1,5,0,1,7
TACGCCATATTCTAAT-1_V12N28-333_A1,0,0,0,0,0,0
GCCGGGTTAGGGTCGC-1_V12N28-333_A1,0,1,2,0,0,3
TACATAGGCATACACC-1_V12N28-333_A1,0,1,1,0,0,2
GCCGATTGGCCAAGCT-1_V12N28-333_A1,0,1,1,0,1,3
CTGCCATGCATCACAT-1_V12N28-333_A1,1,1,1,0,1,4
TTATGAATGAAAGGGA-1_V12N28-333_A1,0,0,3,0,0,3
GCTGAGGCGTGAGTAT-1_V12N28-333_A1,0,1,2,0,0,3
AGGTTTCACACACCTT-1_V12N28-333_A1,0,1,3,0,0,4
CAAGGATCGCATGTTC-1_V12N28-333_A1,0,0,2,0,0,2
ACGTTAATGTCGAAGA-1_V12N28-333_A1,0,1,1,0,1,3
TCCAGAGCACCGGTTC-1_V12N28-333_A1,1,1,3,0,0,5
GATTCGACGGTTCACG-1_V12N28-333_A1,0,1,1,0,2,4
GTTTCTGCAGTCTCCC-1_V12N28-333_A1,0,1,2,0,0,3
GCTGCACGGTTTCTTA-1_V12N28-333_A1,2,2,1,0,0,5
CGTGCAGACTGGGACA-1_V12N28-333_A1,0,2,0,0,1,3
GTGTTACTATGCGTCC-1_V12N28-333_A1,0,1,1,0,1,3
TCCTCGGGCTGGGCTT-1_V12N28-333_A1,0,1,1,0,0,2
GTGAGGACACTTAAGG-1_V12N28-333_A1,0,1,0,0,0,1
ATACGCCGGCGAAACC-1_V12N28-333_A1,0,0,2,0,1,3
TCTGCCAGAAACTGCA-1_V12N28-333_A1,0,0,0,0,0,0
TTCTGCGGGTTAGCGG-1_V12N28-333_A1,0,3,2,0,1,6
CTCGGTACCACTGCTC-1_V12N28-333_A1,1,2,1,0,1,5
GTAAGTAACAGTCTGG-1_V12N28-333_A1,0,2,2,0,0,4
GTGCGTGTATATGAGC-1_V12N28-333_A1,0,0,1,0,1,2
ATTTGTCTTGGGAGCT-1_V12N28-333_A1,0,1,1,0,0,2
CCTCGGACCGGGATAG-1_V12N28-333_A1,0,0,5,0,0,5
TAGGTGCTCGCCTAGC-1_V12N28-333_A1,1,0,3,0,0,4
CTTTAGGAACACTGTT-1_V12N28-333_A1,0,0,0,0,0,0
TCGGGCCGTCGTGGTA-1_V12N28-333_A1,1,0,2,0,0,3
AGTGCTTGCACGAATA-1_V12N28-333_A1,0,0,0,0,1,1
TGCAGTTTCCTCCCAT-1_V12N28-333_A1,1,1,1,0,0,3
TGAGAGATTTACCACG-1_V12N28-333_A1,0,0,2,0,0,2
GAAACAGATGACCACC-1_V12N28-333_A1,0,0,1,0,1,2
AGCAACATATCTTATT-1_V12N28-333_A1,0,0,1,0,1,2
CAAGTGTGGTTGCAAA-1_V12N28-333_A1,0,0,1,0,0,1
GCCTCATCTGGAAATA-1_V12N28-333_A1,0,0,2,0,0,2
AACCCTACTGTCAATA-1_V12N28-333_A1,0,0,1,0,0,1
ACGTATTACTCCGATC-1_V12N28-333_A1,0,0,1,0,2,3
TCTGGGAACCTTTGAA-1_V12N28-333_A1,0,0,0,0,0,0
GCTCGCTCATGTCCAA-1_V12N28-333_A1,0,1,2,0,0,3
GCGCAAGAGCGCGCTG-1_V12N28-333_A1,1,0,1,0,0,2
TTGACGCTCCATGAGC-1_V12N28-333_A1,0,1,0,0,0,1
TATAGATGGTCGCAGT-1_V12N28-333_A1,0,2,2,0,1,5
TTACATGCCACAACTA-1_V12N28-333_A1,1,0,0,0,0,1
ACATGGCGCCAAAGTA-1_V12N28-333_A1,0,0,1,1,1,3
TATGGTTAGTGGGAGA-1_V12N28-333_A1,1,0,3,0,0,4
CATGACTTCGCTGAAT-1_V12N28-333_A1,0,3,0,0,1,4
ACCACCAATGTAACAA-1_V12N28-333_A1,0,0,3,0,0,3
TCTTAGAGCTCCAATT-1_V12N28-333_A1,0,1,2,0,0,3
CCACGAATTTAACCTC-1_V12N28-333_A1,1,1,0,0,0,2
TTCTTGCTAGCATCTC-1_V12N28-333_A1,0,0,1,0,0,1
ACACCTTACTACTTGC-1_V12N28-333_A1,0,1,2,0,0,3
AGTCGGTTGCGTGAGA-1_V12N28-333_A1,0,1,3,0,0,4
ACCTACAGTATGTGGT-1_V12N28-333_A1,0,3,1,0,0,4
GAGGATAAACAGTGCT-1_V12N28-333_A1,0,0,1,0,0,1
TTCCGGTATCTGTGTC-1_V12N28-333_A1,0,1,0,0,0,1
GGAGGCCGAAGTCGTC-1_V12N28-333_A1,1,2,2,0,0,5
TTCGCTAGGAAGTTGT-1_V12N28-333_A1,0,1,0,0,0,1
TAAAGACAACCCTTTA-1_V12N28-333_A1,0,0,1,0,0,1
GTTGCGCTAACATTAC-1_V12N28-333_A1,4,0,2,0,0,6
GCTGAACTCTCCAGGG-1_V12N28-333_A1,0,0,1,0,0,1
AGCCCTGTCGCACCGT-1_V12N28-333_A1,0,2,2,0,0,4
AGCGCTAGAGCGATGT-1_V12N28-333_A1,0,1,4,0,1,6
TGCGCCGTTAATAACG-1_V12N28-333_A1,0,0,0,0,0,0
TGACAACGCATGTCGC-1_V12N28-333_A1,0,0,1,0,1,2
CGTCTTGAGTGTGACG-1_V12N28-333_A1,1,2,0,0,1,4
GATAGGATTAATTACA-1_V12N28-333_A1,1,0,1,0,1,3
GATACCGTGTCGGAGT-1_V12N28-333_A1,0,1,0,0,0,1
TGTGTCGAAGTCGAGG-1_V12N28-333_A1,2,2,0,0,0,4
GGATCAGAGCCATCAG-1_V12N28-333_A1,4,1,0,0,0,5
GTCCCAATCATCCCGC-1_V12N28-333_A1,0,3,0,0,0,3
TGCCACACTAGAGGAA-1_V12N28-333_A1,10,1,0,0,0,11
TGAATTTCACTTGCCT-1_V12N28-333_A1,1,0,0,0,0,1
CTCAGATTGTGATAAG-1_V12N28-333_A1,5,0,0,0,0,5
CGGACGTTACTTGAAG-1_V12N28-333_A1,1,0,1,0,0,2
CCGCCTTGCGATGTCG-1_V12N28-333_A1,4,1,1,0,2,8
CCAGTCAAATCTCTTA-1_V12N28-333_A1,0,0,5,0,0,5
AAACAGCTTTCAGAAG-1_V12N28-333_A1,0,1,2,0,1,4
TAGCTGATGTGAAGCG-1_V12N28-333_A1,0,1,3,0,0,4
CTTATGCGCTCAGGGC-1_V12N28-333_A1,0,0,4,0,2,6
TGGCTCTTGTCGCGTA-1_V12N28-333_A1,0,0,2,0,0,2
TTGTGAGGCATGACGC-1_V12N28-333_A1,0,0,1,0,0,1
CATAAGCTCTCCGTCT-1_V12N28-333_A1,0,0,1,0,0,1
CCTTCTCAGCGTTCCT-1_V12N28-333_A1,0,0,2,0,1,3
TGCAGCTACGTACTTC-1_V12N28-333_A1,0,0,1,0,0,1
CTCTACACTGGCGATT-1_V12N28-333_A1,0,0,2,0,1,3
TGCAGATCGTCCTAGG-1_V12N28-333_A1,0,1,1,0,0,2
TGCCAAAGTCAGACTT-1_V12N28-333_A1,0,0,1,0,0,1
ACAATAGTCGTACGTT-1_V12N28-333_A1,0,0,1,0,0,1
CATGCCAACTCGCAAA-1_V12N28-333_A1,0,1,2,0,0,3
TGCAGAACTATATCGT-1_V12N28-333_A1,0,1,2,0,0,3
TCGTGTCACGCTGACA-1_V12N28-333_A1,0,1,1,0,0,2
TGATCAGGGAACTGCT-1_V12N28-333_A1,0,0,2,0,0,2
CTTGCAACCGCCTCCT-1_V12N28-333_A1,0,0,1,0,0,1
AGCCCATACATGTAAG-1_V12N28-333_A1,0,0,1,0,0,1
ATCCAATGGAGGGTCC-1_V12N28-333_A1,2,0,5,0,0,7
AAACCGGGTAGGTACC-1_V12N28-333_A1,0,0,2,0,0,2
GCAACCACGGCCGCGT-1_V12N28-333_A1,0,0,2,0,3,5
CGCTTATTCCCGGTCG-1_V12N28-333_A1,0,2,2,0,1,5
TTACTCTGGTACGTAC-1_V12N28-333_A1,0,0,3,0,3,6
GTGGTTTCCGCCTTTC-1_V12N28-333_A1,0,0,1,0,0,1
ATAGGCGGCTATAGAA-1_V12N28-333_A1,0,1,3,0,0,4
GTGCCATCACACGGTG-1_V12N28-333_A1,0,0,1,0,0,1
CCCAACATACGTCGCG-1_V12N28-333_A1,0,1,0,0,2,3
CGGTGCAGATAGAACG-1_V12N28-333_A1,0,0,4,0,0,4
GGGCGGGTTCCCTACG-1_V12N28-333_A1,0,0,1,0,0,1
TGAGCCATACAGTCTC-1_V12N28-333_A1,0,2,1,0,0,3
CTCCGCCCACATGAGG-1_V12N28-333_A1,0,0,2,0,0,2
GTTGAACCGGTTCCAT-1_V12N28-333_A1,0,1,1,0,0,2
TTGACTACCATATGGT-1_V12N28-333_A1,0,0,1,0,1,2
ACCATCGTATATGGTA-1_V12N28-333_A1,1,0,1,0,0,2
TGCGTAAGAACCTGAT-1_V12N28-333_A1,0,1,2,0,0,3
AGAAGGTTGCCGAATT-1_V12N28-333_A1,0,0,2,0,0,2
AGGACGACCCATTAGA-1_V12N28-333_A1,0,0,0,0,0,0
GGTGCTGGTACACATT-1_V12N28-333_A1,1,0,2,0,0,3
GCGCTATGCCGAGGCA-1_V12N28-333_A1,0,0,4,0,0,4
ACCCGGTTACACTTCC-1_V12N28-333_A1,0,0,5,0,0,5
TAACTCATCCGCGCGG-1_V12N28-333_A1,0,0,2,0,1,3
CACAATGAGCTGCTAT-1_V12N28-333_A1,0,0,3,0,0,3
GTTACTTTGGGCCTAG-1_V12N28-333_A1,0,1,0,0,1,2
GGGCCCGTCTTAAACA-1_V12N28-333_A1,1,0,2,0,0,3
GAAATTGTCTCTATAA-1_V12N28-333_A1,1,0,1,0,1,3
GGCGCATGAATTGATG-1_V12N28-333_A1,0,0,1,0,1,2
CATATAGGTACAGTCA-1_V12N28-333_A1,2,0,8,0,0,10
TCAACGAGGAGACAAA-1_V12N28-333_A1,0,0,0,0,0,0
TTGCACAATTCAGAAA-1_V12N28-333_A1,0,0,1,0,0,1
CATCGGACGGGTTAAT-1_V12N28-333_A1,0,0,1,0,0,1
ATTAAACATGCGGACC-1_V12N28-333_A1,0,0,3,0,0,3
TATCTACCACAGCGGG-1_V12N28-333_A1,0,1,4,0,0,5
ACATCGATCGTTTACC-1_V12N28-333_A1,0,0,1,0,1,2
ATCGACCCAATACAGA-1_V12N28-333_A1,0,0,0,0,0,0
AGTTCCTATTTATGTT-1_V12N28-333_A1,0,1,0,0,0,1
CAGTCTGTATACTGGG-1_V12N28-333_A1,0,0,0,0,0,0
GGAGACGACACCTTTG-1_V12N28-333_A1,0,1,1,0,1,3
CCTAAATTAACGGTTC-1_V12N28-333_A1,0,0,3,0,0,3
GCTACGACTTATTGGG-1_V12N28-333_A1,0,1,0,0,2,3
CTGTGCAGGGTAGGTC-1_V12N28-333_A1,0,0,1,0,1,2
ACGCCGCTAGACGACC-1_V12N28-333_A1,0,0,2,0,2,4
ACTTGACTCCCTCTTT-1_V12N28-333_A1,1,0,1,0,0,2
CGCCTCCCTCCTCTAT-1_V12N28-333_A1,0,0,1,0,0,1
CTAGATTTACGACGGC-1_V12N28-333_A1,0,0,2,0,0,2
GATGCTGTATTTCATC-1_V12N28-333_A1,0,0,1,0,1,2
TGCGTTTGTTGACACT-1_V12N28-333_A1,0,1,1,0,0,2
CGTGCCCTCCCGAAGA-1_V12N28-333_A1,0,0,2,0,1,3
ACTCTCTGACTTAGGT-1_V12N28-333_A1,0,0,2,0,1,3
CTGGGTAGGCAGTTAA-1_V12N28-333_A1,0,0,2,0,0,2
GTTTGGCCCAAGTTAT-1_V12N28-333_A1,0,0,1,0,1,2
GAATGTGGTCCGGATT-1_V12N28-333_A1,0,2,2,0,0,4
CCCAGTTAAGGCGCCG-1_V12N28-333_A1,0,0,2,0,0,2
CGGTACTAGAATCAAA-1_V12N28-333_A1,0,0,1,0,0,1
GCTTAATGTAACTAAC-1_V12N28-333_A1,0,2,1,0,0,3
AGGACAGTCGAATCCC-1_V12N28-333_A1,0,0,1,0,1,2
GACAGCCAGACCTGAC-1_V12N28-333_A1,1,1,1,0,0,3
GGCGAAATCTAACTTG-1_V12N28-333_A1,0,2,2,0,1,5
CTGGTAACACATAGAA-1_V12N28-333_A1,0,0,1,0,0,1
TAGCCATTTCAAAGTC-1_V12N28-333_A1,0,1,2,0,2,5
GGGATTTACCGCACCT-1_V12N28-333_A1,1,0,1,1,0,3
ATGCCATTTGCGACCA-1_V12N28-333_A1,1,0,1,0,0,2
GAATAGACGCGACCCA-1_V12N28-333_A1,1,0,1,0,0,2
TGTATGGCGCAGACAG-1_V12N28-333_A1,0,0,1,0,0,1
GGATGAAGATCGCTGA-1_V12N28-333_A1,0,1,0,0,1,2
CGACAATTTGATCTAA-1_V12N28-333_A1,0,0,2,0,2,4
AAAGTTGACTCCCGTA-1_V12N28-333_A1,1,1,1,0,0,3
CGCGGCTCAACTTGAA-1_V12N28-333_A1,0,2,3,0,0,5
CACGCGGAACTGTTGC-1_V12N28-333_A1,2,1,2,0,0,5
TCTTAGAGTGAACTCT-1_V12N28-333_A1,1,0,2,0,0,3
AGTCCATTGGCTGATG-1_V12N28-333_A1,0,0,1,0,0,1
TTAAGATAGGATTGAC-1_V12N28-333_A1,0,1,2,0,0,3
ACATCCTGGTAACTGT-1_V12N28-333_A1,1,1,1,0,0,3
CACCTTGGCGCCTTTG-1_V12N28-333_A1,0,0,2,0,0,2
GCTAGACCGTCTACTG-1_V12N28-333_A1,0,3,2,0,0,5
CGGCCCAGGTATATCC-1_V12N28-333_A1,0,0,0,0,0,0
GTCCATTACTGCTACG-1_V12N28-333_A1,0,0,1,0,0,1
GGGTTTAGGATAGGAT-1_V12N28-333_A1,0,0,1,0,0,1
TAATTAGGACATCCGT-1_V12N28-333_A1,0,2,2,0,0,4
GCTCCCAGTCGGTCCA-1_V12N28-333_A1,0,0,1,0,2,3
ATTCGTGCTATCTCTT-1_V12N28-333_A1,0,1,1,0,0,2
GTTAACTATGTTGTCA-1_V12N28-333_A1,1,1,1,0,0,3
GCTCCGCTCGCTTCAG-1_V12N28-333_A1,0,1,1,0,0,2
GCAACGGCTAGTTATG-1_V12N28-333_A1,0,0,3,0,0,3
AATCGCGCAGAGGACT-1_V12N28-333_A1,1,1,1,0,1,4
AGGTTACACCATGCCG-1_V12N28-333_A1,0,3,1,0,1,5
CGAGATTTCGCTCGGG-1_V12N28-333_A1,0,0,2,0,0,2
CGATAATACTCAGGTT-1_V12N28-333_A1,0,0,5,0,0,5
AAGGCAGGCTGTCTCC-1_V12N28-333_A1,0,1,0,0,0,1
GTAAGTCCACACTCTA-1_V12N28-333_A1,0,1,2,0,0,3
ATGAGGGCAGCGGCTA-1_V12N28-333_A1,0,0,0,0,0,0
GCCGCACTCCGTTTCA-1_V12N28-333_A1,0,0,1,0,1,2
GAGCACGGCGCCTCTT-1_V12N28-333_A1,0,0,2,0,0,2
ACAATTTGGCCATATT-1_V12N28-333_A1,0,0,1,0,0,1
CTGGTTCGCGAGCTAC-1_V12N28-333_A1,0,0,1,0,0,1
GACGGTCCTAGGGTGT-1_V12N28-333_A1,0,1,1,0,1,3
ACTCGCGATCTGACGC-1_V12N28-333_A1,1,0,1,0,1,3
GTGTACGAACCGTTCC-1_V12N28-333_A1,0,1,2,0,0,3
CTTTGACGTCGCTTCT-1_V12N28-333_A1,3,3,0,0,0,6
CGTTATCATACTTCCA-1_V12N28-333_A1,3,1,1,0,0,5
GCTATGCCAGCTTATG-1_V12N28-333_A1,2,1,0,0,0,3
CAGTCGGCCTAGATAT-1_V12N28-333_A1,9,1,0,0,0,10
CCCGTGAGGGCGGTGA-1_V12N28-333_A1,2,0,0,0,0,2
TCTCGTGTTACGAGGA-1_V12N28-333_A1,1,0,0,0,0,1
ACGTCTCGTTCCGGGA-1_V12N28-333_A1,3,1,1,0,1,6
CGAGAGCGCGTAGATA-1_V12N28-333_A1,2,0,0,0,0,2
GACAGATTTCTGGCTC-1_V12N28-333_A1,0,1,0,0,0,1
GGGCCTAAATGGGCTA-1_V12N28-333_A1,2,0,3,0,0,5
ACTTGTAGTCCCTTCA-1_V12N28-333_A1,0,0,2,0,0,2
CCCGAAGTTTCGCGAA-1_V12N28-333_A1,0,0,4,0,0,4
ACCATCCGCCAACTAG-1_V12N28-333_A1,0,0,3,0,0,3
TGCGAATATGGGATTT-1_V12N28-333_A1,0,0,2,0,0,2
TACATCCCTATCCCTG-1_V12N28-333_A1,0,0,1,0,0,1
GTGGGAAGACTGAATC-1_V12N28-333_A1,0,0,2,0,0,2
TCAACATCGACCGAGA-1_V12N28-333_A1,0,0,0,0,0,0
CTATGTGAGTCACGGC-1_V12N28-333_A1,0,0,2,0,0,2
CCGAACACTGGGCCTC-1_V12N28-333_A1,0,0,2,0,0,2
AAACTTGCAAACGTAT-1_V12N28-333_A1,0,0,1,0,1,2
AGGGCGAGCAGCTGAT-1_V12N28-333_A1,0,0,1,0,0,1
AACACGAGACGCGGCC-1_V12N28-333_A1,0,0,1,0,0,1
TGACGAATATTTCCCT-1_V12N28-333_A1,0,1,3,0,0,4
TCGGAGAGTATCGGGA-1_V12N28-333_A1,0,0,2,0,1,3
CAAATCTCTCACAAGG-1_V12N28-333_A1,0,0,0,0,0,0
AGGCCCTAGAACGCCA-1_V12N28-333_A1,1,1,0,0,1,3
TAGAGATCATGCAACT-1_V12N28-333_A1,5,0,2,0,0,7
TTGTTTCCATACAACT-1_V12N28-333_A1,0,0,0,0,0,0
GAGAGGTGCATTCTGG-1_V12N28-333_A1,0,0,1,0,0,1
GTGGACCAACCCGATT-1_V12N28-333_A1,0,0,1,0,0,1
CTGGGCCTGCTATATC-1_V12N28-333_A1,0,0,1,0,0,1
CATAGTCCACAAGAAC-1_V12N28-333_A1,0,0,1,0,0,1
TTGACATGAACGTGGA-1_V12N28-333_A1,0,0,3,0,2,5
GGTTACCACCCTCGGG-1_V12N28-333_A1,0,0,0,0,0,0
TACCGGTCGTTTCCAT-1_V12N28-333_A1,1,0,2,0,0,3
CGAGTACTAAAGAGGA-1_V12N28-333_A1,0,1,7,0,0,8
GCAAGAATTCCTTGGC-1_V12N28-333_A1,0,0,1,0,0,1
TCGCCGAAGTTGCGTC-1_V12N28-333_A1,0,1,0,0,0,1
TTGAGAGTACTGCTAA-1_V12N28-333_A1,0,1,0,0,0,1
GCCACAATTTAAGGAC-1_V12N28-333_A1,0,1,1,0,0,2
ATATTCAGTTAAACCT-1_V12N28-333_A1,0,1,1,0,1,3
TGAGTGCCTCTTAAAT-1_V12N28-333_A1,0,0,0,0,0,0
ATCAGACGGCACGCCG-1_V12N28-333_A1,1,3,1,0,0,5
GTGCGAAATCGAACAC-1_V12N28-333_A1,1,0,0,0,0,1
GTGCCGCTTCAAAGGT-1_V12N28-333_A1,2,1,0,0,1,4
GATACGATGGGAGTCA-1_V12N28-333_A1,0,0,1,0,0,1
GACACTGAGTTCAGTG-1_V12N28-333_A1,0,0,1,0,0,1
ATCCTGCGTGGAATGG-1_V12N28-333_A1,0,0,0,0,0,0
ATCCTACCTAAGCTCT-1_V12N28-333_A1,0,0,1,0,0,1
AGTGATATGAGTAGTT-1_V12N28-333_A1,0,2,1,0,0,3
ATGATGCAATGGTACA-1_V12N28-333_A1,0,0,2,0,0,2
GAAACCGAATTACCTT-1_V12N28-333_A1,0,0,1,0,0,1
AGTGACCTACTTTACG-1_V12N28-333_A1,0,1,1,0,0,2
CAAATGTCCTTCCGTG-1_V12N28-333_A1,0,0,1,1,0,2
TTACTGGGATATTTCA-1_V12N28-333_A1,1,0,1,0,0,2
CTTGCCCAGGCTCTAC-1_V12N28-333_A1,0,0,3,0,0,3
AAATCGTGTACCACAA-1_V12N28-333_A1,0,0,1,0,0,1
GTGATCATAGATCTGC-1_V12N28-333_A1,0,3,4,0,0,7
TGGCAGATTACGATCA-1_V12N28-333_A1,0,0,2,0,0,2
TCACCCTCTTAAGATT-1_V12N28-333_A1,0,1,2,0,0,3
CTAAAGGGAAATAGGA-1_V12N28-333_A1,0,0,0,0,0,0
CCGCTATCAGCACCAG-1_V12N28-333_A1,0,0,1,0,0,1
CTTTAGTGCTATTATT-1_V12N28-333_A1,0,1,0,0,1,2
CGGGAATTTATGTAAA-1_V12N28-333_A1,0,0,3,0,1,4
TACGACTGCCTCTTAG-1_V12N28-333_A1,0,2,1,0,1,4
AAACTGCTGGCTCCAA-1_V12N28-333_A1,0,0,2,0,0,2
GTACGTTTGCCCGTCA-1_V12N28-333_A1,0,1,3,0,0,4
GGCAAGGCGAAATAGC-1_V12N28-333_A1,0,0,2,0,0,2
GATCTTGGAGGGCATA-1_V12N28-333_A1,0,1,1,0,0,2
AGCGTGGTATTCTACT-1_V12N28-333_A1,0,1,2,0,0,3
CTAAGGGAATGATTGG-1_V12N28-333_A1,0,1,1,0,0,2
CATGGTAAGTAGCGTT-1_V12N28-333_A1,0,3,2,0,1,6
CGTTGAGCGACCGTCG-1_V12N28-333_A1,1,3,1,0,0,5
TGCCCGTACCGTTAAA-1_V12N28-333_A1,0,1,1,0,1,3
ACAAGGGCAGGCTCTG-1_V12N28-333_A1,0,0,3,0,1,4
GAGATCTTCCATGACA-1_V12N28-333_A1,1,0,0,0,0,1
AATGACGTAGGATGTC-1_V12N28-333_A1,1,0,2,0,0,3
GTGGTGGCCAAGTGAA-1_V12N28-333_A1,0,0,1,1,0,2
TCCCGTGTGCAATTTG-1_V12N28-333_A1,0,0,0,0,1,1
ACATCGTATGCAATGG-1_V12N28-333_A1,0,1,2,0,1,4
GCGAAACTTAACTGGA-1_V12N28-333_A1,1,1,0,0,3,5
AATTGAACGCTCTGGT-1_V12N28-333_A1,0,0,1,0,0,1
ACAAATGGTAGTGTTT-1_V12N28-333_A1,0,0,6,0,0,6
ATGGTCGCGTGGTTTC-1_V12N28-333_A1,0,0,1,0,0,1
TGTTATTGTATGTGGC-1_V12N28-333_A1,0,2,0,0,1,3
TTCCGGTTACCCACTT-1_V12N28-333_A1,0,0,1,0,0,1
GAGTGTGCGGTACCCA-1_V12N28-333_A1,0,1,1,0,1,3
CAAGATATTATAACGT-1_V12N28-333_A1,0,0,4,0,1,5
ACACACCAGGACCAGT-1_V12N28-333_A1,0,0,1,0,0,1
ATGGGCCTCGGCCTCT-1_V12N28-333_A1,0,0,2,0,0,2
AAGGTGATAAACCAGC-1_V12N28-333_A1,0,0,3,0,0,3
TCTTACTTATGCCTCT-1_V12N28-333_A1,1,1,0,0,1,3
AAAGTGTGATTTATCT-1_V12N28-333_A1,0,0,1,0,1,2
TGCTCCACAGTTCTTA-1_V12N28-333_A1,0,1,1,0,1,3
CTGGCTGATTCATCCT-1_V12N28-333_A1,0,3,3,0,0,6
TAAGGCTGAATCCCTC-1_V12N28-333_A1,0,0,2,0,0,2
TCTAGTGATATCGTGG-1_V12N28-333_A1,0,1,4,0,0,5
TCGAAGAACCGAGCAC-1_V12N28-333_A1,0,0,3,0,1,4
GACAAACATATGCAGG-1_V12N28-333_A1,1,1,2,0,1,5
AAGTCAATTGTCGTCA-1_V12N28-333_A1,1,0,1,0,0,2
AGTGAACAAACTTCTC-1_V12N28-333_A1,0,1,1,0,0,2
CATGATGGAAGTTAGC-1_V12N28-333_A1,0,0,1,0,0,1
AAGTGCCTTGACTGTA-1_V12N28-333_A1,0,0,1,0,0,1
ATCGCCAGTCAACATT-1_V12N28-333_A1,0,0,1,0,0,1
ACCGCGGTGGAAGTCG-1_V12N28-333_A1,0,0,1,0,2,3
TCTTCTATAACCCGCC-1_V12N28-333_A1,0,2,0,0,0,2
CACATTTCTTGTCAGA-1_V12N28-333_A1,0,0,2,0,0,2
TAGCGTCCCTCGATTG-1_V12N28-333_A1,0,0,4,0,1,5
GTTCGGATCGGGAACA-1_V12N28-333_A1,0,1,0,0,1,2
CAAACTCGCGACGCCG-1_V12N28-333_A1,0,0,2,0,0,2
GTCTTGTAGCTATTCA-1_V12N28-333_A1,0,1,1,0,0,2
TCTCGACGTATCGCCG-1_V12N28-333_A1,0,1,3,0,0,4
TTGCCAAGCAGAACCC-1_V12N28-333_A1,0,0,0,0,1,1
AAACCCGAACGAAATC-1_V12N28-333_A1,0,1,0,0,0,1
TTGAGCAGCCCACGGT-1_V12N28-333_A1,0,1,1,0,0,2
CGCCTTTAGCATGCTC-1_V12N28-333_A1,0,0,0,0,0,0
TGTGGCTCCCACCAAC-1_V12N28-333_A1,0,0,2,0,0,2
CCGCCGTTGAGGATAA-1_V12N28-333_A1,0,1,1,0,1,3
CAATACGAGAGTCTGA-1_V12N28-333_A1,0,0,2,0,0,2
CATCTAGTGAAGGGAA-1_V12N28-333_A1,0,0,1,0,0,1
GGTGGAGGTTGATACG-1_V12N28-333_A1,0,0,2,0,0,2
CCGCACACGAACGTGT-1_V12N28-333_A1,0,2,2,0,0,4
AGAACCCAGCGTGACA-1_V12N28-333_A1,0,1,0,0,1,2
GCGCTCGATCACCTGT-1_V12N28-333_A1,0,1,2,0,0,3
ATCATGGACTACCGAC-1_V12N28-333_A1,0,1,3,0,0,4
TACGCCGCCTCAGAAG-1_V12N28-333_A1,0,1,1,0,1,3
CGACCTACTAGACAAT-1_V12N28-333_A1,2,6,4,0,0,12
GAGTCTTGTAAAGGAC-1_V12N28-333_A1,0,5,0,0,0,5
AATATCCTAGCAAACT-1_V12N28-333_A1,0,3,1,0,0,4
CCCTAGGCAACAAGAG-1_V12N28-333_A1,6,0,0,0,0,6
ACAAAGAAGGTAGGCC-1_V12N28-333_A1,2,0,0,0,0,2
CCCTGGCTGTTCCTTC-1_V12N28-333_A1,0,0,0,0,0,0
TCGCCGCACCGCGTGA-1_V12N28-333_A1,1,0,0,0,0,1
TATAGCGCACGTTATC-1_V12N28-333_A1,1,1,0,0,0,2
TTATCTGACATTAGGA-1_V12N28-333_A1,1,0,1,0,0,2
AGTGGTGTTACCCGTG-1_V12N28-333_A1,3,0,0,0,1,4
GCCAAGAATACTTCTG-1_V12N28-333_A1,0,1,3,0,1,5
CCGGCGTGAGACTCTG-1_V12N28-333_A1,0,2,3,0,0,5
TTCCCGGCGCCAATAG-1_V12N28-333_A1,1,0,2,0,1,4
AAACAGGGTCTATATT-1_V12N28-333_A1,0,0,3,0,0,3
ACAGTAATACAACTTG-1_V12N28-333_A1,0,0,3,0,1,4
CGAACGGCCGGACAAC-1_V12N28-333_A1,0,0,2,0,0,2
GCAACACACTAGAACT-1_V12N28-333_A1,0,0,4,0,0,4
ACTCCCATTCCTAAAG-1_V12N28-333_A1,0,0,2,0,0,2
ACCTGCGTGTCATGTT-1_V12N28-333_A1,0,0,1,0,1,2
TACTTTCCGCACGCCA-1_V12N28-333_A1,0,0,3,0,0,3
AGGTCAGGTGAGAGTG-1_V12N28-333_A1,0,0,0,0,0,0
TCCTCCTAAGACATTC-1_V12N28-333_A1,0,0,2,0,0,2
ATGTGAAAGCCTAATG-1_V12N28-333_A1,0,1,2,0,0,3
AGTCGGCTCAACTTTA-1_V12N28-333_A1,0,0,2,0,0,2
CGATCTGTTGGAGGAC-1_V12N28-333_A1,0,0,0,0,1,1
ACGGGAGTGTCGGCCC-1_V12N28-333_A1,0,1,3,0,1,5
TTAACTTCAGGTAGGA-1_V12N28-333_A1,0,0,0,0,0,0
CCACGGAGCCATAAGA-1_V12N28-333_A1,0,0,2,0,0,2
CTTCTATGTTGAAGTA-1_V12N28-333_A1,0,0,4,0,0,4
CACCGTTGCGCGATAT-1_V12N28-333_A1,1,0,2,0,1,4
TCTAGCAATCTCCGCC-1_V12N28-333_A1,0,0,0,0,0,0
AGTTTGGCCAGACCTA-1_V12N28-333_A1,0,0,0,0,3,3
TTGTAAGGACCTAAGT-1_V12N28-333_A1,0,0,2,0,0,2
AAATTTGCGGGTGTGG-1_V12N28-333_A1,0,1,2,0,1,4
AAGTTCGGCCAACAGG-1_V12N28-333_A1,2,0,1,0,0,3
CCGCTTACCTCACTCT-1_V12N28-333_A1,0,0,0,0,0,0
ATCACGTGCTAATTAA-1_V12N28-333_A1,0,0,3,0,0,3
GGTGAAGTACAGGGAT-1_V12N28-333_A1,0,0,0,0,0,0
GCTGTATTACTGGCCC-1_V12N28-333_A1,3,0,0,0,1,4
AACGGCCATCTCCGGT-1_V12N28-333_A1,0,0,0,0,0,0
TAAGTAACATCTTGAC-1_V12N28-333_A1,0,0,0,0,0,0
TTCTTGAGCCGCGCTA-1_V12N28-333_A1,0,0,0,0,0,0
AGTGCGTAGCTCGTAA-1_V12N28-333_A1,0,0,0,0,0,0
GGGATGGTCGTAACCG-1_V12N28-333_A1,1,0,1,0,0,2
GTCTGGGCGGTCGAGA-1_V12N28-333_A1,0,0,2,0,0,2
CGGAACGTAAACATAG-1_V12N28-333_A1,0,0,2,0,0,2
TGCGACACCCTAGTGC-1_V12N28-333_A1,0,0,2,0,0,2
CAAACGAGTATCGCAG-1_V12N28-333_A1,0,0,2,0,1,3
TCAGTAGGGACTATAA-1_V12N28-333_A1,0,0,2,0,0,2
GCGGTTCCCTATCATG-1_V12N28-333_A1,0,2,1,0,0,3
GTGACTTCAGTAGTGC-1_V12N28-333_A1,0,0,2,0,0,2
CGTCACGTCCATTGGT-1_V12N28-333_A1,0,0,0,0,1,1
ATAAGTTACCGCGACG-1_V12N28-333_A1,0,0,0,0,1,1
CTGAATCCGAGACCTC-1_V12N28-333_A1,0,0,5,0,0,5
TACGACGCTTGCTGCG-1_V12N28-333_A1,0,0,0,0,0,0
GGCGCGTTCGAGTTTA-1_V12N28-333_A1,0,2,2,0,0,4
ATTCATATACTGTCCA-1_V12N28-333_A1,0,0,0,0,0,0
ATAAACGGACCCGTAA-1_V12N28-333_A1,0,0,2,0,0,2
GTCGTACCATCTCGGG-1_V12N28-333_A1,0,1,0,0,0,1
ATAATAGCTGTTGAAT-1_V12N28-333_A1,0,1,0,0,0,1
TTCCGCGTGAGGCGAT-1_V12N28-333_A1,0,1,1,0,0,2
TACCGGCTCACTGCCC-1_V12N28-333_A1,0,0,0,0,0,0
GTATCTTTCATAACCA-1_V12N28-333_A1,0,0,2,0,0,2
GTTACCTACAACTTGC-1_V12N28-333_A1,0,2,1,0,0,3
TGACTATAATCCTTTC-1_V12N28-333_A1,0,1,0,0,0,1
AAATACCTATAAGCAT-1_V12N28-333_A1,0,2,3,0,0,5
TTATTAGAGCGTGTTC-1_V12N28-333_A1,0,0,1,0,0,1
ATGTGGACATCTTGAT-1_V12N28-333_A1,0,1,3,0,0,4
GTACGCTTCATTGCAC-1_V12N28-333_A1,0,0,4,0,0,4
CACATATTAGCAGGAT-1_V12N28-333_A1,0,1,3,0,0,4
CAAGAGGGCGGAGTAC-1_V12N28-333_A1,0,0,3,0,1,4
TCGCAAAGATGCATTT-1_V12N28-333_A1,0,0,1,0,0,1
GTCGTTATTCGCTTAT-1_V12N28-333_A1,0,0,0,0,0,0
TCGTGTACTATGGATG-1_V12N28-333_A1,0,0,2,0,0,2
GCGGAGAGGGAGAACG-1_V12N28-333_A1,1,0,2,0,2,5
TCACAGGGAATCGCAA-1_V12N28-333_A1,0,1,1,0,1,3
GACTGCACCAGCCCAG-1_V12N28-333_A1,0,1,0,1,0,2
TCCGCTGTCATCCCGG-1_V12N28-333_A1,0,1,1,0,0,2
AGATACTCAAGATCGA-1_V12N28-333_A1,0,0,5,0,1,6
ACTGAATGGCGAAAGT-1_V12N28-333_A1,0,0,0,0,0,0
TCCTACATCCACGGCC-1_V12N28-333_A1,0,3,3,0,0,6
TTCAGCCCTGGTCCAC-1_V12N28-333_A1,2,2,0,0,1,5
TTAGAGTTTAGAAGGA-1_V12N28-333_A1,0,1,4,0,0,5
GGTTAGCTATATGTCT-1_V12N28-333_A1,0,0,2,0,0,2
CTGGTTTCGAGCAAGA-1_V12N28-333_A1,0,0,1,0,2,3
TGGGCCCATACTAATT-1_V12N28-333_A1,0,0,3,0,0,3
ACTTATTTATGTGCCA-1_V12N28-333_A1,0,0,5,0,1,6
TTAGTTATTCGTGGCA-1_V12N28-333_A1,0,0,2,0,0,2
AACCGCTAAGGGATGC-1_V12N28-333_A1,2,0,1,0,0,3
ATACGTCCACTCCTGT-1_V12N28-333_A1,0,1,1,0,0,2
CGACACGCTCCGACAG-1_V12N28-333_A1,0,0,1,0,0,1
TCTGAACTCGTACCCG-1_V12N28-333_A1,0,0,0,0,0,0
AGGATATAGGGATTTA-1_V12N28-333_A1,0,1,1,0,2,4
GTGATCACTAACGCCT-1_V12N28-333_A1,0,0,1,0,0,1
ACCGGGCCTTTGTTGA-1_V12N28-333_A1,0,1,0,0,0,1
TTGACAGGAGCTCCCG-1_V12N28-333_A1,0,1,1,0,1,3
CTCTTCTATTGACTGG-1_V12N28-333_A1,0,1,1,0,0,2
CGTGGCCGAATATCTA-1_V12N28-333_A1,0,0,0,0,1,1
GGTTTAGCCTTTCTTG-1_V12N28-333_A1,0,1,2,0,0,3
TCAAGGTTACTACACC-1_V12N28-333_A1,0,0,1,0,0,1
TTGACTATTGTCCGGC-1_V12N28-333_A1,0,0,4,0,0,4
CGGGAATATAGTATAC-1_V12N28-333_A1,0,0,2,0,0,2
GCAACAGCAGTATGCG-1_V12N28-333_A1,0,0,1,0,1,2
ATCAAACACTGTTCCA-1_V12N28-333_A1,0,0,2,0,0,2
TGGGCAATAGTTGGGT-1_V12N28-333_A1,0,1,0,0,2,3
TGAATGTCAGCCGGCC-1_V12N28-333_A1,0,0,0,0,0,0
CGGCTCTAAAGCTGCA-1_V12N28-333_A1,0,0,1,0,0,1
GGACACAAGTTTACAC-1_V12N28-333_A1,0,0,0,0,0,0
CCGAGAAGTCGCATAA-1_V12N28-333_A1,0,0,0,0,1,1
AACTACCCGTTTGTCA-1_V12N28-333_A1,0,2,1,0,2,5
GCACAAACGAGGCGTG-1_V12N28-333_A1,2,1,4,0,0,7
CACACAGCTTGCGCTC-1_V12N28-333_A1,0,0,2,0,0,2
GTGCTTACATCAGCGC-1_V12N28-333_A1,0,0,2,0,0,2
GCAAACGTCGCCAGGT-1_V12N28-333_A1,0,0,2,0,0,2
GAATAGCATTTAGGGT-1_V12N28-333_A1,1,0,4,0,0,5
TACTGTTTCTCTGGTA-1_V12N28-333_A1,0,0,1,0,1,2
TCCTATCATAGGTAAC-1_V12N28-333_A1,0,1,2,0,0,3
TTCGGTGGAGACGCCC-1_V12N28-333_A1,2,1,1,0,0,4
TGTTGCCGTCGTCCCA-1_V12N28-333_A1,0,0,0,0,0,0
CCAACTTGATAGATCC-1_V12N28-333_A1,0,0,0,0,0,0
CAAAGGTCATCTGAAA-1_V12N28-333_A1,0,2,3,0,0,5
CTAGCTTAATGGTCCC-1_V12N28-333_A1,0,2,1,0,2,5
AGGCCACATTGGTTAC-1_V12N28-333_A1,0,1,2,0,0,3
TTAGGATGGGAGGGTA-1_V12N28-333_A1,0,0,3,0,2,5
TATGACCTTGCGCTGG-1_V12N28-333_A1,0,2,0,0,0,2
ATATACATGTATGGTA-1_V12N28-333_A1,0,2,5,0,0,7
TGTGTGACCATGAATC-1_V12N28-333_A1,2,3,0,0,0,5
CCCACTCCACGGTATC-1_V12N28-333_A1,4,0,0,0,0,4
GGGCAGACGTCACTGC-1_V12N28-333_A1,9,0,0,0,0,9
TCAAAGAGCTATCTGT-1_V12N28-333_A1,6,2,0,0,0,8
AGATGCATCCTGTGTC-1_V12N28-333_A1,1,0,0,0,0,1
GTGAAGTCACGACTCG-1_V12N28-333_A1,2,0,0,0,0,2
TGATTCAGGTCCCGCG-1_V12N28-333_A1,4,0,2,0,0,6
CGCCACAGGTCGCGAT-1_V12N28-333_A1,3,0,1,0,0,4
TTGAATCGTTGTATAA-1_V12N28-333_A1,2,0,0,0,2,4
TGGCCAATTTGGTACT-1_V12N28-333_A1,4,0,0,0,1,5
CGACCCTTAACGCCGG-1_V12N28-333_A1,0,0,1,0,0,1
TCGGCGTACTGCACAA-1_V12N28-333_A1,2,0,0,0,0,2
GAGTAAGGCCACGGGA-1_V12N28-333_A1,0,0,1,0,0,1
ATCAGCTCGTCCACTA-1_V12N28-333_A1,0,0,1,0,0,1
AGGATCACGCGATCTG-1_V12N28-333_A1,2,1,5,0,0,8
AAATGGCCCGTGCCCT-1_V12N28-333_A1,0,0,2,0,1,3
CAGTACCAGTTTACGT-1_V12N28-333_A1,2,0,0,0,0,2
GGTCGTAAGCTCGCAC-1_V12N28-333_A1,0,0,1,0,0,1
CGTTCATGGTGCGCGT-1_V12N28-333_A1,0,0,1,0,0,1
GACTACAAAGCGGTGG-1_V12N28-333_A1,0,0,6,0,0,6
CAGCTGGCGTAACCGT-1_V12N28-333_A1,0,0,1,0,0,1
ACTCGTAACCCGTCCT-1_V12N28-333_A1,0,0,1,0,1,2
CATATGTCAGGCTACG-1_V12N28-333_A1,0,0,1,0,0,1
GCCCGACTTCTTCCCG-1_V12N28-333_A1,0,1,3,0,1,5
CTGGCATCCGAATGAG-1_V12N28-333_A1,0,0,0,0,1,1
AAGTGCGTTAGAATCT-1_V12N28-333_A1,0,0,0,0,0,0
AGAAGTGATTCGTGAT-1_V12N28-333_A1,0,1,2,0,1,4
TACCTTAAGATTTCCC-1_V12N28-333_A1,0,0,2,0,0,2
AATGACAGCAATGTCT-1_V12N28-333_A1,0,1,2,0,1,4
TCAACGCAGGAAATAA-1_V12N28-333_A1,0,0,2,0,1,3
TATTCCTCCGCCCACT-1_V12N28-333_A1,0,0,0,0,1,1
ATCAAACGAAGGTTTG-1_V12N28-333_A1,0,0,2,0,2,4
TTGATTAGCTGTTTCT-1_V12N28-333_A1,0,0,1,0,0,1
CTGCTGAGGCCACGAA-1_V12N28-333_A1,0,0,0,0,1,1
CCGTGTTAAATTCCAT-1_V12N28-333_A1,0,0,2,0,1,3
CACGTCGGCAACCTCT-1_V12N28-333_A1,4,0,0,0,0,4
GTATTCTGAGAAACGA-1_V12N28-333_A1,0,0,0,0,0,0
CGGTGCGCGTTGGTCC-1_V12N28-333_A1,1,0,0,0,0,1
GTGATTCGCCGCTCAA-1_V12N28-333_A1,0,0,0,0,0,0
GCCCGCGCGTAAACGG-1_V12N28-333_A1,0,2,3,0,1,6
AACGTACTGTGGGTAC-1_V12N28-333_A1,0,0,1,0,3,4
GAGTATGCCCGCCTTG-1_V12N28-333_A1,0,0,1,0,2,3
TGATTCTGTCGCCGGT-1_V12N28-333_A1,0,2,0,0,0,2
GGGCGGCAAATGAATT-1_V12N28-333_A1,0,2,0,0,0,2
TTCCAATCTGGCTATC-1_V12N28-333_A1,0,0,3,0,1,4
GGAACCGTGTAAATTG-1_V12N28-333_A1,0,0,1,0,0,1
TTGGTCACACTCGTAA-1_V12N28-333_A1,1,1,2,0,0,4
CGAACCCGCATGCGTC-1_V12N28-333_A1,0,0,1,0,0,1
GGGCGTCACCACGTAA-1_V12N28-333_A1,0,3,1,0,1,5
TACCAGAAGTAGGTTC-1_V12N28-333_A1,0,0,2,0,0,2
TTGGATATCGTCTACG-1_V12N28-333_A1,0,0,2,0,0,2
TATTCCACTCAGCTCG-1_V12N28-333_A1,0,0,0,0,0,0
CTGTTACCCAATCTAG-1_V12N28-333_A1,0,2,2,0,0,4
ACGCGAAGTCAGACGA-1_V12N28-333_A1,0,2,2,0,1,5
GATAGGTAACGTTGAC-1_V12N28-333_A1,0,0,0,0,0,0
TGTTCGTATTGCGGTG-1_V12N28-333_A1,0,0,3,0,2,5
GGTCAGTGGGTCCCAC-1_V12N28-333_A1,0,0,4,0,0,4
AATTCTAGAGTTAGGC-1_V12N28-333_A1,0,0,2,0,0,2
GTTTACGTTCCATCTG-1_V12N28-333_A1,0,2,4,0,0,6
AGACCCACCGCTGATC-1_V12N28-333_A1,0,0,2,0,0,2
TCTAGCATGCCCAGAA-1_V12N28-333_A1,0,0,4,0,0,4
CCCGCAGCGCGAACTA-1_V12N28-333_A1,0,0,1,0,0,1
CTCTATTTGGCTGCAG-1_V12N28-333_A1,0,1,1,0,2,4
TTCTGCCGCGCCTAGA-1_V12N28-333_A1,0,0,4,0,0,4
ACTCCCTAGAATAGTA-1_V12N28-333_A1,0,2,2,0,0,4
CCGAACCTTCCCGGCC-1_V12N28-333_A1,0,1,3,0,0,4
TCAGACGCTATAGAAG-1_V12N28-333_A1,0,0,1,0,1,2
CAGGCGCCATGCTAGG-1_V12N28-333_A1,0,0,0,0,0,0
CACTCGAGCTGAACAA-1_V12N28-333_A1,0,3,2,0,0,5
ACAAGGAAATCCGCCC-1_V12N28-333_A1,0,0,0,0,1,1
ACCACGTGCAGCTATA-1_V12N28-333_A1,0,0,8,0,0,8
ACGGCGACGATGGGAA-1_V12N28-333_A1,0,0,3,0,0,3
TTACTAAAGGACTTTA-1_V12N28-333_A1,0,1,1,0,0,2
GGCTGAAATAGCAAAG-1_V12N28-333_A1,0,0,1,0,0,1
TTAGACGAGTCACCTC-1_V12N28-333_A1,0,1,3,0,0,4
GTAGTCGCGGGAATCA-1_V12N28-333_A1,0,0,1,0,0,1
GCAAACCCTACATTAT-1_V12N28-333_A1,0,1,4,0,0,5
GTTAAAGTAGGACTGG-1_V12N28-333_A1,0,0,1,0,0,1
ACCCTCCCTTGCTATT-1_V12N28-333_A1,0,1,0,0,0,1
CATGTCTCATTTATGG-1_V12N28-333_A1,0,0,5,0,1,6
AATAGAATCTGTTTCA-1_V12N28-333_A1,0,1,3,0,0,4
TCTCATGAGATAGGGT-1_V12N28-333_A1,0,0,1,0,1,2
ATGACTATGCGACATT-1_V12N28-333_A1,0,0,1,0,2,3
CCTAACCCAAACAAGT-1_V12N28-333_A1,0,0,1,0,0,1
AGTCAAGATGACACTT-1_V12N28-333_A1,0,1,0,0,0,1
CGGGAGCTTCAGTGTA-1_V12N28-333_A1,0,0,1,0,0,1
CCACAGTACCCATCCT-1_V12N28-333_A1,0,1,4,0,0,5
GAGCGCGCACGAGTAG-1_V12N28-333_A1,0,0,4,0,0,4
ACCAGTGCGGGAGACG-1_V12N28-333_A1,0,1,3,0,0,4
TCCTTACGACGGTCCG-1_V12N28-333_A1,0,0,5,0,0,5
TAGTCGATCACGGGTT-1_V12N28-333_A1,0,0,1,0,2,3
AGACGAAGTGCCGGTC-1_V12N28-333_A1,0,0,0,0,0,0
CGCTGGTGACTACCCT-1_V12N28-333_A1,1,3,1,0,0,5
AGGCATTGTCGTAGGG-1_V12N28-333_A1,1,1,2,0,0,4
TGGTAGAATATATGGG-1_V12N28-333_A1,0,1,3,0,1,5
TTCTTATCCGCTGGGT-1_V12N28-333_A1,0,0,1,0,0,1
AGTTTGGCACGGGTTG-1_V12N28-333_A1,1,1,1,0,2,5
GCATCGGCCGTGTAGG-1_V12N28-333_A1,0,0,2,0,2,4
ATGCGAGTCCCACCAC-1_V12N28-333_A1,0,1,2,0,1,4
TCGGCGAACCCAAACC-1_V12N28-333_A1,0,1,1,0,2,4
AGAGTAAACTTCACTA-1_V12N28-333_A1,0,0,1,0,0,1
AAGCCGAAGCGGTTTA-1_V12N28-333_A1,0,0,1,0,0,1
CCCGAGTTTCTCCGTA-1_V12N28-333_A1,0,2,1,0,1,4
AATATCGAATCAATGC-1_V12N28-333_A1,0,0,0,0,0,0
GCGCCTCCCACTCCGA-1_V12N28-333_A1,0,1,1,0,1,3
CGTTAAACTAGTTAGG-1_V12N28-333_A1,0,1,1,0,0,2
TGAGTTAAAGACATTC-1_V12N28-333_A1,0,3,0,0,1,4
AACAGGTAGTATGGAT-1_V12N28-333_A1,0,1,0,0,0,1
GAACGCGGGTCACACG-1_V12N28-333_A1,0,1,2,0,2,5
TGTTTGAGATCGTCAG-1_V12N28-333_A1,0,1,2,0,1,4
ATCTCGTGAGCGAAAC-1_V12N28-333_A1,0,1,1,0,0,2
CTGAGAAAGTTCGGCG-1_V12N28-333_A1,0,0,1,0,0,1
ATTACCACACTGCCTG-1_V12N28-333_A1,1,2,0,0,1,4
CTGCTGTCTAACGAGC-1_V12N28-333_A1,0,0,2,0,1,3
CGTGGAAGCCTCGTAC-1_V12N28-333_A1,0,1,1,1,0,3
GGACTCACAAATTAGG-1_V12N28-333_A1,0,0,0,0,0,0
CTTTGCTGTCATGGAT-1_V12N28-333_A1,1,0,1,0,0,2
GGTGTTGGGCGTCTTA-1_V12N28-333_A1,1,1,4,0,0,6
TACCATGTATTGATTT-1_V12N28-333_A1,0,0,1,0,0,1
GGTCTCCAAGTAGTGC-1_V12N28-333_A1,0,2,3,0,0,5
ATCCTTCTGAAAGAAC-1_V12N28-333_A1,0,0,1,0,1,2
CCGGAAGTTATCAGTC-1_V12N28-333_A1,0,1,1,0,0,2
TTAGAGGGATATACAG-1_V12N28-333_A1,0,3,3,1,0,7
TTGTACACCTCGAACA-1_V12N28-333_A1,0,4,6,0,0,10
GTGGGTACTGAGCGTA-1_V12N28-333_A1,1,2,1,0,0,4
CTTAAGCAGCGAGCCG-1_V12N28-333_A1,1,3,4,0,0,8
GCATTGACTTGCGGAA-1_V12N28-333_A1,6,1,2,0,0,9
CCATAACCTGTGCAGT-1_V12N28-333_A1,5,1,1,0,0,7
GGGCTACTATTTCGTG-1_V12N28-333_A1,1,0,0,0,0,1
GGAGACCATCTACATA-1_V12N28-333_A1,0,0,0,0,0,0
AGACCAAACCACACCT-1_V12N28-333_A1,0,0,0,0,0,0
CGACGCATCCGTACCT-1_V12N28-333_A1,3,0,1,0,2,6
CCTAGGTAAAGGTAGC-1_V12N28-333_A1,1,0,0,0,0,1
AGCGGCGGTTAGCGGT-1_V12N28-333_A1,2,0,1,0,0,3
CTGGACGCAGTCCGGC-1_V12N28-333_A1,4,2,2,0,0,8
AGCCTAATACCCACGT-1_V12N28-333_A1,2,0,5,0,0,7
AATCTGGCTTTCTAGT-1_V12N28-333_A1,0,0,5,0,0,5
CACCCTTGGTGAGACC-1_V12N28-333_A1,1,0,3,0,1,5
GGATCTTGACTCAACC-1_V12N28-333_A1,0,1,1,0,1,3
ACGAGGATACCACTCT-1_V12N28-333_A1,0,0,5,0,0,5
GAGTTGATGGCAATTT-1_V12N28-333_A1,0,0,2,0,0,2
GTGGCAAACAGCGGCA-1_V12N28-333_A1,0,0,8,0,0,8
GATGTAACGAACCACC-1_V12N28-333_A1,0,0,1,0,0,1
AGCCGTGGCTAAATGT-1_V12N28-333_A1,0,0,0,0,0,0
CTCCCTCCTTTCGATC-1_V12N28-333_A1,0,1,2,0,1,4
TTGGAAGAATACAGTC-1_V12N28-333_A1,0,1,3,0,1,5
AGTTAAGTCAACCGCT-1_V12N28-333_A1,0,0,3,0,1,4
CTCATGGTAATTTGCG-1_V12N28-333_A1,0,0,1,0,0,1
AAAGTAGCATTGCTCA-1_V12N28-333_A1,0,0,2,0,0,2
TTGTGGTAGGAGGGAT-1_V12N28-333_A1,0,0,3,0,0,3
AGTCGTGGGCATTACG-1_V12N28-333_A1,0,0,2,0,1,3
ACCTAAGTACCTTTCA-1_V12N28-333_A1,4,1,0,0,0,5
GTAGAGGGAGACAAGT-1_V12N28-333_A1,5,2,1,0,1,9
GATCCTCGACACTGGC-1_V12N28-333_A1,0,0,0,0,2,2
CCTACATTCACAGACG-1_V12N28-333_A1,1,0,0,0,3,4
TTGACCGTGTTAATGA-1_V12N28-333_A1,1,2,1,0,0,4
TCTGTTACCCAGCATA-1_V12N28-333_A1,1,0,0,0,2,3
CTAACTGGTCCGGTTC-1_V12N28-333_A1,0,0,0,0,0,0
AGCGACAGGAACGGTC-1_V12N28-333_A1,1,0,0,0,0,1
TAATAGAACAGAGTTA-1_V12N28-333_A1,0,1,1,0,0,2
ACAGGTGGAGGTGAGG-1_V12N28-333_A1,0,1,2,0,2,5
TGCGAGAATATTACCC-1_V12N28-333_A1,3,1,3,0,0,7
TTGCGTCGGCCAACCG-1_V12N28-333_A1,0,0,0,0,2,2
AGGCTTCCCGAAGAAG-1_V12N28-333_A1,0,0,1,0,3,4
GCGGACCGCGTTGTGG-1_V12N28-333_A1,0,1,1,0,0,2
GTAATCTGATTCTTCG-1_V12N28-333_A1,0,2,3,0,0,5
CCGCGGAATGCGTCAC-1_V12N28-333_A1,1,0,1,0,1,3
TTCCACACAGATTTGA-1_V12N28-333_A1,0,0,1,0,1,2
CTTCTATTAATGCTAG-1_V12N28-333_A1,0,0,0,0,2,2
CATTTGAGTGGTACGT-1_V12N28-333_A1,0,0,1,0,0,1
TCACAGCAAACTCGAA-1_V12N28-333_A1,0,0,1,0,0,1
CAGACGAACCTGATAC-1_V12N28-333_A1,0,1,1,0,0,2
TGGCGATCAAGTTATG-1_V12N28-333_A1,0,0,0,0,0,0
CCCTTTGACAGGTCTT-1_V12N28-333_A1,0,0,0,0,0,0
CAGAGACGGTCACCCA-1_V12N28-333_A1,0,0,2,0,0,2
TAGCTCGCCTGATAAC-1_V12N28-333_A1,0,0,6,0,1,7
TTGTGTTTCCCGAAAG-1_V12N28-333_A1,1,0,4,0,1,6
TATACACAGACGCCTT-1_V12N28-333_A1,0,0,1,0,0,1
ACATTAGTTTATATCC-1_V12N28-333_A1,0,0,2,0,0,2
CCATCGCAGTTAAACT-1_V12N28-333_A1,0,1,2,0,0,3
AATTAGCGCTGCAGCG-1_V12N28-333_A1,0,1,0,0,0,1
TCCGCTTATCCCATTA-1_V12N28-333_A1,0,1,2,0,0,3
GTTTGGGCTTGTGAGC-1_V12N28-333_A1,0,0,1,0,0,1
CTTGTCAACATTCGAG-1_V12N28-333_A1,0,2,1,0,0,3
GGACCAACAGGATAAC-1_V12N28-333_A1,0,1,1,0,0,2
AAGCTAGATCGAGTAA-1_V12N28-333_A1,0,0,3,0,0,3
TACCGTGCCTCGGACC-1_V12N28-333_A1,0,3,4,0,0,7
GTAGCCAAACATGGGA-1_V12N28-333_A1,0,1,7,0,0,8
TGCCAGTACGTGGAGA-1_V12N28-333_A1,0,0,2,0,0,2
ATAAGGTGGAGAACAT-1_V12N28-333_A1,0,2,3,0,0,5
CTTTAATATTGGTCGA-1_V12N28-333_A1,0,0,0,0,1,1
TGGTTCAACGGGTAAT-1_V12N28-333_A1,0,0,3,0,1,4
GCTGCTACTGCGTAGC-1_V12N28-333_A1,0,0,1,0,0,1
CTGCACAACTACATAT-1_V12N28-333_A1,0,1,2,0,2,5
ATATTCCACATAGTGA-1_V12N28-333_A1,0,0,1,0,0,1
TGGCAAACTAAATTAC-1_V12N28-333_A1,0,1,1,0,0,2
ACCGCAATAACTGCCT-1_V12N28-333_A1,0,0,3,0,0,3
TCGCACCAGGAGGCAG-1_V12N28-333_A1,0,0,1,0,1,2
ACTTCAGGCTGATCCC-1_V12N28-333_A1,0,1,5,0,0,6
ACAAATCGCACCGAAT-1_V12N28-333_A1,0,0,1,0,0,1
TCTGATGTATTCTGTC-1_V12N28-333_A1,0,0,2,0,1,3
CTTTACCGAATAGTAG-1_V12N28-333_A1,1,3,3,0,0,7
GCAGATCCATAAGACT-1_V12N28-333_A1,0,0,4,0,0,4
TTCCTCGGACTAACCA-1_V12N28-333_A1,0,2,0,0,0,2
TTATCCGGGATCTATA-1_V12N28-333_A1,0,1,3,0,0,4
CTGGAAGACACGGTGG-1_V12N28-333_A1,0,1,0,0,1,2
GTTCGTCTAAAGAACT-1_V12N28-333_A1,0,0,4,0,1,5
GTCTATTGGTTCCGGT-1_V12N28-333_A1,0,2,3,0,0,5
CTAGGCGCCCTATCAG-1_V12N28-333_A1,0,1,1,0,0,2
AACGGACGTACGTATA-1_V12N28-333_A1,0,0,1,0,0,1
AACACACGCTCGCCGC-1_V12N28-333_A1,0,0,1,0,0,1
GCTACTATAGTAGAGT-1_V12N28-333_A1,0,1,2,0,1,4
AGCATATCAATATGCT-1_V12N28-333_A1,0,3,2,0,0,5
CGAACAGTATGGGCGT-1_V12N28-333_A1,0,0,2,0,0,2
ACAATTGTGTCTCTTT-1_V12N28-333_A1,0,0,2,0,0,2
GATCGCTACCCGATTT-1_V12N28-333_A1,0,0,2,0,0,2
ATTGCGATCAGTAACT-1_V12N28-333_A1,0,0,2,0,0,2
CAGCAGTCCAGACTAT-1_V12N28-333_A1,0,0,1,0,0,1
AGAGGCTTCGGAAACC-1_V12N28-333_A1,0,0,1,0,0,1
AAACAAGTATCTCCCA-1_V12N28-333_A1,0,0,1,0,0,1
GGCAGCAAACCTATGC-1_V12N28-333_A1,0,2,1,0,0,3
ACTAGTTGCGATCGTC-1_V12N28-333_A1,0,0,1,0,0,1
TTGGACCATCTGGCAA-1_V12N28-333_A1,0,0,1,0,0,1
CCCTCCTCGCTCGTAT-1_V12N28-333_A1,0,1,0,0,0,1
GAGCGCAAATACTCCG-1_V12N28-333_A1,1,3,4,0,0,8
ATTACATGTCAGTCTT-1_V12N28-333_A1,0,2,2,0,0,4
TTGGGACGTAAGAGTT-1_V12N28-333_A1,0,0,1,0,0,1
CTTCGGCCAATTGTTT-1_V12N28-333_A1,0,0,0,0,0,0
AGACCGCTCCGCGGTT-1_V12N28-333_A1,0,1,1,0,0,2
GACCGCGTCTGACGTG-1_V12N28-333_A1,0,0,1,0,1,2
CCAAATAACAAGATTC-1_V12N28-333_A1,0,0,1,0,0,1
TCTTTAGAGTCTAACA-1_V12N28-333_A1,0,0,2,0,2,4
CTCCCAATGAGTCGCG-1_V12N28-333_A1,0,0,2,0,0,2
TAGTCTTTCCGAATTG-1_V12N28-333_A1,0,0,5,0,0,5
GAGTAAACCGGAAAGT-1_V12N28-333_A1,0,1,0,0,0,1
GATCTCGACGCTGTGG-1_V12N28-333_A1,0,0,2,0,1,3
CTGACATAGAAATAGA-1_V12N28-333_A1,0,0,4,0,0,4
TATACCGAGTGCCACA-1_V12N28-333_A1,0,0,3,0,0,3
TCCGAACGTTGCCGCT-1_V12N28-333_A1,0,0,1,0,0,1
GCAGAAGGTAATCTCC-1_V12N28-333_A1,0,0,0,0,2,2
GGTACTAAGTGCTTTG-1_V12N28-333_A1,0,0,1,0,1,2
CAGAATATTCGTTATC-1_V12N28-333_A1,1,1,1,0,2,5
TAATCAACCAAATGGG-1_V12N28-333_A1,0,0,3,0,1,4
TCTGCTTAGAACAAGC-1_V12N28-333_A1,0,0,2,0,0,2
AACTGAGTTATACTGA-1_V12N28-333_A1,0,1,0,0,0,1
CCTCAACGATCGCTGT-1_V12N28-333_A1,0,1,2,1,0,4
CGGTACGGCAAACCCA-1_V12N28-333_A1,0,4,2,0,0,6
CAGATGTTTGTCCCAA-1_V12N28-333_A1,0,0,2,0,0,2
GTTTGTTAGCCAAGTA-1_V12N28-333_A1,0,0,4,0,0,4
ACGTGACAAAGTAAGT-1_V12N28-333_A1,0,2,3,0,0,5
TTGTCACCGCGGTATC-1_V12N28-333_A1,3,3,3,0,0,9
GATCTAACCGTATTCA-1_V12N28-333_A1,9,1,0,0,0,10
ATGGAAATTTAAGGAG-1_V12N28-333_A1,0,0,0,0,0,0
TCTAAAGAACAGTCTC-1_V12N28-333_A1,0,0,0,0,0,0
CTGGGTTGAGTTAAAG-1_V12N28-333_A1,4,0,0,0,0,4
CCCAGTAAACTTGGGA-1_V12N28-333_A1,7,0,0,0,0,7
AGATTCACAACCGATA-1_V12N28-333_A1,3,1,0,0,1,5
AGAAGGTACACTTCAC-1_V12N28-333_A1,5,1,4,0,1,11
GCAGGAACTTAGATCT-1_V12N28-333_A1,2,0,2,0,1,5
AATCTAGGTTTACTTG-1_V12N28-333_A1,0,0,3,0,0,3
CCCGGTGTATCGGAAT-1_V12N28-333_A1,0,0,3,0,0,3
TTATCCTCAAGGAATA-1_V12N28-333_A1,0,0,3,0,0,3
AGCATCATTTCGAAAG-1_V12N28-333_A1,0,1,3,0,0,4
CGCGAGTCTGCCGGGT-1_V12N28-333_A1,0,0,2,0,2,4
TGCGTCATGACTGAGC-1_V12N28-333_A1,0,0,0,0,0,0
GTATGAAATTTCACTC-1_V12N28-333_A1,0,0,1,0,0,1
TTGGTTGCGGTGCGCG-1_V12N28-333_A1,0,0,2,0,0,2
ACAGAACTGAGAACAA-1_V12N28-333_A1,0,0,2,0,0,2
CTACTATCATAGGTTT-1_V12N28-333_A1,0,0,0,0,0,0
CCTCTATCGATTAGCA-1_V12N28-333_A1,0,0,2,0,0,2
CCGTATCTCGTCGTAG-1_V12N28-333_A1,0,0,3,0,0,3
TCACGATGTCCGTGGA-1_V12N28-333_A1,0,0,1,0,0,1
TCAACAAAGATAATTC-1_V12N28-333_A1,0,0,0,0,0,0
ATGACGCGTTCTATCC-1_V12N28-333_A1,1,0,2,0,0,3
ATTTGCGCGAGTAGCT-1_V12N28-333_A1,1,0,0,0,2,3
TTCTTGGACGATCTGC-1_V12N28-333_A1,2,2,1,0,1,6
AGACGACGATGCCGCT-1_V12N28-333_A1,5,0,0,0,2,7
GGTCTCTGAATGGACT-1_V12N28-333_A1,1,2,0,0,0,3
GCTCAATCCGTTTATT-1_V12N28-333_A1,1,1,0,0,0,2
CCAGAAAGCAACTCAT-1_V12N28-333_A1,0,0,2,0,0,2
CACCGTTAGGGATCAC-1_V12N28-333_A1,0,2,0,0,0,2
AATAACACTAGAACAA-1_V12N28-333_A1,0,0,0,0,0,0
CCACCAACTTTACTGT-1_V12N28-333_A1,0,0,0,0,0,0
AAACCGTTCGTCCAGG-1_V12N28-333_A1,0,0,0,0,0,0
GCTAGCTTGAATAGCT-1_V12N28-333_A1,0,0,0,0,0,0
AATAGAACAGAGTGGC-1_V12N28-333_A1,0,0,1,0,0,1
ACACTGATCAAGGTGT-1_V12N28-333_A1,0,0,0,0,1,1
GTGAGTGGTACAACGC-1_V12N28-333_A1,0,0,1,0,0,1
GAGACTTCGCGACCGA-1_V12N28-333_A1,0,0,0,0,0,0
GAAGTCAGTTGCACTA-1_V12N28-333_A1,0,0,4,0,0,4
GTTTGGTAGGGTCAAC-1_V12N28-333_A1,0,0,5,0,0,5
ACGGCACTTGCTTGGG-1_V12N28-333_A1,0,0,4,0,0,4
CCTCTGTACTATTCTA-1_V12N28-333_A1,0,2,1,0,0,3
CTATTCATGTGTCCCA-1_V12N28-333_A1,0,1,0,0,0,1
GCCCGATCTGTGGTCG-1_V12N28-333_A1,1,0,2,0,0,3
TTAGAAGAACATGACT-1_V12N28-333_A1,0,0,2,0,1,3
AGGATAAAGTCGGGAT-1_V12N28-333_A1,0,0,4,0,0,4
CGGCAAACATCGTGCG-1_V12N28-333_A1,0,1,1,0,0,2
CTAGTTACAACCCGGT-1_V12N28-333_A1,0,2,2,0,0,4
TTCGACAGAGCCCGTG-1_V12N28-333_A1,0,0,0,0,0,0
AAGCATACTCTCCTGA-1_V12N28-333_A1,0,0,1,0,1,2
GACGACGATCCGCGTT-1_V12N28-333_A1,0,0,0,0,0,0
GGTAGAAGACCGCCTG-1_V12N28-333_A1,0,0,0,0,0,0
GAGATGGGAGTCGACA-1_V12N28-333_A1,0,1,0,0,0,1
AACGATAATGCCGTAG-1_V12N28-333_A1,0,1,2,0,0,3
TGGTCCCACGCTACGG-1_V12N28-333_A1,0,0,0,0,0,0
CTGCTTGGCGATAGCT-1_V12N28-333_A1,0,1,2,0,1,4
ATCGGAGACAGACGGC-1_V12N28-333_A1,1,0,2,0,0,3
TAGCGTCCGGTGTGGT-1_V12N28-333_A1,0,1,3,0,0,4
GTTGAGTCCCGCCGGT-1_V12N28-333_A1,0,1,1,0,0,2
AAATAGGGTGCTATTG-1_V12N28-333_A1,0,0,3,0,0,3
AAGTGTTTGGAGACGG-1_V12N28-333_A1,0,0,3,0,0,3
AGCACTACCTCACCAG-1_V12N28-333_A1,0,3,7,0,0,10
TGCCTTGGCCAGGCAA-1_V12N28-333_A1,1,0,2,0,1,4
TCGTCTTAGGCGTTAA-1_V12N28-333_A1,0,1,3,0,0,4
TTCTGACCGGGCTCAA-1_V12N28-333_A1,0,0,3,0,0,3
CAGAACTTAGCCCTCT-1_V12N28-333_A1,0,0,2,0,0,2
AGCTCCTTCGCACATC-1_V12N28-333_A1,0,0,3,0,0,3
ACAGGCTTGCCCGACT-1_V12N28-333_A1,0,0,0,0,0,0
GCTATACGTCTCGGAC-1_V12N28-333_A1,0,0,1,0,0,1
GAGCCAGCTACCTGTG-1_V12N28-333_A1,0,1,2,0,1,4
TGCTAAGTGTCTATTT-1_V12N28-333_A1,0,3,1,0,1,5
GTCCTACGAATAGTCT-1_V12N28-333_A1,0,0,3,0,0,3
CAGTGTCGGCTGGCCC-1_V12N28-333_A1,0,1,6,0,0,7
CTATCGACGAAATACA-1_V12N28-333_A1,0,0,3,0,0,3
CATCATTACCCTGAGG-1_V12N28-333_A1,0,0,1,0,0,1
TAAGTTGCGACGTAGG-1_V12N28-333_A1,0,0,2,0,0,2
AGTGCACGCTTAAGAA-1_V12N28-333_A1,0,0,0,0,0,0
TGTGCCGGTGCCGGAA-1_V12N28-333_A1,0,0,1,0,0,1
AGGAGGCCTTCGCGCG-1_V12N28-333_A1,0,0,0,0,0,0
TCCGCGGCCCAATGAA-1_V12N28-333_A1,0,1,2,0,0,3
TCCGTTAAGCTAATAT-1_V12N28-333_A1,0,0,3,0,0,3
AAATCTAGCCCTGCTA-1_V12N28-333_A1,0,0,3,0,0,3
CGCAGGCGATCCAAAC-1_V12N28-333_A1,0,0,2,0,0,2
CCATATGGAAACTATA-1_V12N28-333_A1,0,0,2,0,0,2
CACCGTATCCCATCCG-1_V12N28-333_A1,0,0,0,0,0,0
GGTCAAGACTACTTCG-1_V12N28-333_A1,0,1,0,0,0,1
CCCGTTTCGCAGATGT-1_V12N28-333_A1,0,1,0,0,1,2
GTTATAATACGGTGAA-1_V12N28-333_A1,0,0,1,0,0,1
ACTTGTGGATGGAACG-1_V12N28-333_A1,0,1,1,0,0,2
GTTCGCTGAGACGTCT-1_V12N28-333_A1,0,0,1,0,0,1
GACACTGGAACCCGAT-1_V12N28-333_A1,0,1,0,0,0,1
CCCAGGTCTGAAGGCT-1_V12N28-333_A1,0,0,1,0,1,2
TCTCGAGGAGGTTCGC-1_V12N28-333_A1,0,0,1,0,0,1
ACTATCTGCCCGCGTA-1_V12N28-333_A1,0,1,0,0,0,1
CCTAAATTGTATCCTA-1_V12N28-333_A1,0,0,4,0,0,4
AGAAATTATGACTCGC-1_V12N28-333_A1,0,1,2,0,0,3
TCCAGCGCTATAAGCG-1_V12N28-333_A1,0,2,2,0,1,5
TCGTGTATTGGTCACG-1_V12N28-333_A1,0,0,4,0,0,4
CCACATACTGCACCCA-1_V12N28-333_A1,0,1,1,0,0,2
GTTGCGGACGGTCAGG-1_V12N28-333_A1,0,0,4,0,1,5
GTATTTAATGGCATAA-1_V12N28-333_A1,1,2,2,0,0,5
GTCGATAGGTGACTTT-1_V12N28-333_A1,0,0,1,0,1,2
AATAATCTTCGTATCG-1_V12N28-333_A1,0,0,2,0,1,3
ATTGTTCAACGATCCG-1_V12N28-333_A1,0,0,4,0,1,5
GTGCAGCGTAGAGTAG-1_V12N28-333_A1,0,1,2,0,2,5
TGTGGTAGGGTGCCTT-1_V12N28-333_A1,0,1,4,0,1,6
TGTGGACTATCTACGT-1_V12N28-333_A1,0,0,2,0,0,2
GGCGGGCTCTAAGAGT-1_V12N28-333_A1,0,0,2,0,1,3
TGTGCCAGAGGCAAAG-1_V12N28-333_A1,0,6,1,0,0,7
TGGCTTATGTATAATG-1_V12N28-333_A1,0,0,1,0,0,1
GCAAGCTGGAAACCGC-1_V12N28-333_A1,0,2,6,0,0,8
GATATCAAGCAGGAGC-1_V12N28-333_A1,0,3,3,0,0,6
CACCAATCATCCGTCT-1_V12N28-333_A1,1,1,5,0,0,7
CCACATGGCTCTTTAT-1_V12N28-333_A1,1,1,1,0,0,3
GTCCTACTCTACGGGC-1_V12N28-333_A1,4,2,0,0,0,6
CTCGAGACATACGATA-1_V12N28-333_A1,7,0,1,0,0,8
TATCAGTGGCGTAGTC-1_V12N28-333_A1,6,2,0,0,0,8
TGACAGGACAAGTCCA-1_V12N28-333_A1,9,0,0,0,0,9
CCGCCGGAACTTCTCG-1_V12N28-333_A1,1,0,0,0,0,1
GCCATTAGCCTCAAAC-1_V12N28-333_A1,1,1,0,0,0,2
GTTAGGCTACCCGTTT-1_V12N28-333_A1,2,0,0,0,0,2
GGGTATTCTAGCAAAC-1_V12N28-333_A1,0,0,0,0,0,0
GCCCTAGCCGTCGCGA-1_V12N28-333_A1,2,1,0,0,0,3
CAGATCCTGGTTTGAA-1_V12N28-333_A1,0,0,0,0,0,0
CTTCAGTGGTCGCCTA-1_V12N28-333_A1,1,0,2,0,0,3
GGGCAACCGCACGTGC-1_V12N28-333_A1,0,0,5,0,1,6
GACCCAATTATGATAC-1_V12N28-333_A1,0,0,2,0,2,4
GAAGCTCGGACCCGTC-1_V12N28-333_A1,0,0,2,0,0,2
CGTCGGGTCTAAGCGC-1_V12N28-333_A1,0,0,2,0,0,2
GAGGCCCGACTCCGCA-1_V12N28-333_A1,0,0,0,0,0,0
TTGCCATAGCCCGCTC-1_V12N28-333_A1,1,0,3,0,0,4
TAACATACACGCGATC-1_V12N28-333_A1,0,0,0,0,0,0
CCGACGGGCATGAGGT-1_V12N28-333_A1,0,0,1,0,0,1
CTCTTGTCCCGCTTGG-1_V12N28-333_A1,0,0,0,0,0,0
TACGCCTCCATTCCGA-1_V12N28-333_A1,0,0,0,0,0,0
CGGAGCAATTTAATCG-1_V12N28-333_A1,0,0,4,0,0,4
AACTAGGCTTGGGTGT-1_V12N28-333_A1,0,0,3,0,0,3
GCGTCGCCAGGGTGAT-1_V12N28-333_A1,0,0,0,0,0,0
GTTGGTCATGCTATCC-1_V12N28-333_A1,0,1,2,0,0,3
GCTGGCGGCGCATGCT-1_V12N28-333_A1,0,0,0,0,0,0
TGAGCGGAAAGTGTTC-1_V12N28-333_A1,0,1,2,0,0,3
CTTTCTGTGCGGGCTT-1_V12N28-333_A1,0,0,1,0,1,2
ATCTAATATCCTACGG-1_V12N28-333_A1,0,0,1,0,2,3
AACCTTTAAATACGGT-1_V12N28-333_A1,0,0,0,0,0,0
TTCACTCGAGCACCTA-1_V12N28-333_A1,0,0,3,0,1,4
CTGCACTCCAGTACAG-1_V12N28-333_A1,0,0,0,0,0,0
CCATTTCTACCTATTA-1_V12N28-333_A1,0,0,1,0,0,1
CAAGCGGCACATAATT-1_V12N28-333_A1,0,1,1,0,0,2
GTTAACATCACTTAAA-1_V12N28-333_A1,1,0,3,0,0,4
ATATAAATGTAGCTGC-1_V12N28-333_A1,0,0,2,0,0,2
GCCTCTATACATAGCA-1_V12N28-333_A1,0,0,1,0,2,3
GTGTCGTATAGCGTTC-1_V12N28-333_A1,0,0,2,0,0,2
ATACGTACTTAGCCAC-1_V12N28-333_A1,0,1,1,0,0,2
GCTATCATACTCATGG-1_V12N28-333_A1,0,1,2,0,0,3
TATCCAATTGGTTATC-1_V12N28-333_A1,0,1,5,0,0,6
TCTCCCTGGGCAGCGT-1_V12N28-333_A1,0,2,1,0,2,5
CCTATAATGAGTGCCC-1_V12N28-333_A1,0,0,4,0,0,4
CAATGCGAGAAGTATC-1_V12N28-333_A1,0,0,2,0,1,3
TACCAATAAAGTACCA-1_V12N28-333_A1,0,1,4,0,0,5
GCTAGGCACCACGGAG-1_V12N28-333_A1,0,0,3,0,1,4
GGTGGACTGCTCTGGC-1_V12N28-333_A1,0,1,1,0,0,2
TATTCCGAGCTGTTAT-1_V12N28-333_A1,0,0,2,0,0,2
TTGAGAAGTTTAGCAT-1_V12N28-333_A1,0,0,3,0,0,3
GTCCGGACCTGAAATT-1_V12N28-333_A1,0,0,1,0,0,1
CTGTGGTCGGGAGATA-1_V12N28-333_A1,0,0,3,0,2,5
CATGTAAGAGACATTT-1_V12N28-333_A1,0,0,3,0,0,3
CACGTTTCGTACACAC-1_V12N28-333_A1,0,0,0,0,0,0
CATCCTCTCAAAGATC-1_V12N28-333_A1,0,2,3,0,0,5
GATTAACCGAAAGCCC-1_V12N28-333_A1,0,1,1,0,0,2
AACGCTGTTGCTGAAA-1_V12N28-333_A1,0,0,2,0,2,4
TTCAGCTGGCGTGCCC-1_V12N28-333_A1,1,0,0,0,0,1
TAGAGGTTCTACTTGT-1_V12N28-333_A1,0,0,6,0,0,6
GTATCAAACGTTAGCT-1_V12N28-333_A1,0,0,1,0,0,1
AATCATGTAAAGACTC-1_V12N28-333_A1,0,0,1,0,0,1
AGTCACTAGCTCTCGA-1_V12N28-333_A1,0,0,5,0,0,5
GCGAAACGATCGGGAG-1_V12N28-333_A1,0,1,5,0,0,6
CATGGATTGTCTTCCG-1_V12N28-333_A1,0,1,3,0,0,4
ATTGGATTACAGCGTA-1_V12N28-333_A1,1,1,3,0,0,5
CACACACGCTAACGAG-1_V12N28-333_A1,0,0,2,0,1,3
CTATGGGAAGCGGAAT-1_V12N28-333_A1,0,1,1,0,0,2
TGCCTAATTGAAGATT-1_V12N28-333_A1,0,1,0,0,0,1
TGGCAATGGGACGGCG-1_V12N28-333_A1,0,0,5,0,0,5
ACCTCCGCCCTCGCTG-1_V12N28-333_A1,0,0,1,0,0,1
CGGCAATAAGATCGCC-1_V12N28-333_A1,0,2,1,0,1,4
CCTTGACCACTTTATT-1_V12N28-333_A1,0,0,2,0,0,2
TCATTTAGAAGTGTGA-1_V12N28-333_A1,0,1,3,0,0,4
CAGAATAACACACGGA-1_V12N28-333_A1,0,1,2,0,0,3
TCTGAGCAATTGACTG-1_V12N28-333_A1,0,1,1,0,0,2
CAACGTGGTGGAGTCT-1_V12N28-333_A1,0,0,1,0,0,1
CACAGTTCGCTTCCCA-1_V12N28-333_A1,0,2,1,0,1,4
TCTCTCGCCGCACATA-1_V12N28-333_A1,0,1,3,0,1,5
TGGGCAGGCCACCGCA-1_V12N28-333_A1,0,0,4,0,2,6
CTCCTGTTCAAGGCAG-1_V12N28-333_A1,0,1,3,0,0,4
TATTTGATTTGCACAG-1_V12N28-333_A1,0,1,3,0,0,4
GCCACTCCTTACGGTA-1_V12N28-333_A1,0,3,0,0,1,4
ACCGATATTTAATCAT-1_V12N28-333_A1,0,0,0,0,2,2
TTATTATCTGGAAGGC-1_V12N28-333_A1,0,1,1,0,0,2
TACATGCCGGAATTGT-1_V12N28-333_A1,0,0,0,0,0,0
GGCACTCAGCCGACCC-1_V12N28-333_A1,0,1,1,0,0,2
AAACCGGAAATGTTAA-1_V12N28-333_A1,0,0,1,0,0,1
AGACAGGCATCTCAGC-1_V12N28-333_A1,0,0,4,0,0,4
GTGGTGATGGTTTGTG-1_V12N28-333_A1,0,0,3,0,1,4
CCGATATGACGTAAGG-1_V12N28-333_A1,0,0,0,0,0,0
CATACACAAAGTCAGC-1_V12N28-333_A1,0,4,2,0,0,6
TGCCGTTCTTAATCGG-1_V12N28-333_A1,0,1,3,0,0,4
TCGAGTCTACGATTCG-1_V12N28-333_A1,0,1,1,0,0,2
ACTTCCAGTGGAAGCT-1_V12N28-333_A1,0,1,3,0,0,4
CAATTGGGCCGCACTC-1_V12N28-333_A1,1,1,2,0,0,4
AAATCGCGGAAGGAGT-1_V12N28-333_A1,2,0,1,0,0,3
ATATCAATTCCAGCCT-1_V12N28-333_A1,2,0,1,0,0,3
CTTTGTCGAATGCTCC-1_V12N28-333_A1,2,2,0,0,0,4
TGAGGCATGTACTGTG-1_V12N28-333_A1,4,0,0,0,0,4
TTCGCCGCTCGCGCTA-1_V12N28-333_A1,2,0,0,0,0,2
GACTCCTTCCAATTGA-1_V12N28-333_A1,4,0,0,0,0,4
ACCGAAGAGTCTGGTT-1_V12N28-333_A1,1,0,0,0,0,1
TTGTGTATGCCACCAA-1_V12N28-333_A1,0,1,2,0,0,3
TGCTCGGCGAAACCCA-1_V12N28-333_A1,0,1,1,0,0,2
CGATTAAATATCTCCT-1_V12N28-333_A1,0,1,1,0,3,5
TGCCGTGGATCGTCCT-1_V12N28-333_A1,0,0,3,0,0,3
GTGGACGCATTTGTCC-1_V12N28-333_A1,0,0,2,0,0,2
ACCCGGAAACTCCCAG-1_V12N28-333_A1,0,1,2,0,1,4
CCGCATGTGGTACGAT-1_V12N28-333_A1,0,1,1,0,0,2
GCAAACCTTGGCCATA-1_V12N28-333_A1,0,3,5,0,0,8
ATTCACTGATGTTGGA-1_V12N28-333_A1,0,1,0,0,0,1
ACTCCCTAATGCTAAA-1_V12N28-333_A1,0,0,1,0,2,3
TCCTAAATTGGGAAGC-1_V12N28-333_A1,0,0,2,0,1,3
GAACAGATTACTAAAT-1_V12N28-333_A1,0,0,0,0,0,0
ATACAGGCCCTCCAAT-1_V12N28-333_A1,0,0,1,0,0,1
CGATTCGCCTGGCTGC-1_V12N28-333_A1,0,0,0,0,1,1
TCCGCCTGTCTACAAG-1_V12N28-333_A1,0,0,1,0,1,2
CACATCTCACCGACGA-1_V12N28-333_A1,2,1,2,0,0,5
CGTCGTCCTTCGCGAA-1_V12N28-333_A1,0,1,5,0,1,7
CGTTGAATACCGCGCT-1_V12N28-333_A1,0,0,1,0,2,3
ACCAATATGCAAGTTA-1_V12N28-333_A1,0,0,3,0,0,3
ACGGATGGTGCGGATA-1_V12N28-333_A1,0,1,2,0,0,3
CACCCTAACAAGATCT-1_V12N28-333_A1,0,2,1,0,0,3
AAGCTCTTTCATGGTG-1_V12N28-333_A1,0,0,1,0,0,1
CATGGGTATGCCTTAT-1_V12N28-333_A1,0,0,2,0,2,4
GCGCGTCATTGGTACA-1_V12N28-333_A1,0,0,2,0,1,3
TCTGAAGCACGTGGTC-1_V12N28-333_A1,0,0,4,0,0,4
AAGTTCACTCCAAGCT-1_V12N28-333_A1,0,0,0,0,1,1
TTGGACCTATAACAGT-1_V12N28-333_A1,0,0,2,0,0,2
ATCAGCCTCATGCTGC-1_V12N28-333_A1,0,1,3,0,0,4
AGTACTCTTATGCCCA-1_V12N28-333_A1,0,0,2,0,0,2
GCGCTTAAATAATTGG-1_V12N28-333_A1,0,0,1,0,0,1
TTGTGAACCTAATCCG-1_V12N28-333_A1,0,0,1,0,0,1
AGTCGTCGACCACCAA-1_V12N28-333_A1,0,1,1,0,0,2
TCCTTTAAATCCGCTT-1_V12N28-333_A1,0,0,1,0,1,2
ACTGAAACGCCGTTAG-1_V12N28-333_A1,1,0,1,0,0,2
GCACACACTGGTAGCC-1_V12N28-333_A1,4,0,0,0,0,4
TAAGGGCCTGTCCGAT-1_V12N28-333_A1,0,0,1,0,0,1
GCTAGAGTAGAGATGT-1_V12N28-333_A1,0,1,3,0,0,4
CACAGGGCCATATAGT-1_V12N28-333_A1,0,0,0,0,1,1
CCATGCCCTAGATTTC-1_V12N28-333_A1,0,0,1,0,0,1
TCGCGTAGCAGTGTCC-1_V12N28-333_A1,1,2,0,0,0,3
GACGAGGCTAATAAAC-1_V12N28-333_A1,0,0,2,0,0,2
CTACACTCGCAGATGG-1_V12N28-333_A1,0,0,0,0,0,0
ACGCATACGTTTACTA-1_V12N28-333_A1,0,0,2,0,0,2
GGAGCAACATTTCAAG-1_V12N28-333_A1,0,0,1,0,0,1
CGAGAGGGTAGCCGCG-1_V12N28-333_A1,0,0,6,0,0,6
TCGTGTTCGACCACAA-1_V12N28-333_A1,0,1,0,0,1,2
TCTACCCAATAGAGAG-1_V12N28-333_A1,0,0,3,0,0,3
ATAAACGTTGCACCAC-1_V12N28-333_A1,0,0,0,0,1,1
TCAACTGCAGAGTCAG-1_V12N28-333_A1,0,1,4,0,0,5
AGCTCCATATATGTTC-1_V12N28-333_A1,0,1,2,0,0,3
GTAACATCTAAGATAA-1_V12N28-333_A1,0,1,2,0,0,3
CCGACAATAGGCCGCC-1_V12N28-333_A1,0,2,0,0,0,2
ATGCTTAGGAGTTGAT-1_V12N28-333_A1,0,0,0,0,1,1
AACCCGAGCAGAATCG-1_V12N28-333_A1,0,1,0,0,0,1
CGGGTTTGTTAGGGCT-1_V12N28-333_A1,2,0,3,0,0,5
AGGCACGTGACTGTCC-1_V12N28-333_A1,0,0,3,0,0,3
GACAAGAGATGAGATT-1_V12N28-333_A1,0,0,1,0,0,1
AGCCCTTGGACATCCC-1_V12N28-333_A1,0,0,4,0,0,4
GCAGTTCGATCCGAGC-1_V12N28-333_A1,0,0,1,0,0,1
TCGAGGGCAACAGACG-1_V12N28-333_A1,0,2,1,0,0,3
ACTTTGTCGACGCACT-1_V12N28-333_A1,0,0,2,0,0,2
GAGTATCAAAGTTACA-1_V12N28-333_A1,0,0,2,0,0,2
CCAGGCTGGCGTCTGA-1_V12N28-333_A1,0,1,3,0,0,4
GGACTCTTCCGGTTGA-1_V12N28-333_A1,0,2,1,0,0,3
TCCCAGCACACGACAT-1_V12N28-333_A1,0,0,1,0,0,1
GCTCCATGAGTGCAGA-1_V12N28-333_A1,0,2,3,0,0,5
GCAGTGCGGGCGGATG-1_V12N28-333_A1,0,0,3,0,0,3
GCGTTCTGACTAAGCG-1_V12N28-333_A1,0,1,3,0,0,4
ATTTGGAGATTGCGGT-1_V12N28-333_A1,0,1,3,0,0,4
AAGGGTTTGATTTCAG-1_V12N28-333_A1,0,5,1,0,0,6
CCGGCCGCGAGCATAT-1_V12N28-333_A1,1,3,3,0,0,7
GAGTTCTGTGGGTGCT-1_V12N28-333_A1,1,1,3,0,0,5
AAACGAAGATGGAGTA-1_V12N28-333_A1,2,1,3,0,0,6
AATTACGAGACCCATC-1_V12N28-333_A1,1,0,0,0,0,1
CCTTTGAATTATGGCT-1_V12N28-333_A1,2,0,0,0,0,2
CATGGTATTAGTTTGT-1_V12N28-333_A1,1,2,0,0,0,3
AACGAAAGTCGTCCCA-1_V12N28-333_A1,2,1,0,0,0,3
ACATAAGTCGTGGTGA-1_V12N28-333_A1,5,1,0,0,0,6
GCACAACCTCGGGCGT-1_V12N28-333_A1,3,2,0,0,0,5
ATGCACGCGCTGTTCA-1_V12N28-333_A1,4,1,0,0,0,5
CGATGTTGTTATCTAC-1_V12N28-333_A1,0,0,1,0,0,1
GTCTCCTGCCAGTATG-1_V12N28-333_A1,0,0,0,0,0,0
GGGCAGAGCAATCGTT-1_V12N28-333_A1,0,0,0,0,0,0
TACCAAATAGCCCAGA-1_V12N28-333_A1,0,1,7,0,0,8
TACCTACTCCCAGTAT-1_V12N28-333_A1,0,0,0,0,2,2
TGTGAGACTAGCCCAA-1_V12N28-333_A1,0,0,0,0,0,0
ATACCTAACCAAGAAA-1_V12N28-333_A1,0,0,2,0,2,4
GTCGGGAAGCAGAAAC-1_V12N28-333_A1,0,0,3,0,0,3
AATTAACGGATTTCCA-1_V12N28-333_A1,0,0,1,0,0,1
GAACCCTCTGTGTTCT-1_V12N28-333_A1,0,0,2,0,1,3
ATATAAAGCGCTCGTG-1_V12N28-333_A1,0,0,5,0,2,7
CCTGGTCGAATGTGGG-1_V12N28-333_A1,0,0,3,0,0,3
CTAGGTTCGGACGTGA-1_V12N28-333_A1,0,0,3,0,0,3
TCGGGAGACAGCGTAC-1_V12N28-333_A1,0,0,1,0,0,1
CATAAGAAGCTTGGCT-1_V12N28-333_A1,0,0,0,0,2,2
AAGCACCCTGCGTATC-1_V12N28-333_A1,0,0,0,0,0,0
AGTTTGCACCTGCCTC-1_V12N28-333_A1,0,1,3,0,0,4
GACTGCAAATCGAGCT-1_V12N28-333_A1,0,0,1,0,1,2
GTGTATATCAGCGGGC-1_V12N28-333_A1,0,0,4,0,1,5
CTTCAACTCCACTTGG-1_V12N28-333_A1,0,0,0,0,0,0
ACTTACGCATCCACGC-1_V12N28-333_A1,0,0,2,0,3,5
CATGAGATGCACTCTC-1_V12N28-333_A1,0,0,3,0,0,3
GAGCACCTGTGTCCAG-1_V12N28-333_A1,0,0,0,0,0,0
CGCGACCGCGACAGAT-1_V12N28-333_A1,0,0,1,0,1,2
GTCCCGCGACGTTATG-1_V12N28-333_A1,0,0,2,0,2,4
GCAGTGTGGCTATAGG-1_V12N28-333_A1,0,0,0,0,1,1
ATACTGCCTTACACCG-1_V12N28-333_A1,0,2,0,0,1,3
TACAGAAACGGTGGGC-1_V12N28-333_A1,0,0,2,0,2,4
GGCGCGGAGATCTTTC-1_V12N28-333_A1,0,0,2,0,1,3
CGTTAATGTCCCGACG-1_V12N28-333_A1,0,0,3,0,0,3
GCTAACTGAAGTCTGA-1_V12N28-333_A1,0,0,0,0,1,1
AGTGATAACCTGCGCG-1_V12N28-333_A1,0,1,3,0,2,6
TATGATCTTCTCTTTA-1_V12N28-333_A1,0,0,2,0,0,2
TGTACCTACACGAGGG-1_V12N28-333_A1,0,0,1,0,0,1
ATATCGTTCCTCGAAC-1_V12N28-333_A1,0,0,2,0,1,3
CGGCGCCATCAATCCC-1_V12N28-333_A1,0,0,4,0,3,7
CCTGTTTGAAGACACG-1_V12N28-333_A1,0,0,1,0,1,2
GCCACTCAGAGCGCGA-1_V12N28-333_A1,0,1,1,0,1,3
TCGGCTTGTATCGACG-1_V12N28-333_A1,0,2,6,0,0,8
TAGATGGTTCCTTACT-1_V12N28-333_A1,0,0,0,0,1,1
ATCGTTAGCTAGCGGA-1_V12N28-333_A1,1,1,1,0,0,3
ACAGCGACATTCTCAT-1_V12N28-333_A1,1,0,0,0,1,2
ATTCAACCATTTAAGG-1_V12N28-333_A1,0,1,1,0,0,2
CACTCTTCTGCTAGCC-1_V12N28-333_A1,1,0,4,0,1,6
CTAACTGATAATCGCC-1_V12N28-333_A1,0,0,0,0,0,0
TGATGTCAATTAAGTG-1_V12N28-333_A1,0,0,1,0,0,1
CGCCGTTCAGCATAGT-1_V12N28-333_A1,0,1,1,0,0,2
ATACTACCCGTACCAC-1_V12N28-333_A1,0,0,5,0,0,5
CCACTGTTTGGATTAA-1_V12N28-333_A1,0,0,0,0,0,0
CACTACGGGAGCTGCC-1_V12N28-333_A1,0,0,0,0,0,0
GACCAAACGTTGACTG-1_V12N28-333_A1,0,1,1,0,0,2
AAGAGGCCCTTTGGAA-1_V12N28-333_A1,0,1,3,0,0,4
ACACGTAGGCCACAAG-1_V12N28-333_A1,0,0,2,0,1,3
TACTCTTACTTTACTG-1_V12N28-333_A1,0,0,4,0,1,5
AGAGCCGCCGAGATTT-1_V12N28-333_A1,0,0,2,0,0,2
GGCCTGCTTCTCCCGA-1_V12N28-333_A1,0,0,0,0,0,0
TCAAGCGCGGACGGTA-1_V12N28-333_A1,0,1,2,0,0,3
ACACTGGGACAGTCGT-1_V12N28-333_A1,0,0,0,0,0,0
TGTGTAGTAGCACGTG-1_V12N28-333_A1,0,1,4,0,0,5
CTAGCCACAGGCGAGC-1_V12N28-333_A1,1,0,4,0,1,6
CTATCGCGTAGAGAAC-1_V12N28-333_A1,0,0,4,0,0,4
GTTCCCGTAAACATAT-1_V12N28-333_A1,0,1,1,0,0,2
TCTTTCCTTCGAGATA-1_V12N28-333_A1,0,1,2,0,0,3
ATATTGGAGAGGCCTT-1_V12N28-333_A1,0,2,2,0,0,4
AGGCGATAACTGGCGT-1_V12N28-333_A1,0,1,3,0,1,5
ACCCGGAGCACCACAA-1_V12N28-333_A1,0,0,0,0,0,0
TGAGCTCAACTGTATA-1_V12N28-333_A1,0,0,2,0,0,2
ACGACCCATGAGTTGC-1_V12N28-333_A1,0,0,0,0,0,0
CGGTCAGTCCATATTT-1_V12N28-333_A1,0,0,1,0,0,1
TCCGGCTGTCGGGTCG-1_V12N28-333_A1,0,0,2,0,0,2
ATTCCCGAAGGTACAG-1_V12N28-333_A1,0,2,1,0,0,3
CTAACAGCACAATAAC-1_V12N28-333_A1,1,0,1,0,1,3
TTGTGCGGAAGCGGAT-1_V12N28-333_A1,1,0,2,0,0,3
GGGCACTATTGACCAT-1_V12N28-333_A1,1,2,2,0,0,5
CCATAGAGGCTGCCAG-1_V12N28-333_A1,0,2,2,0,0,4
CCGAAGCATTGACCAA-1_V12N28-333_A1,0,6,0,0,0,6
TACTGAGGGAAGAAAG-1_V12N28-333_A1,0,2,0,0,0,2
TATGTAGAAACCCGGC-1_V12N28-333_A1,3,2,1,0,0,6
TGGTTAACTTACATTT-1_V12N28-333_A1,2,2,0,0,0,4
AGAACCCTCAATTGGG-1_V12N28-333_A1,2,0,1,0,0,3
CCTATATCGTGTCACG-1_V12N28-333_A1,8,0,0,0,1,9
ACGGCTGGATGTAGAA-1_V12N28-333_A1,4,0,0,0,0,4
CTCGCATTGCATAGCC-1_V12N28-333_A1,7,1,0,0,0,8
ACTTTGGTCGTGCTCC-1_V12N28-333_A1,3,0,0,0,0,3
GCTGGTTTAGGCCATA-1_V12N28-333_A1,0,0,0,0,0,0
TAGGTGTTCCACAGAT-1_V12N28-333_A1,0,0,0,0,0,0
GAAGCCTGCACATTCC-1_V12N28-333_A1,0,0,0,0,2,2
GGCTTTCAATAAGGGT-1_V12N28-333_A1,0,0,2,0,1,3
TCCAGGGTATATACGA-1_V12N28-333_A1,0,1,3,0,1,5
CTCGCCGAATGTAGGG-1_V12N28-333_A1,0,0,1,0,0,1
AGGAAGCTGTCCGCCG-1_V12N28-333_A1,0,1,1,0,0,2
GTCTCAAGGCCCGGCT-1_V12N28-333_A1,0,1,4,0,2,7
ACCGACACATCTCCCA-1_V12N28-333_A1,0,0,1,0,0,1
TATACGCGTCATCACT-1_V12N28-333_A1,0,1,3,0,0,4
ATCTGGGCTGTTCTTG-1_V12N28-333_A1,0,1,3,0,1,5
TCAAATTTGAGACTCA-1_V12N28-333_A1,0,0,5,0,0,5
GTTAAGGGTGCGATGT-1_V12N28-333_A1,0,0,3,0,1,4
AGCAAAGGCCGCTAGT-1_V12N28-333_A1,0,0,1,0,0,1
TTATAGGTAATTGTCT-1_V12N28-333_A1,0,1,1,0,1,3
TTGTGCAGCCACGTCA-1_V12N28-333_A1,0,0,1,0,0,1
ACGGACTCTCAAAGCG-1_V12N28-333_A1,2,0,0,0,0,2
ATGCTCTGGCGCGGTA-1_V12N28-333_A1,0,0,4,0,1,5
ATAATCTTGGAGAACC-1_V12N28-333_A1,0,0,1,0,2,3
CTCATTGCTCTAACAA-1_V12N28-333_A1,0,0,4,0,0,4
TAGGTGACGATAACCT-1_V12N28-333_A1,0,1,0,0,0,1
CGGATCCTCAAGGACT-1_V12N28-333_A1,0,0,0,0,0,0
GGGCGTGGTTTCCCAG-1_V12N28-333_A1,0,0,1,0,0,1
TGGCTATGTGACATAC-1_V12N28-333_A1,0,0,1,0,2,3
CTTAGTGTAGTAGCAT-1_V12N28-333_A1,0,0,1,0,1,2
GGATTGCTGTGACTCC-1_V12N28-333_A1,0,0,1,0,0,1
ACTTCCATGCGGGACA-1_V12N28-333_A1,0,0,0,0,0,0
ACTCAAGTGCAAGGCT-1_V12N28-333_A1,0,0,2,0,1,3
ACAAGGATGCTTTAGG-1_V12N28-333_A1,0,1,0,0,2,3
TTGAACGACGTGCTGA-1_V12N28-333_A1,0,0,0,0,3,3
ATTCATCGTTGAGGCA-1_V12N28-333_A1,0,1,0,0,0,1
TGCAACCCATCTGCGG-1_V12N28-333_A1,0,1,1,0,1,3
AGTGCTAAACACAGCA-1_V12N28-333_A1,0,0,1,0,0,1
AACTCCAGAGCGTGTT-1_V12N28-333_A1,0,1,1,0,0,2
TCTCCACAAGTTGAAT-1_V12N28-333_A1,0,0,3,1,0,4
CTTTGCATCGCTCTTG-1_V12N28-333_A1,0,0,2,0,0,2
TCACAAACCGAGGTAC-1_V12N28-333_A1,0,1,0,0,0,1
CCGTAGGAAATCCCTG-1_V12N28-333_A1,0,0,3,0,0,3
AAACATTTCCCGGATT-1_V12N28-333_A1,0,1,2,0,0,3
GCCTCCGACAATTCAC-1_V12N28-333_A1,0,0,1,0,0,1
TCTGCATACCTTGCTT-1_V12N28-333_A1,0,1,3,0,0,4
ACCCATTTGTCCCTCT-1_V12N28-333_A1,0,0,3,0,0,3
CTGCAGAGAATCAGAG-1_V12N28-333_A1,0,0,1,0,1,2
GGAAACTAAATGGGCC-1_V12N28-333_A1,0,0,1,0,0,1
CAACCTACCGAGCAGT-1_V12N28-333_A1,0,1,2,0,0,3
CCGTAGGGTTGTTTAC-1_V12N28-333_A1,0,0,0,0,1,1
GGTTTGTGACCTGAGG-1_V12N28-333_A1,0,0,1,0,0,1
TAACCTAGGGAGTCCA-1_V12N28-333_A1,0,1,2,0,1,4
TTCCATCGACAGCGTG-1_V12N28-333_A1,0,0,0,0,2,2
ATCTCCCACGGAATAT-1_V12N28-333_A1,0,0,3,0,0,3
GTTTCAAACGAGTTGT-1_V12N28-333_A1,0,1,2,0,1,4
GGAACTTTGGCGATTA-1_V12N28-333_A1,0,0,2,0,1,3
CTGCAAGCACGTTCCG-1_V12N28-333_A1,0,0,1,0,1,2
CACAGTCCCGCTTCGC-1_V12N28-333_A1,0,0,2,0,0,2
TACGCTCGGTATTGGA-1_V12N28-333_A1,0,0,1,0,0,1
CTGGTAAAGTGTGGGC-1_V12N28-333_A1,0,0,1,0,0,1
CAACCAGTGGCCTACC-1_V12N28-333_A1,0,1,3,0,0,4
TCTTCGCGGTGAGAGG-1_V12N28-333_A1,0,0,0,0,1,1
TTCGGGTTGCCACGGG-1_V12N28-333_A1,0,0,1,0,0,1
ACCGATAGGCATAACC-1_V12N28-333_A1,0,0,1,0,0,1
CTTATAGATGGCTGTT-1_V12N28-333_A1,0,0,2,0,0,2
AGACGCCCACTTCGCC-1_V12N28-333_A1,0,0,4,0,0,4
AGGTCGCCTCCCAACA-1_V12N28-333_A1,0,0,2,0,0,2
CCTCACGTCAGCTAAT-1_V12N28-333_A1,0,2,1,0,0,3
CCACCTGTATGGAATA-1_V12N28-333_A1,0,1,1,0,0,2
GGACTCGAAGCTTTCA-1_V12N28-333_A1,0,0,0,0,0,0
AAGCCGGAGAGCAGGA-1_V12N28-333_A1,0,0,3,0,0,3
GCCTATCAGGTAAGAT-1_V12N28-333_A1,0,0,0,0,0,0
TCAGAGTGTGAGCATG-1_V12N28-333_A1,0,0,3,0,1,4
CTATACTTAAAGCGAG-1_V12N28-333_A1,2,0,0,0,0,2
AAGACCAAATAACTCA-1_V12N28-333_A1,4,1,1,0,0,6
TGTTTCTGAAGCGTGC-1_V12N28-333_A1,1,0,0,0,4,5
TTCTCTTACAGGTGAT-1_V12N28-333_A1,0,2,0,0,0,2
AATTCATTGTCATGCA-1_V12N28-333_A1,1,2,0,0,0,3
GCCCGAGAGTCTAAAT-1_V12N28-333_A1,3,2,0,0,0,5
ATATAGAGTATTGGTC-1_V12N28-333_A1,3,1,0,0,0,4
TTGAAGGATGGGCGCC-1_V12N28-333_A1,3,1,0,0,0,4
TAGTACCACAACTTTC-1_V12N28-333_A1,6,0,0,0,0,6
ATCCCATCCACAGCGC-1_V12N28-333_A1,3,0,0,0,0,3
CTTAGGTATAGACCAG-1_V12N28-333_A1,2,0,0,0,0,2
CACAGGGCCGTTGTCA-1_V12N28-333_A1,0,0,0,0,0,0
TCAATACGCCGTCATG-1_V12N28-333_A1,0,0,1,0,0,1
AGCGGACACTTCGTAG-1_V12N28-333_A1,0,0,2,0,0,2
ATACGTTATGCACGGA-1_V12N28-333_A1,0,0,1,0,0,1
GAGTAGATACTAGTTG-1_V12N28-333_A1,0,0,1,0,0,1
CCAGCTCGAACGCATT-1_V12N28-333_A1,0,0,2,0,0,2
TGCTTCCCAAGCAGTA-1_V12N28-333_A1,0,0,0,0,0,0
GTAGACACGCCTGACT-1_V12N28-333_A1,0,1,2,0,0,3
CTCACATTTACTAAAT-1_V12N28-333_A1,0,0,1,0,0,1
GAATGCGAATCGGTTC-1_V12N28-333_A1,0,0,0,0,0,0
TAAGGCCCGTCACCCT-1_V12N28-333_A1,0,1,0,0,0,1
GAGTATGCGCGTGCAT-1_V12N28-333_A1,0,0,3,0,1,4
ATCCACATCGACAGAA-1_V12N28-333_A1,0,0,2,0,0,2
TAGACGAAACGCCAAT-1_V12N28-333_A1,0,1,2,0,0,3
CAGCAGTCTGTGCTGC-1_V12N28-333_A1,0,0,4,0,0,4
CTCACTGTGATACTTA-1_V12N28-333_A1,0,0,3,0,3,6
TTAATTGCTTTGGGTG-1_V12N28-333_A1,0,1,1,0,0,2
GTAGTCTACGATATTG-1_V12N28-333_A1,0,0,1,0,0,1
TTGCCGCTTTCTAGTA-1_V12N28-333_A1,0,1,2,0,0,3
GAACCTTTAACGATCC-1_V12N28-333_A1,0,1,1,0,0,2
TGGACCAATCTAAGAT-1_V12N28-333_A1,0,0,1,0,0,1
CTAGTAGAAAGGGATT-1_V12N28-333_A1,0,0,1,0,0,1
AACCTCGCTTTAGCCC-1_V12N28-333_A1,0,0,0,0,0,0
GAGTGTCAACCAGAAA-1_V12N28-333_A1,0,0,2,0,0,2
GTGATCCTTGTCATGA-1_V12N28-333_A1,0,0,5,0,1,6
CTCAACTAACCCGGAT-1_V12N28-333_A1,0,0,0,0,1,1
AGTGGCGTCTGAAGGT-1_V12N28-333_A1,0,0,2,0,1,3
GGGAAGGGCTTTCTCA-1_V12N28-333_A1,0,0,0,0,0,0
AGGCCTGAGAATCTCG-1_V12N28-333_A1,0,0,1,0,0,1
AGCCACAGGTTACCCG-1_V12N28-333_A1,0,0,2,0,0,2
TGCAATCTAACACGGT-1_V12N28-333_A1,0,1,6,0,0,7
GTTTGGGTTTCGCCCG-1_V12N28-333_A1,0,0,1,0,2,3
CCTATGTCCACTCCAC-1_V12N28-333_A1,0,0,2,0,0,2
CTGCCTTTCTAGTAAA-1_V12N28-333_A1,0,0,1,0,0,1
TTAGTAAACCTGCTCT-1_V12N28-333_A1,0,0,1,0,1,2
TTGTGGTGGTACTAAG-1_V12N28-333_A1,0,0,3,0,1,4
CCTCCTGTTGTGTCGT-1_V12N28-333_A1,0,0,2,0,1,3
ACAAAGCATGACCTAG-1_V12N28-333_A1,0,0,0,0,1,1
ATAGCAACTAGGGAAG-1_V12N28-333_A1,0,1,1,0,0,2
CCGCTCTTCCGAACTA-1_V12N28-333_A1,0,0,0,0,0,0
TAGAATAGCCGATGAA-1_V12N28-333_A1,0,0,3,0,0,3
GGTCTCCGTCCAGGTT-1_V12N28-333_A1,0,0,3,0,0,3
TAATTACGTCAGTAGA-1_V12N28-333_A1,0,0,1,0,0,1
TACGTAAAGCGGAGTG-1_V12N28-333_A1,0,1,2,0,2,5
GCTACAATCGAGGATA-1_V12N28-333_A1,0,1,2,0,0,3
TCAGCCAATCCGTAAA-1_V12N28-333_A1,0,2,1,0,1,4
ATCATAGCCCTATGTA-1_V12N28-333_A1,0,0,0,0,0,0
GAGGCCTGTTGATACA-1_V12N28-333_A1,0,2,2,0,0,4
ATATACGCTCGTGACG-1_V12N28-333_A1,0,0,2,0,1,3
CCCTTTAATGGAGTTC-1_V12N28-333_A1,0,0,1,0,1,2
TTACACGATCTGCGAC-1_V12N28-333_A1,0,1,4,0,2,7
TCGCATAAAGGGCGCA-1_V12N28-333_A1,0,0,2,0,1,3
TGTAGCCATCCCATTC-1_V12N28-333_A1,0,1,0,0,1,2
GGGTCTATCGCTTTCC-1_V12N28-333_A1,0,1,1,0,1,3
GGAGGGTCAAGTAAGA-1_V12N28-333_A1,0,0,1,0,0,1
TACGGCATGGACGCTA-1_V12N28-333_A1,0,0,1,0,0,1
CACGTCAATCAATGGA-1_V12N28-333_A1,0,1,3,0,0,4
CGCTTGGACGGATAGA-1_V12N28-333_A1,0,0,0,0,0,0
CGCGGTACGGTATACA-1_V12N28-333_A1,0,2,3,0,0,5
CCTACTCAACACGATT-1_V12N28-333_A1,0,1,0,0,0,1
CGTTTGGTGTTGTGGG-1_V12N28-333_A1,0,2,0,0,1,3
GTTGTTGCAAGATGGC-1_V12N28-333_A1,0,1,2,0,0,3
CATTCGTCGTAGCGGT-1_V12N28-333_A1,0,0,2,0,0,2
CAGCCTCGATAGCGGT-1_V12N28-333_A1,0,0,3,0,0,3
TCATAAGTCCAAGAAG-1_V12N28-333_A1,0,0,0,0,1,1
AAAGTGCCATCAATTA-1_V12N28-333_A1,0,0,1,0,0,1
GTTGCAGTCGACAACA-1_V12N28-333_A1,0,0,1,0,0,1
TAAATGGGCTACTGAG-1_V12N28-333_A1,0,0,2,0,0,2
GCCTTTGTCAGTGGAC-1_V12N28-333_A1,0,0,0,0,0,0
AAACTTAATTGCACGC-1_V12N28-333_A1,6,0,0,0,0,6
TAGGCGGCTGCAAAGA-1_V12N28-333_A1,0,0,0,0,0,0
TCCATCAATACTAATC-1_V12N28-333_A1,3,0,0,0,0,3
ACCTCGAACTTATGCT-1_V12N28-333_A1,5,0,0,0,0,5
ACAAACCATGCGTCCT-1_V12N28-333_A1,6,0,0,0,1,7
ACACCGGTCTGACCGC-1_V12N28-333_A1,7,1,0,0,0,8
CTGGTGAATGGGCCTA-1_V12N28-333_A1,2,0,0,0,1,3
CGTTCAGACCCGCGAA-1_V12N28-333_A1,0,0,0,0,0,0
TCATATGAGCTTTGTT-1_V12N28-333_A1,0,1,1,0,0,2
AGTTGACGGTCCTTGC-1_V12N28-333_A1,0,2,1,0,0,3
ATAATTAGCTAAGTAG-1_V12N28-333_A1,0,1,3,0,0,4
GGTCTTGAGCGCTCTT-1_V12N28-333_A1,0,0,0,0,1,1
CGTTGTCGGCAATTGA-1_V12N28-333_A1,0,0,1,0,1,2
TCTTGCTCCCGATACT-1_V12N28-333_A1,0,0,1,0,0,1
AGCAGAAGGAGAAAGA-1_V12N28-333_A1,0,0,1,0,1,2
GAAGCCACTGATTATG-1_V12N28-333_A1,0,0,4,0,1,5
TGCTCTTGAGAGTTTG-1_V12N28-333_A1,0,0,2,0,0,2
GACATCCGTCGAACTG-1_V12N28-333_A1,0,0,0,0,2,2
AGATATAATACGACTA-1_V12N28-333_A1,0,1,2,0,1,4
TCGCTACTGGCTTTGA-1_V12N28-333_A1,0,1,2,0,0,3
GTGACAGCTTCCCACT-1_V12N28-333_A1,1,0,2,0,1,4
GTGACGCAGGTTTCAT-1_V12N28-333_A1,0,2,0,0,1,3
GGGAAGACGGTCTGTC-1_V12N28-333_A1,0,0,0,0,0,0
CGTCGCATGTGAGCCA-1_V12N28-333_A1,0,0,3,0,0,3
AGAAGGTTGTAGGTCG-1_V12N28-333_A1,0,0,0,0,1,1
GGCCGGCGTCTGCTAT-1_V12N28-333_A1,0,0,0,0,0,0
TTGACCAGGAACAACT-1_V12N28-333_A1,0,0,1,0,0,1
AGTCGTATAAAGCAGA-1_V12N28-333_A1,0,1,1,0,0,2
GGCGTAGGGAAAGCTG-1_V12N28-333_A1,0,0,2,0,2,4
AAACCTAAGCAGCCGG-1_V12N28-333_A1,0,0,3,0,1,4
ATTGCCTTTATGTTTG-1_V12N28-333_A1,0,1,3,0,2,6
CAGGCAGTCTTACCAG-1_V12N28-333_A1,0,0,1,0,2,3
AGCTAAGTACGCAGGC-1_V12N28-333_A1,0,0,3,0,0,3
AAATCCGATACACGCC-1_V12N28-333_A1,0,0,3,0,0,3
CGAGAGCTTTCACTAC-1_V12N28-333_A1,0,0,3,0,1,4
CGCCCAGCGTTTCACG-1_V12N28-333_A1,0,0,0,0,1,1
TTAAGTATTGTTATCC-1_V12N28-333_A1,0,0,0,0,1,1
AAACGGGCGTACGGGT-1_V12N28-333_A1,0,1,1,0,1,3
GTATCCTTTGGTAACC-1_V12N28-333_A1,0,0,1,0,1,2
CATAGTCAAATACATA-1_V12N28-333_A1,0,0,1,0,0,1
TCTATGCTATAACGAC-1_V12N28-333_A1,0,0,2,0,1,3
ACGTTCTGTACAAGTC-1_V12N28-333_A1,0,0,1,0,0,1
CGCGAAGTGGCATACT-1_V12N28-333_A1,0,0,1,0,0,1
ACCAACCGCACTCCAC-1_V12N28-333_A1,0,0,3,0,0,3
GTCATGCGCGAGGGCT-1_V12N28-333_A1,0,0,2,0,1,3
TAGGCTAAAGTGGCAC-1_V12N28-333_A1,0,0,4,0,0,4
TGGCTACACTCTACCT-1_V12N28-333_A1,0,1,3,0,0,4
TGTCCACGGCTCAACT-1_V12N28-333_A1,0,0,3,0,1,4
AATTGCAGCAATCGAC-1_V12N28-333_A1,0,1,2,0,0,3
GTCAACCAGGCCTATA-1_V12N28-333_A1,2,0,2,0,1,5
ATCTTATCGCACACCC-1_V12N28-333_A1,0,1,1,0,0,2
GTCTATTGCATGCTCG-1_V12N28-333_A1,0,0,1,0,1,2
GCACGTGGTTTACTTA-1_V12N28-333_A1,0,0,0,0,1,1
ATTCGCGCCTTGAGAG-1_V12N28-333_A1,0,0,3,0,1,4
AGCGATGCGCCTAATA-1_V12N28-333_A1,0,1,3,0,0,4
TCTATAGGTGGGTAAT-1_V12N28-333_A1,0,1,4,0,1,6
AGATACCAATAGAACC-1_V12N28-333_A1,0,0,2,0,1,3
CGTGTATGGGAGCTGA-1_V12N28-333_A1,0,1,2,0,1,4
ATGTACATGCGGTGAG-1_V12N28-333_A1,0,1,2,0,0,3
TTGGCTCAATATGTGT-1_V12N28-333_A1,0,1,1,0,0,2
GTTCGGAGCACTCAAC-1_V12N28-333_A1,0,1,0,0,0,1
TCCCTCTTCTCAAGGG-1_V12N28-333_A1,0,1,0,0,0,1
TTACGTATCTATGACA-1_V12N28-333_A1,0,0,2,0,1,3
CCCATATAGGTCGATT-1_V12N28-333_A1,0,0,1,0,0,1
GTCCACGTCGCATTCG-1_V12N28-333_A1,0,0,0,0,0,0
AATTGTGGTTGCCAAA-1_V12N28-333_A1,0,0,3,0,0,3
AGGAACGAACGACTTC-1_V12N28-333_A1,0,0,2,0,0,2
TAATTCCAATGCTTCA-1_V12N28-333_A1,0,0,2,0,0,2
AGGGCCCTAATGTTCT-1_V12N28-333_A1,0,0,1,0,0,1
AGGTGTTGCCGACCAC-1_V12N28-333_A1,0,3,1,0,1,5
CTGAGAGTAGAAATAC-1_V12N28-333_A1,0,0,3,0,1,4
TAGAAGAAGGGTTACA-1_V12N28-333_A1,0,1,6,0,0,7
GGTGACTGATAGAGAG-1_V12N28-333_A1,0,0,2,0,0,2
TACCCTCGGTAACCCT-1_V12N28-333_A1,0,1,2,0,1,4
CGAAGGGTTTCAGATT-1_V12N28-333_A1,1,0,0,0,0,1
CACCGGTAGAGACATT-1_V12N28-333_A1,0,1,0,0,0,1
CATCCAATATAGTTTG-1_V12N28-333_A1,0,0,0,0,0,0
GCAAAGGGCGTTAGCC-1_V12N28-333_A1,1,0,0,0,0,1
GGCAAGCCCATAGTGG-1_V12N28-333_A1,0,0,0,0,0,0
TGACCAAATCTTAAAC-1_V12N28-333_A1,0,0,1,0,0,1
TTCGGTACTGTAGAGG-1_V12N28-333_A1,0,0,2,0,1,3
ATGTACGATGACGTCG-1_V12N28-333_A1,0,0,3,0,0,3
ATCTAGCTTGTGAGGG-1_V12N28-333_A1,0,0,1,0,1,2
AGCGGGTCTGACACTC-1_V12N28-333_A1,0,0,2,0,0,2
GAGGTACGCGTGTCCC-1_V12N28-333_A1,0,0,3,0,1,4
GCACTGCCTACCTTTA-1_V12N28-333_A1,0,1,2,0,3,6
GGAGCGAGGCCTACTT-1_V12N28-333_A1,0,0,0,0,0,0
AAACTCGGTTCGCAAT-1_V12N28-333_A1,0,0,2,0,0,2
GGCGCTTCATTCCCTG-1_V12N28-333_A1,0,0,3,0,0,3
TGCTCGGTGGGTCACC-1_V12N28-333_A1,0,0,0,0,0,0
AAGCGCAGGGCTTTGA-1_V12N28-333_A1,0,0,4,0,0,4
GACCTTCCACGTCTAC-1_V12N28-333_A1,0,1,0,0,0,1
GTTAGCCCATGACATC-1_V12N28-333_A1,0,0,1,0,0,1
AATTCGATTCGAGGAT-1_V12N28-333_A1,0,0,0,0,2,2
AGTCTTTAAAGTGTCC-1_V12N28-333_A1,0,0,1,0,0,1
GACTAGGCCGTTAGGT-1_V12N28-333_A1,0,0,1,1,0,2
TCCAAGCCTAGACACA-1_V12N28-333_A1,0,0,0,0,1,1
GATTGGGAAAGGTTGT-1_V12N28-333_A1,0,0,0,0,0,0
GATGAGGAACCTTCGG-1_V12N28-333_A1,0,0,2,0,0,2
TGAATACCGACGCGTA-1_V12N28-333_A1,0,0,2,0,0,2
AATCGTGAGCCGAGCA-1_V12N28-333_A1,0,0,1,0,1,2
GCGAAGAATCTGACGG-1_V12N28-333_A1,0,1,2,0,1,4
GAACAACTGGGATGAA-1_V12N28-333_A1,0,0,2,0,1,3
TCGCCGACATATTCGC-1_V12N28-333_A1,0,0,0,0,0,0
CGTAGAGAGTAATTAT-1_V12N28-333_A1,0,0,5,0,1,6
CGATAGTCGTACTGCA-1_V12N28-333_A1,0,0,0,0,0,0
CGCATGCCGAATGCGT-1_V12N28-333_A1,0,1,0,0,0,1
CTCTAGCCCTCGGAAA-1_V12N28-333_A1,0,0,2,0,0,2
TCCAACTCAGCTATCT-1_V12N28-333_A1,0,0,0,0,0,0
GTCTAGTGAGCCGCTT-1_V12N28-333_A1,0,0,0,0,0,0
TACCGAATAATTGTAA-1_V12N28-333_A1,0,0,0,0,0,0
ATATAACACGGGCGCA-1_V12N28-333_A1,0,1,2,0,0,3
GCATGCTAATAACGAT-1_V12N28-333_A1,0,1,1,0,1,3
TCCGGGCTTGACGGGA-1_V12N28-333_A1,0,0,0,0,0,0
ATTATTCAGAGTCACT-1_V12N28-333_A1,0,0,3,0,0,3
TAGCAGTATGACTAAA-1_V12N28-333_A1,0,2,2,0,0,4
TATGAAGAATTAAGGT-1_V12N28-333_A1,0,0,0,0,1,1
CAAGGCCAGTGGTGCA-1_V12N28-333_A1,0,0,2,0,0,2
TGCGTACGGCTAATTG-1_V12N28-333_A1,0,0,2,0,0,2
CAGATAATGGGCGGGT-1_V12N28-333_A1,0,2,0,0,1,3
GAGAACGGTTCTGACT-1_V12N28-333_A1,0,0,1,0,1,2
CGCTTCGGTCTAAGAC-1_V12N28-333_A1,0,0,1,0,1,2
AGCATTACGAGGCAAG-1_V12N28-333_A1,0,0,2,0,0,2
AAGTTGTGATGTTATA-1_V12N28-333_A1,0,0,0,0,0,0
TTGCTCATAGTACGTG-1_V12N28-333_A1,0,0,0,0,0,0
TACTTAAACATGTACA-1_V12N28-333_A1,0,0,3,0,1,4
AGTGAGTCGAATTAAC-1_V12N28-333_A1,0,0,1,0,0,1
TAGGCCTATATAGTCT-1_V12N28-333_A1,0,1,1,0,0,2
ACTCGCCGTTCGATAA-1_V12N28-333_A1,0,0,1,0,0,1
GGTACGTTGCGGCCGG-1_V12N28-333_A1,0,0,0,0,0,0
TATTGCCGGGCTTGTA-1_V12N28-333_A1,0,1,0,0,1,2
GGTAAACTCTGCGCTG-1_V12N28-333_A1,0,1,0,0,1,2
TCCCTTGTCTGAAACT-1_V12N28-333_A1,0,1,1,0,3,5
CATGATCGCTTTGAGA-1_V12N28-333_A1,0,0,2,0,1,3
GGACGGGCGACCAACC-1_V12N28-333_A1,0,0,1,0,0,1
GAGAGGCCTATGTGTA-1_V12N28-333_A1,0,0,1,0,4,5
TCGTAACTCCCAAGAC-1_V12N28-333_A1,0,0,0,0,1,1
CGTATCTAGAACTAAG-1_V12N28-333_A1,0,0,6,0,1,7
GCACCTTCCCGAAGGT-1_V12N28-333_A1,0,0,0,0,0,0
TACCTCTTTACCATCC-1_V12N28-333_A1,0,1,0,0,3,4
TGACTCTAACTGGTAA-1_V12N28-333_A1,0,0,3,0,0,3
GAGAAACTGGATCCCA-1_V12N28-333_A1,0,1,2,0,0,3
ATCCGGACCAGCCTGA-1_V12N28-333_A1,0,0,2,0,1,3
TTATTTAGGTTCCTTA-1_V12N28-333_A1,0,2,3,0,2,7
CGAATTCCCGGTTCAA-1_V12N28-333_A1,0,0,0,0,0,0
TGGGCGATACAATAAG-1_V12N28-333_A1,0,0,0,0,0,0
TGACATGTAACGTGAC-1_V12N28-333_A1,0,0,1,0,0,1
TTGGGAAGACGAGCCG-1_V12N28-333_A1,0,0,2,0,0,2
GGTGTAAATCGATTGT-1_V12N28-333_A1,0,0,1,0,0,1
GAACTGTGGAGAGACA-1_V12N28-333_A1,0,0,3,0,0,3
TCCACATCGTATATTG-1_V12N28-333_A1,0,0,0,0,0,0
CCTATGGTCAAAGCTG-1_V12N28-333_A1,0,0,2,1,0,3
TCCTTGTCCTTTAATT-1_V12N28-333_A1,0,0,0,0,0,0
AAGTTTATGGGCCCAA-1_V12N28-333_A1,0,0,0,0,0,0
GTCCGGGTTCACATTA-1_V12N28-333_A1,0,1,2,0,0,3
ATGTAGCGCGCGTAGG-1_V12N28-333_A1,0,0,2,0,0,2
TACGGAAGCCAAACCA-1_V12N28-333_A1,0,0,0,0,1,1
GCCCTGAGGATGGGCT-1_V12N28-333_A1,0,0,0,0,0,0
CGGGCGATGGATCACG-1_V12N28-333_A1,0,0,2,0,0,2
TGCGGACTTGACTCCG-1_V12N28-333_A1,0,0,2,0,0,2
TAATACTAGAACAGAC-1_V12N28-333_A1,0,0,1,0,0,1
TCAAATTGTTGTGCCG-1_V12N28-333_A1,0,0,4,0,0,4
GGGCAGTCAACGCCAA-1_V12N28-333_A1,0,0,0,0,0,0
TCGCTGCCAATGCTGT-1_V12N28-333_A1,0,1,3,0,0,4
TACGTGGGCCCAGGGC-1_V12N28-333_A1,0,0,2,0,0,2
GCCTACGTTCTGTGCA-1_V12N28-333_A1,0,1,6,0,0,7
TTGCGTGTGTAGGCAT-1_V12N28-333_A1,0,0,1,0,0,1
TCCTAAAGATTCAGAC-1_V12N28-333_A1,0,1,2,0,0,3
TGGGTGCACAAGCCAT-1_V12N28-333_A1,0,0,4,0,0,4
GGGAGCGACCGTAGTG-1_V12N28-333_A1,0,3,6,0,0,9
CATAGAGGAGATACTA-1_V12N28-333_A1,0,0,1,0,0,1
CTTCGATTGCGCAAGC-1_V12N28-333_A1,0,0,2,0,1,3
GTGCCTGAGACCAAAC-1_V12N28-333_A1,0,0,1,0,0,1
TCATCCTCAGCTGCTT-1_V12N28-333_A1,0,1,1,0,0,2
TGCAACTACTGGTTGA-1_V12N28-333_A1,0,0,2,0,0,2
ATGTTGATTAGAGACT-1_V12N28-333_A1,0,0,1,0,0,1
GTTTCTAGAGGCGCGG-1_V12N28-333_A1,0,0,0,0,0,0
TACAAGGGCTTCTTTA-1_V12N28-333_A1,0,0,2,0,1,3
ACAGGCACGGATCCTT-1_V12N28-333_A1,0,1,0,0,0,1
CCCAAGTCATTACACT-1_V12N28-333_A1,0,1,2,0,0,3
ACTCTGACCTAATAGA-1_V12N28-333_A1,0,0,1,0,0,1
GGATGGCTTGAAGTAT-1_V12N28-333_A1,0,0,3,0,0,3
ACCCTCCCGTCAGGGC-1_V12N28-333_A1,0,0,1,0,1,2
AGCTTCTTCTCGAGCA-1_V12N28-333_A1,0,0,1,0,0,1
TTGCGCTTGATCAATA-1_V12N28-333_A1,0,0,1,0,1,2
TGGGTGTAATAGATTT-1_V12N28-333_A1,0,0,3,0,0,3
CATGGTTTATTAATCA-1_V12N28-333_A1,0,0,2,0,0,2
TTGCCTTCTCGCCGGG-1_V12N28-333_A1,0,1,0,0,0,1
TTAAAGTAAGTCGCCA-1_V12N28-333_A1,0,0,2,0,0,2
AGTTGGCAAGGCTAGA-1_V12N28-333_A1,0,0,2,0,0,2
CCGCACTTGCAATGAC-1_V12N28-333_A1,0,2,2,0,2,6
AATGTTGTCGTGAGAC-1_V12N28-333_A1,0,1,2,0,2,5
CCAAGGTTGCCCTTTC-1_V12N28-333_A1,0,0,2,0,0,2
TGTGACTAGAGTTTGC-1_V12N28-333_A1,0,2,2,0,0,4
TTGTGATCTGTTCAGT-1_V12N28-333_A1,0,1,0,0,0,1
GGAGTTGATTCTGTGT-1_V12N28-333_A1,0,1,0,0,0,1
GTAGTGAGCAACCTCA-1_V12N28-333_A1,0,1,4,0,1,6
AAGACATACGTGGTTT-1_V12N28-333_A1,0,0,4,0,1,5
CATCCCGAGATTCATA-1_V12N28-333_A1,0,1,3,0,1,5
GGCCGCAGGAACCGCA-1_V12N28-333_A1,3,0,3,0,0,6
CCAGAAACTGATGCGA-1_V12N28-333_A1,0,0,1,0,0,1
ACCCGTAGTCTAGTTG-1_V12N28-333_A1,1,1,1,0,0,3
AGGGTCTGGACGCAGT-1_V12N28-333_A1,0,0,4,0,1,5
TTGAAACCCTCATTCC-1_V12N28-333_A1,0,0,2,0,0,2
TCAATCCCGCGCCAAA-1_V12N28-333_A1,0,1,3,0,0,4
AGGACATCGGCACACT-1_V12N28-333_A1,0,0,0,0,2,2
GACAAGACGCCCGTGC-1_V12N28-333_A1,0,1,5,1,1,8
GAGTAAATTAAGAACC-1_V12N28-333_A1,0,0,3,0,1,4
TAAGTCGGTGAGCTAG-1_V12N28-333_A1,0,0,0,0,1,1
CTTACTGACTCCTCTG-1_V12N28-333_A1,0,1,2,0,0,3
TTAACTGATCGTTTGG-1_V12N28-333_A1,0,0,2,0,1,3
GTTGTAGATTTATGAG-1_V12N28-333_A1,0,0,0,0,0,0
CTATTTGCTTGGAGGA-1_V12N28-333_A1,1,0,2,0,1,4
AGCCATATAGTATGTG-1_V12N28-333_A1,1,1,0,0,0,2
TGTTCCGGCCTGAGCT-1_V12N28-333_A1,0,1,3,0,0,4
TGCCGTGGGACCCAAT-1_V12N28-333_A1,0,0,3,0,0,3
TTGCAAGAAGACTCCT-1_V12N28-333_A1,0,0,0,0,1,1
CCGCTCCAGGGCGATC-1_V12N28-333_A1,0,0,6,0,0,6
CAAACCCTCCGGCGGG-1_V12N28-333_A1,0,0,1,0,0,1
CGGACCTTTACGTCCC-1_V12N28-333_A1,1,0,0,0,0,1
ACGTAGGAGAGTCGCT-1_V12N28-333_A1,0,0,0,0,0,0
CTGCGACCTCGCCGAA-1_V12N28-333_A1,0,0,0,0,0,0
GGCCCAGCTGGTTTGC-1_V12N28-333_A1,0,0,1,0,0,1
GGATTAATCATGGACC-1_V12N28-333_A1,0,0,2,0,0,2
GAGATGGCTTTAATCA-1_V12N28-333_A1,0,0,1,0,0,1
AGTACAGAAGCTTATA-1_V12N28-333_A1,0,0,2,0,0,2
GCGGCTTTAGCAAGTT-1_V12N28-333_A1,0,0,1,0,0,1
ACCGAGTCTCCTTATT-1_V12N28-333_A1,0,0,1,0,2,3
GACCACACTTCCCTTT-1_V12N28-333_A1,0,0,2,0,0,2
TGTAGCCAATTCCGTT-1_V12N28-333_A1,0,0,3,0,0,3
CTCGTCTGTGCCTTCG-1_V12N28-333_A1,0,0,1,0,0,1
GGACTCTTTGACTAAG-1_V12N28-333_A1,0,0,0,0,1,1
TCATCGACGACCGTCG-1_V12N28-333_A1,0,0,3,0,0,3
TACTACGTGCAATGCG-1_V12N28-333_A1,0,2,1,0,0,3
CCCTACTTGAACAATG-1_V12N28-333_A1,0,0,3,0,0,3
GCAGCTGTCAACGCAT-1_V12N28-333_A1,0,0,2,0,0,2
ATCTACCATCTGCTCC-1_V12N28-333_A1,0,1,0,0,0,1
TCTCAAATCAATCGGG-1_V12N28-333_A1,0,0,4,0,0,4
ACTCCGGCCGACCACT-1_V12N28-333_A1,0,0,3,0,0,3
TACACCTCTTCGAATC-1_V12N28-333_A1,0,0,3,0,1,4
GTGGCTGTTTCTGTTC-1_V12N28-333_A1,0,0,1,0,1,2
ACGACTCTAGGGCCGA-1_V12N28-333_A1,0,0,0,0,2,2
TCGTTTACGCGACCCT-1_V12N28-333_A1,0,0,0,0,0,0
AGGATATCCGACTGCA-1_V12N28-333_A1,0,0,2,0,0,2
GACACTTCCAATTACC-1_V12N28-333_A1,0,0,0,0,0,0
ACGGTACAGTTCAATG-1_V12N28-333_A1,0,1,1,0,0,2
CTTGATGACCATCCAG-1_V12N28-333_A1,0,0,2,0,0,2
CTGGTAAAGACTTACA-1_V12N28-333_A1,0,0,0,0,0,0
CTTGCCCACCCACGCA-1_V12N28-333_A1,0,0,2,0,0,2
CATTACGCAGGAAGGG-1_V12N28-333_A1,0,0,1,0,1,2
GGACAACCATGAAGCC-1_V12N28-333_A1,0,0,1,0,1,2
GTTATCAAGCTATCGA-1_V12N28-333_A1,0,0,1,0,0,1
AGGTGCACGTCCACAT-1_V12N28-333_A1,0,0,1,0,1,2
AAAGAATGTGGACTAA-1_V12N28-333_A1,0,0,2,0,0,2
ACCAAGTCATCGGCAG-1_V12N28-333_A1,0,2,1,0,1,4
AGTAACTATAGCAGCC-1_V12N28-333_A1,0,0,1,0,0,1
GGGAAAGAATGCCAAC-1_V12N28-333_A1,0,0,2,0,0,2
AATCGGTATAGCCCTC-1_V12N28-333_A1,0,0,2,0,0,2
GGCACTGCGGTGGTTT-1_V12N28-333_A1,0,0,2,0,1,3
CGTCCTCATCGCGTGC-1_V12N28-333_A1,0,0,1,0,0,1
CTTAACTTACAGTATA-1_V12N28-333_A1,0,0,2,0,0,2
GTGAGTCGACTAATAG-1_V12N28-333_A1,0,0,5,0,2,7
TGTACTTCCGGGCATG-1_V12N28-333_A1,0,1,2,0,1,4
CACAAACCGCAGAACT-1_V12N28-333_A1,0,1,2,0,0,3
GCTTTACACAACTGGG-1_V12N28-333_A1,0,0,2,0,2,4
CACCGATGATGGGTAC-1_V12N28-333_A1,0,0,2,0,1,3
TCAATATACAGGAGGC-1_V12N28-333_A1,0,0,3,0,1,4
AACGACCTCCTAGCCG-1_V12N28-333_A1,0,1,1,1,0,3
GTTACCAAGGCGTACG-1_V12N28-333_A1,0,0,5,0,0,5
TAGCTCACTGTGTTTG-1_V12N28-333_A1,0,1,1,0,2,4
TCGGCAGGGTTAAGGG-1_V12N28-333_A1,0,0,5,0,2,7
TGTTAACAAAGTGACT-1_V12N28-333_A1,0,1,1,0,2,4
CAGAGCGATGGATGCT-1_V12N28-333_A1,0,1,4,0,4,9
AAACGCTGGGCACGAC-1_V12N28-333_A1,0,1,0,0,1,2
TGTTCTCATACTATAG-1_V12N28-333_A1,0,0,0,0,0,0
TAGGTTCTGCTGAGAA-1_V12N28-333_A1,0,0,0,0,0,0
GCCTGTCCCGGTGCAT-1_V12N28-333_A1,1,0,1,0,0,2
GGCCTGCTCTGATGTT-1_V12N28-333_A1,2,1,2,0,0,5
TAGAGGGAGTTTATCT-1_V12N28-333_A1,0,1,1,0,0,2
CTCTACATCCTGCGTG-1_V12N28-333_A1,1,0,3,0,0,4
ACACATTTCCGTAGAC-1_V12N28-333_A1,2,0,0,0,0,2
TGGGTGTTAAGTAGAA-1_V12N28-333_A1,0,0,4,0,1,5
GAGCTCAACATGAGCG-1_V12N28-333_A1,0,0,0,0,0,0
GCACACAGCTATTACC-1_V12N28-333_A1,0,0,3,0,0,3
GCGACGGTAGTCTCCT-1_V12N28-333_A1,0,0,3,0,0,3
GTATCAAGGTACTTCC-1_V12N28-333_A1,2,0,2,0,0,4
GGAAAGGGAATTGAGC-1_V12N28-333_A1,0,0,1,0,0,1
TACACAGCCGTGGTGC-1_V12N28-333_A1,0,0,1,0,0,1
CGGTTGGGCAGGGTCC-1_V12N28-333_A1,0,1,1,0,0,2
GCACGCCGATTCCCGC-1_V12N28-333_A1,0,1,6,0,0,7
CGCTTTCCGCCAAGGT-1_V12N28-333_A1,0,0,2,0,0,2
TGCCCGATAGTTAGAA-1_V12N28-333_A1,0,0,3,0,0,3
TCAGAACGGCGGTAAT-1_V12N28-333_A1,0,0,2,0,0,2
CCACTCAGATCCGCAA-1_V12N28-333_A1,0,0,2,0,0,2
GAAGGGTCATTAAGAC-1_V12N28-333_A1,0,0,3,0,0,3
GCGGTCTTGCTTTCAC-1_V12N28-333_A1,0,0,2,0,0,2
GGAAGGACACCGTATA-1_V12N28-333_A1,0,0,2,0,0,2
CGCGGGAATTCCTTTC-1_V12N28-333_A1,0,0,1,0,0,1
TCTATCCGATTGCACA-1_V12N28-333_A1,1,0,4,0,0,5
TACTCGTTTGAATCAA-1_V12N28-333_A1,0,0,2,0,0,2
GTCTGCCGACTCGACG-1_V12N28-333_A1,0,1,2,0,0,3
TACGGGTAATAACATA-1_V12N28-333_A1,0,0,0,0,0,0
CCAGTTCGGTAACTCA-1_V12N28-333_A1,0,0,0,0,0,0
CGTGCACACCACTGTA-1_V12N28-333_A1,0,0,1,0,0,1
CTTCAGTTGGACAACG-1_V12N28-333_A1,0,0,4,0,1,5
TGATCTATCACACTCT-1_V12N28-333_A1,0,0,2,0,0,2
TAGCAGATACTTAGGG-1_V12N28-333_A1,0,2,2,0,0,4
CACCGGGCATCACAAG-1_V12N28-333_A1,0,0,2,0,0,2
AGTGGCCCGCAAATGG-1_V12N28-333_A1,0,1,0,0,0,1
CTCGCTAGGTAAGCGA-1_V12N28-333_A1,0,1,0,0,0,1
GATAGATAGTACAGTC-1_V12N28-333_A1,0,0,1,0,1,2
CGAGACTACTGCTGCT-1_V12N28-333_A1,0,0,1,0,0,1
ACATTTGAAACCTAAC-1_V12N28-333_A1,0,0,2,0,0,2
GACACAGCCGGGACTG-1_V12N28-333_A1,0,1,3,1,0,5
ACGGAACACGAGTGCC-1_V12N28-333_A1,0,0,1,0,0,1
ACGCCAGTGCGTTTGC-1_V12N28-333_A1,0,0,1,0,0,1
GCACCTAGGCGAGTCC-1_V12N28-333_A1,0,0,1,1,0,2
TCACTATCCCTTCGGT-1_V12N28-333_A1,0,0,2,0,2,4
TGAGTGTAACAACGGG-1_V12N28-333_A1,0,1,1,0,0,2
ATTGGTTGTGCATTAC-1_V12N28-333_A1,0,0,1,0,0,1
CTGGCGATTTACATGT-1_V12N28-333_A1,0,0,1,0,1,2
TCCACCAAGACATAGG-1_V12N28-333_A1,0,0,1,0,0,1
AACGTCGCTGCACTTC-1_V12N28-333_A1,0,0,3,0,0,3
GTCTCCCGAGTCCCGT-1_V12N28-333_A1,0,1,2,0,0,3
AGCCCGCACTACAATG-1_V12N28-333_A1,0,0,0,0,0,0
GGCACGCTGCTACAGT-1_V12N28-333_A1,0,0,0,0,0,0
GCTTGAGTGACCTCTG-1_V12N28-333_A1,0,0,3,0,1,4
ATAGCCATAACAGTCA-1_V12N28-333_A1,0,0,2,0,1,3
TAGGAGGCTCGAGAAC-1_V12N28-333_A1,0,0,2,0,0,2
GTCGGGTGAAGTACCG-1_V12N28-333_A1,0,1,4,0,0,5
CACCCGCGTTTGACAC-1_V12N28-333_A1,0,0,0,0,1,1
TCTCAGGCTACTCGCT-1_V12N28-333_A1,0,0,5,1,1,7
TAGATTCTCTAGCAAA-1_V12N28-333_A1,0,0,0,0,0,0
CCCATTATTGTATCCT-1_V12N28-333_A1,0,0,1,0,0,1
GTTAATAGCGTCATTA-1_V12N28-333_A1,0,0,0,0,0,0
TAGTGACAAGCTCTAC-1_V12N28-333_A1,0,0,1,0,0,1
ATCGCCGTGGTTCATG-1_V12N28-333_A1,0,2,2,0,1,5
GATTTGCGCTAACACC-1_V12N28-333_A1,0,0,1,1,0,2
GATTCTGTTAATGAGT-1_V12N28-333_A1,0,0,0,0,0,0
GGACACCTCGGTGTTG-1_V12N28-333_A1,0,0,0,0,0,0
CGATCGAGAAGCACCA-1_V12N28-333_A1,0,1,1,1,0,3
CTGCTCTGACGGCAAA-1_V12N28-333_A1,0,0,2,1,0,3
CCCAGGAAGAATTCGA-1_V12N28-333_A1,0,0,3,0,0,3
TGTCGTGGGTATAGGC-1_V12N28-333_A1,0,0,3,0,1,4
ATATGTCTAGAGCGTG-1_V12N28-333_A1,0,0,1,0,0,1
GCGGGCAGACGGGTGA-1_V12N28-333_A1,0,0,2,0,1,3
CGAAGATCAGTTTCAT-1_V12N28-333_A1,0,0,3,0,0,3
ACGCCACTCGAAACAG-1_V12N28-333_A1,0,0,3,2,0,5
CTTAGATGTTTCATCC-1_V12N28-333_A1,0,1,3,0,0,4
GCGAATGGACTAGCGA-1_V12N28-333_A1,0,0,1,1,0,2
TAAATTGTGGGTAAAG-1_V12N28-333_A1,0,0,3,0,0,3
ATTTATACTGGTAAAG-1_V12N28-333_A1,0,0,5,0,1,6
GCGTCGTAACATGGTC-1_V12N28-333_A1,0,0,3,0,0,3
CGGTATGGGCACTCTG-1_V12N28-333_A1,0,0,4,2,0,6
CTATCACAACGCTGGA-1_V12N28-333_A1,0,0,3,0,0,3
ACCACACGGTTGATGG-1_V12N28-333_A1,0,0,0,1,0,1
TCAGCGCACGCCGTTT-1_V12N28-333_A1,0,0,1,0,0,1
AATGTTAAGACCCTGA-1_V12N28-333_A1,0,0,1,0,0,1
CTTACATAGATTTCTT-1_V12N28-333_A1,0,0,1,0,0,1
AACATAGCGTGTATCG-1_V12N28-333_A1,0,0,5,1,0,6
AGCAGTCGAAGCATGC-1_V12N28-333_A1,0,0,0,0,0,0
GTACTACGGCCTCGTT-1_V12N28-333_A1,0,0,4,1,0,5
TTGGCCAAATTGTATC-1_V12N28-333_A1,0,1,4,0,0,5
TCAGAGGACGCGTTAG-1_V12N28-333_A1,0,1,2,0,0,3
AGTAATCTAAGGGTGG-1_V12N28-333_A1,0,0,3,1,0,4
AATTATACCCAGCAAG-1_V12N28-333_A1,0,0,0,1,0,1
CCCTACCCACACCCAG-1_V12N28-333_A1,0,0,3,1,0,4
CTCTGTCCATGCACCA-1_V12N28-333_A1,0,0,1,0,0,1
TCGCCTCCTTCGGCTC-1_V12N28-333_A1,0,0,3,0,0,3
CCTGATTCGCGAAGAA-1_V12N28-333_A1,0,0,1,0,0,1
GACTTCAACGCATCAA-1_V12N28-333_A1,0,0,2,0,0,2
GCTTCCCGTAAGCTCC-1_V12N28-333_A1,0,0,0,0,0,0
AGAACTGTACTTTGTA-1_V12N28-333_A1,0,0,1,1,1,3
CCTTAAGTACGCAATT-1_V12N28-333_A1,0,0,4,1,0,5
GGCCAATTGTATAGAC-1_V12N28-333_A1,0,0,1,0,0,1
AGAATACAGGCTATCC-1_V12N28-333_A1,0,0,3,0,1,4
AATACCTGATGTGAAC-1_V12N28-333_A1,0,0,1,0,0,1
TAGAGTGTTCCGGGTA-1_V12N28-333_A1,0,0,2,0,0,2
GCTTCCATGTAACCGC-1_V12N28-333_A1,0,1,1,0,1,3
GGTTCGCATTTGCCGT-1_V12N28-333_A1,0,0,0,0,0,0
TCAATCCGGGAAGTTT-1_V12N28-333_A1,0,0,1,0,0,1
CCGGAAGTGCAATATG-1_V12N28-333_A1,0,0,1,0,0,1
GACGGGCATCGAATTT-1_V12N28-333_A1,0,0,1,0,0,1
TACAACAGCGCATACA-1_V12N28-333_A1,0,0,0,0,0,0
TCTACCCGCATCATTT-1_V12N28-333_A1,0,0,0,0,0,0
GTCTTACCACGCCAAG-1_V12N28-333_A1,0,0,0,0,0,0
GGCTGTCCTACTGCGG-1_V12N28-333_A1,0,0,3,0,0,3
TACTGCATGATTAAAT-1_V12N28-333_A1,0,0,2,0,0,2
CGGACCTCTGTAGTTA-1_V12N28-333_A1,0,0,1,0,0,1
CCCTAGCTCTAAGGTC-1_V12N28-333_A1,0,0,1,0,0,1
ATGTCATAATAAACGA-1_V12N28-333_A1,0,0,0,0,0,0
CTTAATCGACTTAGTA-1_V12N28-333_A1,0,0,0,0,0,0
CTAAAGGATGAGATAC-1_V12N28-333_A1,0,0,1,1,0,2
GTGCTATCCAGCTGGA-1_V12N28-333_A1,0,0,3,0,0,3
GACAGAGGTCTTCAGT-1_V12N28-333_A1,0,0,4,0,0,4
TCGATTTACGAAACGA-1_V12N28-333_A1,0,0,0,0,0,0
AGGCTTAAGTTGCACA-1_V12N28-333_A1,0,0,0,0,0,0
TAGGATCTTAACCGCA-1_V12N28-333_A1,0,0,0,0,0,0
GACTTTCGAGCGGTTC-1_V12N28-333_A1,0,0,2,0,0,2
CCCTGGGAGGGATCCT-1_V12N28-333_A1,0,0,1,0,0,1
TAGTAGTTGCCGGACA-1_V12N28-333_A1,0,0,0,0,0,0
GCCCTAAGTGCAGGAT-1_V12N28-333_A1,0,0,4,0,0,4
ACTTGGGCTTTCGCCA-1_V12N28-333_A1,0,0,2,0,0,2
CATGATACGGTGAAAC-1_V12N28-333_A1,0,0,3,0,0,3
TCCTGCAGCCGCCAAT-1_V12N28-333_A1,0,0,3,0,0,3
GTCCGTTAGAGGGCCT-1_V12N28-333_A1,0,0,0,0,0,0
GCTTTATTAAGTTACC-1_V12N28-333_A1,0,0,3,0,0,3
AATCGAGGTCTCAAGG-1_V12N28-333_A1,0,0,2,0,0,2
GTGCTGTTAGAACATA-1_V12N28-333_A1,0,1,1,0,0,2
GGCTTCTCGTGGGTGG-1_V12N28-333_A1,0,0,1,0,0,1
CCTACAGTTGAGGGAG-1_V12N28-333_A1,0,1,3,1,0,5
TATCCCTCGATCTGCA-1_V12N28-333_A1,0,0,2,0,0,2
CCGGTATCTGGCGACT-1_V12N28-333_A1,0,0,1,0,0,1
CTCTAACACCGGCAGC-1_V12N28-333_A1,0,0,2,0,0,2
CTTCATCACCAGGGCT-1_V12N28-333_A1,0,0,1,0,0,1
GGCTGGCAATCCCACG-1_V12N28-333_A1,0,0,1,0,0,1
CAAACCATAAGCGTAT-1_V12N28-333_A1,0,0,1,0,0,1
CATGTGGGCTCATCAC-1_V12N28-333_A1,0,0,4,0,0,4
CCCGTGACAGTGCCTT-1_V12N28-333_A1,0,0,0,0,0,0
GATTATCTTGCATTAT-1_V12N28-333_A1,0,0,1,0,0,1
TGTACTATCGCTCGTT-1_V12N28-333_A1,0,1,2,2,0,5
TTAGCGAATAGATAGG-1_V12N28-333_A1,0,0,0,0,0,0
ACATACAATCAAGCGG-1_V12N28-333_A1,0,0,3,1,0,4
GCTAGCAACGCACCTA-1_V12N28-333_A1,0,0,0,0,0,0
