key,other,neuron,oligo,microglia,astrocyte,n_cells
TACCGATCCAACACTT-1_V10B01-087_D1,0,0,0,0,0,0
ATTAAAGCGGACGAGC-1_V10B01-087_D1,0,0,0,0,0,0
GATAAGGGACGATTAG-1_V10B01-087_D1,0,0,0,0,0,0
GTGCAAATCACCAATA-1_V10B01-087_D1,0,0,0,0,0,0
TGTTGGCTGGCGGAAG-1_V10B01-087_D1,0,0,0,0,0,0
GCATCCTCTCCTATTA-1_V10B01-087_D1,0,0,0,0,0,0
GCGAGGGACTGCTAGA-1_V10B01-087_D1,0,0,0,0,0,0
TGGTACCGGCACAGCC-1_V10B01-087_D1,0,0,0,0,0,0
GCGCGTTTAAATCGTA-1_V10B01-087_D1,0,1,1,0,0,2
TGCCTTGCCCTTACGG-1_V10B01-087_D1,0,0,0,0,0,0
GACGACTTTCCAAGAA-1_V10B01-087_D1,0,0,0,0,0,0
CCAGTGAGCTCCTTGT-1_V10B01-087_D1,0,0,0,0,0,0
ATACCCTGGCTCAAAT-1_V10B01-087_D1,0,2,0,0,0,2
GGGTTTCCGGCTTCCA-1_V10B01-087_D1,1,0,0,0,0,1
TAACCGTCCAGTTCAT-1_V10B01-087_D1,2,0,1,0,0,3
AAACAACGAATAGTTC-1_V10B01-087_D1,3,1,2,0,0,6
CAAGGGAGTGTATTTG-1_V10B01-087_D1,1,0,1,0,0,2
CCAAGCTTGATCTCCT-1_V10B01-087_D1,5,0,2,0,0,7
TTATTTCATCCCAAAC-1_V10B01-087_D1,2,0,0,0,0,2
GAGCGCTATGTCAGGC-1_V10B01-087_D1,2,0,0,1,0,3
TATGGCAGACTTTCGA-1_V10B01-087_D1,1,1,0,0,0,2
CTTCGTGCCCGCATCG-1_V10B01-087_D1,3,1,0,0,0,4
AAACGGGTTGGTATCC-1_V10B01-087_D1,4,0,0,0,0,4
TGCAAACCCACATCAA-1_V10B01-087_D1,4,1,1,0,0,6
GACGGGATGTCTTATG-1_V10B01-087_D1,1,1,0,0,0,2
GGCGAGCATCGAGGAC-1_V10B01-087_D1,5,0,1,0,0,6
CGCGTGCTATCAACGA-1_V10B01-087_D1,3,0,0,0,0,3
TGAAACCTCAACTCAC-1_V10B01-087_D1,3,0,1,0,0,4
CACATAAGGCGACCGT-1_V10B01-087_D1,4,0,0,0,0,4
TGACCCAACTCACATT-1_V10B01-087_D1,2,1,0,0,0,3
ATACGCCGATCTACCG-1_V10B01-087_D1,3,0,0,0,0,3
ACTTATCTGATCTATA-1_V10B01-087_D1,2,1,0,0,0,3
GTGTGAGCCGAGGTGC-1_V10B01-087_D1,5,0,1,0,0,6
GATGATTTGAAACTGG-1_V10B01-087_D1,3,1,2,0,0,6
GGGAACCACCTGTTTC-1_V10B01-087_D1,1,0,2,0,0,3
GTTCGTTGCGGACCAG-1_V10B01-087_D1,0,0,0,0,0,0
TGAGGTTGATCCCAAG-1_V10B01-087_D1,2,1,1,0,0,4
GATGCCACACTACAGC-1_V10B01-087_D1,5,0,1,0,0,6
AGGCAAAGAGGAATCA-1_V10B01-087_D1,4,0,1,0,0,5
AAGTAAGCTTCCAAAC-1_V10B01-087_D1,4,2,1,0,0,7
AACGTAGTCTACCCAT-1_V10B01-087_D1,4,2,1,0,0,7
GTTTGAGCGGTTATGT-1_V10B01-087_D1,7,1,2,0,0,10
GAAGCAAGGCAATGTT-1_V10B01-087_D1,0,0,0,0,0,0
TCACTCAGCGCATTAG-1_V10B01-087_D1,5,1,2,0,0,8
TACAATGAAACCAGCA-1_V10B01-087_D1,3,0,0,0,0,3
GTGCGCTTACAAATGA-1_V10B01-087_D1,1,1,0,0,0,2
GCACTCCCACAGTCCC-1_V10B01-087_D1,3,2,0,0,0,5
CGAAGACTGCCCGGGA-1_V10B01-087_D1,1,3,1,0,0,5
CAGGATCCGCCCGACC-1_V10B01-087_D1,0,3,3,1,0,7
CACGATTGGTCGTTAA-1_V10B01-087_D1,0,2,0,0,0,2
GGTTGTATCGTGAAAT-1_V10B01-087_D1,2,1,0,0,0,3
TCTTATGGGTAGTACC-1_V10B01-087_D1,4,2,1,0,0,7
TACAAGCTGTTCACTG-1_V10B01-087_D1,3,2,2,0,0,7
GTATCTTGTTGCTCAC-1_V10B01-087_D1,1,1,0,0,0,2
ATACCAGGTGAGCGAT-1_V10B01-087_D1,2,1,2,0,0,5
CCTAAACAGGGTCCGT-1_V10B01-087_D1,1,0,0,0,0,1
ATGGTGCTCAAAGCCA-1_V10B01-087_D1,0,0,0,0,0,0
CAAATGCGGAGTGTTC-1_V10B01-087_D1,2,0,2,1,0,5
CGTGCCCGACATTTGT-1_V10B01-087_D1,1,1,2,0,0,4
GTATCTCCCTAACTGT-1_V10B01-087_D1,1,1,0,0,0,2
ATTTGCCTAGTTACGA-1_V10B01-087_D1,2,0,4,0,0,6
ACGTCCTAAACGAGAT-1_V10B01-087_D1,2,0,0,0,0,2
CTGGGATCGCCCAGAT-1_V10B01-087_D1,2,1,1,0,0,4
CTGCAAATGGGCTCCA-1_V10B01-087_D1,2,1,1,0,0,4
CATTATAACAGGGTCC-1_V10B01-087_D1,5,0,1,0,0,6
ACCTTTCCTTTAGAAG-1_V10B01-087_D1,1,2,0,0,0,3
ATAGATTTGCAGTCGG-1_V10B01-087_D1,0,1,0,0,0,1
CTCGGGCATCGTCGGG-1_V10B01-087_D1,2,0,0,0,0,2
GTGGCGGGCCGTAGCT-1_V10B01-087_D1,4,1,2,0,0,7
CAACAGTGCCAAACGG-1_V10B01-087_D1,1,0,0,0,0,1
TGCGGGTATTGGGATC-1_V10B01-087_D1,3,1,2,1,0,7
GTCTCGCCAACACGCC-1_V10B01-087_D1,2,0,0,0,0,2
CTGGGCGGCCAAATGT-1_V10B01-087_D1,0,1,0,1,0,2
TAAAGGAGAAACTAGT-1_V10B01-087_D1,1,0,0,0,0,1
TCCCACGGAGGGAGCT-1_V10B01-087_D1,5,1,0,0,0,6
AGCTTCAATACTTTGA-1_V10B01-087_D1,3,2,0,0,0,5
TTCCACATTTCTCGTC-1_V10B01-087_D1,3,2,2,0,0,7
ACAAACCGACAAGGCG-1_V10B01-087_D1,2,1,0,0,0,3
AGACGGGATTGGTATA-1_V10B01-087_D1,2,0,0,0,0,2
AACCTAAAGCCGTCCG-1_V10B01-087_D1,3,0,0,0,0,3
TACAAATTGCGGAGGT-1_V10B01-087_D1,2,2,0,0,0,4
CCCGCTAGAGGGTTAA-1_V10B01-087_D1,3,0,0,0,0,3
CATTGCAAAGCATAAT-1_V10B01-087_D1,5,0,0,0,0,5
TGTACGCTATCAGCTT-1_V10B01-087_D1,1,0,0,0,0,1
TTCTTCGCAATAGAGC-1_V10B01-087_D1,1,0,0,0,0,1
TGTGATTCCAGCGCTT-1_V10B01-087_D1,2,2,0,1,0,5
ATTCAGGATCGCCTCT-1_V10B01-087_D1,1,0,0,0,0,1
GCCCATGGGTGCAATG-1_V10B01-087_D1,2,2,0,0,0,4
TTCCCGACGCTTCACT-1_V10B01-087_D1,4,1,0,1,0,6
AGCGGTTGAGATGTAC-1_V10B01-087_D1,1,0,0,0,1,2
GCTGTCTGTGATCGAC-1_V10B01-087_D1,0,0,0,0,0,0
AAAGACATGAAGTTTA-1_V10B01-087_D1,5,0,0,0,0,5
CAACAGAATAACGCTA-1_V10B01-087_D1,2,0,0,0,0,2
TGCGGTCTACGAGTAA-1_V10B01-087_D1,3,0,0,1,0,4
AAGACTCACGCCCACT-1_V10B01-087_D1,3,2,2,0,0,7
CTTTGAAACATATTCC-1_V10B01-087_D1,1,2,0,1,0,4
CTGGGCACTAGTCGGA-1_V10B01-087_D1,2,2,0,0,0,4
CGCCCTTACATCCACC-1_V10B01-087_D1,2,0,0,0,0,2
CACGACCACAGACTTT-1_V10B01-087_D1,2,1,0,0,0,3
CAATCCATTATCCGTT-1_V10B01-087_D1,0,1,0,0,0,1
GTGGCGTGCACCAGAG-1_V10B01-087_D1,5,1,1,0,0,7
CGGAGTCCTAACCTGG-1_V10B01-087_D1,2,0,0,0,0,2
GGTCCCATAACATAGA-1_V10B01-087_D1,3,1,0,1,0,5
ATCTCATAAACCTACC-1_V10B01-087_D1,2,2,1,0,0,5
TGCATGGCAGTCTTGC-1_V10B01-087_D1,2,3,1,1,0,7
TTGCAGGTCATGAAGT-1_V10B01-087_D1,1,2,0,0,0,3
AGCTGCATTTGAGGTG-1_V10B01-087_D1,0,1,0,0,1,2
TAATCAGGAATGCTGC-1_V10B01-087_D1,0,0,0,0,0,0
CCATCATAAGAACAGG-1_V10B01-087_D1,3,2,0,0,0,5
TCGTATCACCAAGCTA-1_V10B01-087_D1,4,0,0,0,0,4
ATTCAGATGAATCCCT-1_V10B01-087_D1,3,2,0,0,0,5
AAAGGTCAACGACATG-1_V10B01-087_D1,1,3,3,0,0,7
AGCTGCTGTGCCGAAT-1_V10B01-087_D1,0,0,1,0,0,1
CTAGCGCCAATCCTAC-1_V10B01-087_D1,1,0,0,0,3,4
GCTCGACCGAACTGAA-1_V10B01-087_D1,0,0,1,0,0,1
ACAGTGCAGCGCATTT-1_V10B01-087_D1,0,0,1,0,0,1
CGGCTGAAGGTTACGC-1_V10B01-087_D1,0,2,1,0,0,3
CACCTCTACGAGTGTG-1_V10B01-087_D1,1,0,0,0,0,1
ATACGACAGATGGGTA-1_V10B01-087_D1,2,1,0,0,0,3
ACTTCCTGTCGTGCGA-1_V10B01-087_D1,0,1,0,0,0,1
CGTAACGGAACGATCA-1_V10B01-087_D1,0,0,2,0,0,2
AAATCACTCCTAAACG-1_V10B01-087_D1,2,0,2,0,0,4
CTCCGAGTAAATCCGC-1_V10B01-087_D1,2,0,4,0,0,6
ACGCTAGTATCAGTGC-1_V10B01-087_D1,1,1,1,0,0,3
AGAGTGAACAGACACC-1_V10B01-087_D1,3,0,1,2,0,6
ACACCCGTAAATCTGT-1_V10B01-087_D1,2,0,0,0,0,2
GCTTTGCTGCCGGGTA-1_V10B01-087_D1,1,1,0,0,0,2
ACAGGAGGCGCAGCCG-1_V10B01-087_D1,0,0,0,0,0,0
AGGCAATACGGAGGAC-1_V10B01-087_D1,0,0,0,0,0,0
TGGTGTGACAGACGAT-1_V10B01-087_D1,0,0,0,0,0,0
ATCTATCGATGATCAA-1_V10B01-087_D1,0,1,1,0,0,2
CGGTAACAAGATACAT-1_V10B01-087_D1,3,0,0,0,0,3
TCGCCGGAGAGTCTTA-1_V10B01-087_D1,4,1,1,0,0,6
GGAGGAGTGTGTTTAT-1_V10B01-087_D1,2,2,0,0,0,4
TTAGGTGTGACTGGTC-1_V10B01-087_D1,0,0,0,1,0,1
CAGGGCTAACGAAACC-1_V10B01-087_D1,2,0,0,0,0,2
CCCGTGGGTTAATTGA-1_V10B01-087_D1,10,0,0,1,0,11
GACCGACCGCTAATAT-1_V10B01-087_D1,3,0,1,0,0,4
GGTATCAAGCATAGAA-1_V10B01-087_D1,2,0,1,0,0,3
TGCATGAGTAGATTCG-1_V10B01-087_D1,1,0,2,0,0,3
AATTCCAACTTGGTGA-1_V10B01-087_D1,3,2,1,0,0,6
TGCCGATGTCATCAAT-1_V10B01-087_D1,3,1,0,0,0,4
GCTGGGTCCGCTGTTA-1_V10B01-087_D1,3,2,0,0,0,5
TGAACACCCGAAGCAG-1_V10B01-087_D1,0,0,0,0,0,0
AACATTGGTCAGCCGT-1_V10B01-087_D1,2,2,1,0,0,5
GTGGGTCTTCTTTGCG-1_V10B01-087_D1,3,0,1,0,0,4
CATCGAATGGATCTCT-1_V10B01-087_D1,2,0,1,0,0,3
GCTACACTGTCCGAAC-1_V10B01-087_D1,3,0,0,0,0,3
CGGGTTGTAGCTTTGG-1_V10B01-087_D1,3,0,0,0,0,3
CCTAAGTGTCTAACCG-1_V10B01-087_D1,1,0,0,1,0,2
TCTGTGACTGACCGTT-1_V10B01-087_D1,2,0,0,0,0,2
TTATCATACTCGCAAA-1_V10B01-087_D1,5,0,0,0,0,5
AGCGTAGCGCTAGACC-1_V10B01-087_D1,3,0,1,0,0,4
TCCCTCCGAAATCGTT-1_V10B01-087_D1,3,1,0,0,0,4
AGGTCGCCACTTCGGT-1_V10B01-087_D1,4,0,0,0,0,4
CTAGCAACTAATTTAC-1_V10B01-087_D1,5,0,1,0,0,6
TTGCTAGCTACCAATC-1_V10B01-087_D1,5,2,2,0,0,9
GCCGGTTTGGGCGGAT-1_V10B01-087_D1,3,0,2,0,0,5
TGTAACTTGTCAACCT-1_V10B01-087_D1,0,3,1,0,0,4
CGAGATGTTGCCTATA-1_V10B01-087_D1,8,0,0,0,0,8
GTTACGAAATCCACGC-1_V10B01-087_D1,3,1,1,0,0,5
CTTGTCGTACGTGTCA-1_V10B01-087_D1,5,1,0,0,0,6
GCGTCCAGCTCGTGGC-1_V10B01-087_D1,6,2,0,0,0,8
CCCTTCTCGTACGCGA-1_V10B01-087_D1,3,1,0,0,0,4
CCAAAGTCCCGCTAAC-1_V10B01-087_D1,6,1,2,0,0,9
CCGCTTCGCGGTTAAC-1_V10B01-087_D1,1,1,0,0,0,2
GTTACGGCCCGACTGC-1_V10B01-087_D1,1,0,0,0,0,1
CCCGCTTGCCCTCGTC-1_V10B01-087_D1,2,1,0,0,0,3
TAGTGAGAAGTGGTTG-1_V10B01-087_D1,2,0,0,0,0,2
CGCTACCGCCCTATGA-1_V10B01-087_D1,2,2,0,0,0,4
AAACAATCTACTAGCA-1_V10B01-087_D1,0,3,1,1,0,5
GCGCGATGGGTCAAGT-1_V10B01-087_D1,2,0,0,0,0,2
ATAAACCATTGGACGG-1_V10B01-087_D1,1,3,0,0,0,4
TCGGGCACTTCTGGAT-1_V10B01-087_D1,2,0,0,0,0,2
TCTGTGGCTACATTTC-1_V10B01-087_D1,3,1,2,0,0,6
CTCTGTGCCTGCTATG-1_V10B01-087_D1,4,1,2,0,0,7
CACGACTAAAGTTCTG-1_V10B01-087_D1,2,0,3,0,0,5
GAGGAGTAATTCCTAC-1_V10B01-087_D1,0,4,0,1,0,5
AGAGGTATCTCGGTCC-1_V10B01-087_D1,3,1,3,1,0,8
GGCGTACCCTATATAA-1_V10B01-087_D1,1,1,2,0,0,4
GCCGGAAACACATCTT-1_V10B01-087_D1,4,0,1,0,0,5
AAATGTGGGTGCTCCT-1_V10B01-087_D1,2,1,0,0,0,3
ACCAGGAGTGTGATCT-1_V10B01-087_D1,5,2,1,0,0,8
TGTGGAGGAAGCTTAA-1_V10B01-087_D1,5,0,3,0,3,11
AAGGAGAACTTATAAG-1_V10B01-087_D1,3,1,1,1,0,6
CCCTCGGGAGCCTTGT-1_V10B01-087_D1,0,1,0,0,0,1
ACTGTTTAGTGTAGGC-1_V10B01-087_D1,2,1,0,0,0,3
CGTCAGTTTATCGTCT-1_V10B01-087_D1,1,1,1,0,0,3
GCGTGTATGTCGTATT-1_V10B01-087_D1,1,1,0,0,0,2
ACAATCGATCTTTATA-1_V10B01-087_D1,3,1,2,0,0,6
CAGCCCTCACAGGCAG-1_V10B01-087_D1,1,1,0,0,0,2
CGCGTCATATTAAACC-1_V10B01-087_D1,0,0,1,0,0,1
GAAGACTTCAATGCCG-1_V10B01-087_D1,4,1,2,0,0,7
TTGCGGCGACTCATGC-1_V10B01-087_D1,1,1,0,0,0,2
ACCAAACTAGAAATCC-1_V10B01-087_D1,3,0,0,0,0,3
TTACTGTTTCTCTACG-1_V10B01-087_D1,2,0,0,0,0,2
GACCAGGTCATTCATA-1_V10B01-087_D1,2,1,3,0,0,6
TTCTTCCCTTTGATAT-1_V10B01-087_D1,0,1,0,0,0,1
ACGCCCAGCTGTCGAT-1_V10B01-087_D1,0,1,0,0,0,1
AGTAGCGTGAACGAAC-1_V10B01-087_D1,1,1,0,0,0,2
CCTCGACCCACTGCCT-1_V10B01-087_D1,1,0,1,0,0,2
AGTTATTGAAAGGTAA-1_V10B01-087_D1,2,1,0,0,0,3
TCAGTTACGGAATGAT-1_V10B01-087_D1,3,0,0,0,0,3
GAATCTATACTCGGAC-1_V10B01-087_D1,1,0,0,0,0,1
TCGGCTAACTTCCCTT-1_V10B01-087_D1,3,2,1,0,0,6
ACGTGGTCGAATGTGC-1_V10B01-087_D1,1,0,0,0,0,1
ATATCGTGCCAGACCC-1_V10B01-087_D1,4,0,0,0,0,4
GTAGCTAGTAAGCGCG-1_V10B01-087_D1,4,1,0,0,0,5
ACGCTTAGTGTCTCTC-1_V10B01-087_D1,2,0,0,0,0,2
TCCGGCCTGCATCGAT-1_V10B01-087_D1,1,0,0,0,0,1
TAGTGGAACTCATACA-1_V10B01-087_D1,2,2,0,0,0,4
ATCATCTGCCCAGTGT-1_V10B01-087_D1,3,0,0,0,0,3
GTTATTAAATACGACC-1_V10B01-087_D1,2,0,0,3,0,5
GCGCTAAGTATGCATG-1_V10B01-087_D1,3,0,0,0,0,3
CCTGACGCAACCTTTA-1_V10B01-087_D1,4,1,0,0,0,5
CCCAAGAATGCACGGT-1_V10B01-087_D1,1,0,0,0,0,1
AACTGGGTTCGAGCCG-1_V10B01-087_D1,4,1,0,0,0,5
GGTTCCACCCGCTTCT-1_V10B01-087_D1,1,1,0,0,0,2
CATGCACGTGTTACTG-1_V10B01-087_D1,2,0,0,0,0,2
AGCGTTCCGATTTAAA-1_V10B01-087_D1,2,0,0,0,0,2
CCTACGCGACCTTACA-1_V10B01-087_D1,5,1,0,0,0,6
CGAATTACATGGTGTT-1_V10B01-087_D1,4,1,0,0,0,5
GAGGTCTTAGTGGGTC-1_V10B01-087_D1,1,0,0,0,0,1
GCCGCTAGATACGCAG-1_V10B01-087_D1,2,1,0,0,0,3
GTCACCTGTCTATGTC-1_V10B01-087_D1,2,4,0,0,1,7
CCGATTGGTCAATGAA-1_V10B01-087_D1,3,0,0,0,0,3
CCTGTGCGGATTGTAA-1_V10B01-087_D1,0,1,0,0,0,1
TTACGTAGCGCGTGCT-1_V10B01-087_D1,4,0,0,1,0,5
GGAGGCGAAGAACCGC-1_V10B01-087_D1,3,1,0,0,0,4
GGGTCACGTGCTTATG-1_V10B01-087_D1,2,0,0,0,0,2
GCTCCGGACGTTGATA-1_V10B01-087_D1,1,0,0,0,0,1
ATGTTTGTAAGATCAT-1_V10B01-087_D1,0,2,1,1,0,4
TGACCCAGCATTCCCG-1_V10B01-087_D1,1,1,1,0,0,3
TGGTCGTTTGATAGAT-1_V10B01-087_D1,2,2,0,0,0,4
TGTAATGCCTTCGGAC-1_V10B01-087_D1,0,3,0,0,0,3
TGCTCACACAACAACC-1_V10B01-087_D1,1,2,0,0,0,3
TACGATCCAAGCCACT-1_V10B01-087_D1,2,0,2,0,0,4
TTGTAACTTCATAGCG-1_V10B01-087_D1,1,0,0,0,1,2
AGATTCAAGCGGGTCG-1_V10B01-087_D1,2,1,0,1,0,4
CTCAGCAGACTGCCGA-1_V10B01-087_D1,2,2,0,0,0,4
GTAACATCAGCTCATC-1_V10B01-087_D1,3,0,1,0,0,4
ATGGAACAGAATAAAC-1_V10B01-087_D1,1,1,0,0,0,2
GGGCCTATACAACCGG-1_V10B01-087_D1,3,0,3,0,0,6
TCAAACAATTAGGACA-1_V10B01-087_D1,0,1,0,0,0,1
AAACCACTACACAGAT-1_V10B01-087_D1,0,1,0,0,1,2
AAACGACAGTCTTGCC-1_V10B01-087_D1,3,0,1,0,0,4
TTGAGGGTCGAACGCG-1_V10B01-087_D1,1,0,0,0,0,1
TGTTGATCACTGTTTA-1_V10B01-087_D1,0,1,0,0,0,1
AGGGTGTGCTACACGC-1_V10B01-087_D1,3,0,0,0,0,3
GTAGTTAGACAATATA-1_V10B01-087_D1,1,1,2,2,0,6
AATGGCCGCCAATGCG-1_V10B01-087_D1,3,0,0,1,0,4
TCGGCGGTATTAGATT-1_V10B01-087_D1,0,1,1,0,0,2
GGGTCACTGAGTAGTG-1_V10B01-087_D1,0,1,2,0,0,3
GAATTATGCAACCTAC-1_V10B01-087_D1,4,0,1,0,0,5
GATCTTAGTGAACGTG-1_V10B01-087_D1,2,0,1,0,0,3
CTAATGCGCCCAACAA-1_V10B01-087_D1,3,1,0,0,0,4
GCCACCCATTCCACTT-1_V10B01-087_D1,2,0,0,0,0,2
TACTCACAACGTAGTA-1_V10B01-087_D1,0,0,0,0,0,0
GTTCGGTGTGGATTTA-1_V10B01-087_D1,5,1,0,0,0,6
TCTTTCGGCGGGACAC-1_V10B01-087_D1,6,0,0,0,0,6
GGAGACATTCACGGGC-1_V10B01-087_D1,1,2,0,1,0,4
GGGATTATCTCACAAC-1_V10B01-087_D1,1,1,1,0,0,3
TAGAACGCCAGTAACG-1_V10B01-087_D1,1,0,0,0,0,1
ACGAGTCGCCGGCGTT-1_V10B01-087_D1,1,0,0,0,0,1
TGATGGGACTAAGTCA-1_V10B01-087_D1,2,1,1,0,0,4
TGCGAGAAACGTTACG-1_V10B01-087_D1,2,0,1,0,0,3
TCGCCTCGACCTGTTG-1_V10B01-087_D1,0,1,1,0,0,2
AACTCGATAAACACGT-1_V10B01-087_D1,3,0,0,0,0,3
AGGAAAGCCTCTGATG-1_V10B01-087_D1,0,1,1,0,0,2
GAAGGACTAAATTGAA-1_V10B01-087_D1,6,0,2,0,0,8
GTATCGGGACGAGCTG-1_V10B01-087_D1,3,1,0,0,0,4
CCTGTGCATAGGAGAC-1_V10B01-087_D1,1,2,0,0,0,3
CATACGGGTGCATGAT-1_V10B01-087_D1,2,0,0,0,0,2
CCACTAAACTGAATCG-1_V10B01-087_D1,2,1,0,0,0,3
AAATTGCGGCGGTTCT-1_V10B01-087_D1,3,2,0,0,0,5
AGTCCAGCGGGTACGT-1_V10B01-087_D1,2,0,0,0,0,2
CATTCAGGTCAGTGCG-1_V10B01-087_D1,4,1,1,0,0,6
CTAAAGTCCGAAGCTA-1_V10B01-087_D1,2,0,0,0,0,2
AATCAGACTGCAGGAC-1_V10B01-087_D1,2,1,1,0,0,4
AGTATCCATAATAACG-1_V10B01-087_D1,6,0,0,0,0,6
CTGGCTGCTAACGTAA-1_V10B01-087_D1,2,0,1,0,0,3
GTTCCAAGACAGCGAC-1_V10B01-087_D1,0,0,0,0,0,0
AAGACTAACCCGTTGT-1_V10B01-087_D1,2,0,0,0,0,2
GATTAATCCTGGCTCA-1_V10B01-087_D1,5,1,2,0,0,8
CGCGCAAGGAACTACA-1_V10B01-087_D1,2,0,1,0,0,3
CAGTAGCGAGGTAGTA-1_V10B01-087_D1,4,0,1,0,0,5
ACGGCGGGTTGCCCTG-1_V10B01-087_D1,2,1,0,0,0,3
CTAGGCGGCAGAGAAT-1_V10B01-087_D1,4,0,1,0,0,5
GTGCGCAGCTTGCTCC-1_V10B01-087_D1,2,0,0,0,0,2
TCACTATCGTGCAATC-1_V10B01-087_D1,4,1,1,0,0,6
TATGATTCTGCTTGGT-1_V10B01-087_D1,4,0,4,0,0,8
TAAGATTTAGCGGGAG-1_V10B01-087_D1,1,0,0,0,0,1
TTACGGTGTCACCGAG-1_V10B01-087_D1,1,0,0,0,0,1
CTACACTAGCTTGTTC-1_V10B01-087_D1,1,1,1,0,0,3
TGAGCAGTCGTGAAGT-1_V10B01-087_D1,2,0,0,0,0,2
CGCTGAGGACGTCCAA-1_V10B01-087_D1,2,1,0,0,0,3
GTGTATGACTTTAAAG-1_V10B01-087_D1,1,0,0,0,0,1
CTAAACGGGTGTAATC-1_V10B01-087_D1,0,1,0,0,0,1
TGTACTGTGCCAAAGT-1_V10B01-087_D1,3,0,0,0,0,3
GGCCACAAGCGATGGC-1_V10B01-087_D1,4,0,0,0,0,4
GTCAATTGTACTGAAG-1_V10B01-087_D1,3,0,1,0,0,4
AGGGACAGCACGGCGG-1_V10B01-087_D1,0,0,2,0,0,2
AGCTTATAGAGACCTG-1_V10B01-087_D1,2,1,1,0,0,4
AACTAGCGTATCGCAC-1_V10B01-087_D1,3,1,0,0,0,4
AACTTTAGCTGCTGAG-1_V10B01-087_D1,4,0,0,0,0,4
CCCAAGACAGAGTATG-1_V10B01-087_D1,4,2,0,0,0,6
GGCATCAACGAGCACG-1_V10B01-087_D1,5,1,0,0,0,6
ATGCATTCCGTGATGG-1_V10B01-087_D1,3,1,0,0,0,4
TTATAGATGCACATTA-1_V10B01-087_D1,0,0,3,0,0,3
GAACCATCTGGGAGAC-1_V10B01-087_D1,1,2,1,0,0,4
TGCTATACAAACGGAC-1_V10B01-087_D1,1,3,0,0,0,4
ACTTGCCATATTGTAC-1_V10B01-087_D1,2,1,7,0,0,10
TATTCCGGCAGTCCTA-1_V10B01-087_D1,2,4,0,0,0,6
GACGGACCGCGTTCCT-1_V10B01-087_D1,1,1,0,0,0,2
ATGTGTAGTTTAGTCA-1_V10B01-087_D1,2,1,0,0,0,3
ATACCAGCAAATTGCT-1_V10B01-087_D1,5,0,0,0,0,5
AAGTTTACTAATGGCA-1_V10B01-087_D1,0,2,1,0,0,3
CTCTCGATGTGCGCCT-1_V10B01-087_D1,1,1,1,0,0,3
GATTGACACTCTGCTC-1_V10B01-087_D1,4,2,0,0,0,6
TATCACAGCACGGGCA-1_V10B01-087_D1,2,1,1,1,0,5
ACCGTTCCCGCTCTGA-1_V10B01-087_D1,3,0,0,0,0,3
CCGCCACCACAATCCA-1_V10B01-087_D1,2,0,1,0,0,3
CATTCACTGACAGCTA-1_V10B01-087_D1,4,0,0,0,0,4
CGGCTGCAAGATTAAG-1_V10B01-087_D1,3,1,1,2,0,7
CATGAACCTCTTATCA-1_V10B01-087_D1,4,0,0,1,0,5
TTAATGCGAGGTAACT-1_V10B01-087_D1,3,1,0,0,0,4
AATAAGTCCTCGAGAC-1_V10B01-087_D1,1,0,0,1,0,2
ACCAGCCCGGTCTTTG-1_V10B01-087_D1,0,1,0,0,0,1
CTACGAACTAGGTCGA-1_V10B01-087_D1,3,1,4,0,0,8
ACATCTCAACGCGTAA-1_V10B01-087_D1,0,0,0,1,0,1
CACTACTCAGTTCTGT-1_V10B01-087_D1,4,0,0,0,0,4
CCGACTCGCATAGTCT-1_V10B01-087_D1,4,2,0,0,0,6
CATTTATCGTTCAAGA-1_V10B01-087_D1,1,0,0,1,0,2
CAAACGTGGTCTTGCG-1_V10B01-087_D1,1,0,0,0,0,1
TAGAAACCACTAAGTA-1_V10B01-087_D1,2,1,0,0,0,3
ACTGATTTAGTGATTC-1_V10B01-087_D1,1,0,0,0,0,1
TCGTATTTCGTCCGGA-1_V10B01-087_D1,4,2,0,1,0,7
CGGAAATTTCACATCC-1_V10B01-087_D1,4,0,0,0,0,4
ATCCACGCTAAATGTT-1_V10B01-087_D1,4,0,0,0,0,4
GTTCAATCTATGTCAA-1_V10B01-087_D1,4,1,0,0,0,5
ATAAAGGTCAAGTACG-1_V10B01-087_D1,2,1,0,1,0,4
CAACTCCAACGTTTAG-1_V10B01-087_D1,2,0,0,0,0,2
TAGGAACAGCCTCCAG-1_V10B01-087_D1,3,1,0,0,1,5
ATGGGAACGGAAGCGG-1_V10B01-087_D1,3,0,0,0,0,3
CACACGTTTCAATGGG-1_V10B01-087_D1,2,0,0,1,0,3
GGTGTTCTGTTTCTAC-1_V10B01-087_D1,4,3,0,1,0,8
AGTAACGTTCATCCTG-1_V10B01-087_D1,1,1,0,0,0,2
GTATAGTGGCCCATGT-1_V10B01-087_D1,3,2,1,0,0,6
TCTACACGTTCATGCA-1_V10B01-087_D1,12,0,0,0,0,12
AATCTGGGTAGACCCT-1_V10B01-087_D1,1,0,0,0,1,2
TCGGTTAGCCATGTAG-1_V10B01-087_D1,2,0,0,0,0,2
TGCCATGGCTTATAAG-1_V10B01-087_D1,5,1,0,0,0,6
TAAGTAAATGTGCCGC-1_V10B01-087_D1,3,0,0,0,0,3
GTGTCCGATAAGGCAT-1_V10B01-087_D1,1,0,0,0,0,1
TGGCACGAGCTCGAGT-1_V10B01-087_D1,1,1,0,0,0,2
ACCGGTCTGAGTACGG-1_V10B01-087_D1,1,0,1,0,0,2
GAACTTAGCGCCCGGT-1_V10B01-087_D1,2,0,0,0,0,2
AGTAGCTAGACGCCGA-1_V10B01-087_D1,1,1,0,0,0,2
ATAGGAATCTAAGCTT-1_V10B01-087_D1,3,3,0,0,0,6
CTTCCTGCATATTTAC-1_V10B01-087_D1,1,1,0,0,0,2
CAATATGTAGATTTAC-1_V10B01-087_D1,0,1,1,0,0,2
ACAAGGCCTACCAGCC-1_V10B01-087_D1,3,0,2,0,0,5
TTATAGTCCAAGGTGC-1_V10B01-087_D1,2,1,0,0,0,3
AAACGCCCGAGATCGG-1_V10B01-087_D1,1,1,0,0,0,2
CCTCGTTACGCCTGTT-1_V10B01-087_D1,2,0,0,0,0,2
GAACGGTGTAAAGCAG-1_V10B01-087_D1,1,0,0,1,0,2
ACGCATAAATGACATG-1_V10B01-087_D1,1,2,1,0,0,4
GGTTCGATGCTGAGTT-1_V10B01-087_D1,4,1,2,1,0,8
CTTTGGCAGACAGAGT-1_V10B01-087_D1,2,0,2,0,0,4
TTCGTGGGCTGGAAGC-1_V10B01-087_D1,1,1,0,0,0,2
CAAAGGTTAAATTCAG-1_V10B01-087_D1,2,0,0,0,0,2
GTTTGGCGTCAGGCAC-1_V10B01-087_D1,0,0,1,1,0,2
GCTTTCTATCTCAACT-1_V10B01-087_D1,3,2,1,1,0,7
TGCATCTCCGGATCTT-1_V10B01-087_D1,1,0,0,0,0,1
CTGAAACGGCCCTCAG-1_V10B01-087_D1,2,1,3,0,0,6
TAGCAGTAAATACGCG-1_V10B01-087_D1,1,0,0,0,2,3
CGGGCTACTTAAATTG-1_V10B01-087_D1,2,0,1,0,0,3
ATTATGCTCAGTATTG-1_V10B01-087_D1,0,1,0,1,0,2
TGATGCTCACGTAGTC-1_V10B01-087_D1,3,0,2,0,0,5
GTCTAAGATGCCCAGC-1_V10B01-087_D1,1,0,1,0,0,2
AACCCGATAGGGCTTC-1_V10B01-087_D1,2,0,4,0,0,6
CGCTATCGTGGCTTTA-1_V10B01-087_D1,0,2,2,0,0,4
CGTCTCTCGCCGAGGC-1_V10B01-087_D1,6,2,0,0,0,8
AGTGGGAGTATACACG-1_V10B01-087_D1,0,0,0,0,0,0
GGTCTTGGTGTTAACT-1_V10B01-087_D1,2,1,1,0,0,4
GGCTGGCAGCTTTATG-1_V10B01-087_D1,3,1,1,0,0,5
CGCCAATTATTGCGTT-1_V10B01-087_D1,2,1,0,1,0,4
GGTAACCGGCAAAGGT-1_V10B01-087_D1,4,1,0,0,0,5
TGGGACCATTGGGAGT-1_V10B01-087_D1,1,0,0,0,0,1
CTGCAGGTGCTCGGCC-1_V10B01-087_D1,3,2,4,0,0,9
CCGGTGCGAGTGATAG-1_V10B01-087_D1,1,0,0,0,0,1
GGGTACACTCTGGAGG-1_V10B01-087_D1,1,1,0,0,0,2
TAGCCAGAGGGTCCGG-1_V10B01-087_D1,0,0,0,0,0,0
CTTGTGAGGACAGCGG-1_V10B01-087_D1,5,0,0,0,0,5
GAAGGGCATAACCATG-1_V10B01-087_D1,2,0,0,0,0,2
CAACATGGCCTGATAA-1_V10B01-087_D1,6,1,0,0,0,7
CAATTTGACCGGGAAG-1_V10B01-087_D1,2,1,0,0,0,3
TCTGACTGTAATGGTT-1_V10B01-087_D1,2,1,0,0,0,3
TTCATAGCCTTGTAAC-1_V10B01-087_D1,1,0,0,0,0,1
TGGAAACGGAGTGAAC-1_V10B01-087_D1,2,2,5,0,0,9
ATCGCACGATTGTTCA-1_V10B01-087_D1,4,0,2,0,0,6
CGCCACCCGCATTAAC-1_V10B01-087_D1,1,0,0,1,0,2
TGGACCACGGCGTTGA-1_V10B01-087_D1,3,0,0,0,0,3
GTATATGTTACGGCGG-1_V10B01-087_D1,0,1,0,0,0,1
GTATTCTTACCGTGCT-1_V10B01-087_D1,8,0,0,1,0,9
TTCAGAGTAACCTGAC-1_V10B01-087_D1,3,1,1,0,0,5
GCGGTAACCCAAATGA-1_V10B01-087_D1,1,1,2,0,0,4
CTACGTGTTGCCACCA-1_V10B01-087_D1,2,0,0,0,0,2
CTAGATAAACTCCTCG-1_V10B01-087_D1,1,0,0,0,0,1
TCCATTAGTTGGATAG-1_V10B01-087_D1,3,1,0,0,0,4
CTGGCTCCTGCGGGAT-1_V10B01-087_D1,1,1,4,0,0,6
CAGTCTCTCGGCTAAT-1_V10B01-087_D1,5,0,0,0,0,5
GTATGACGTGGGAAAC-1_V10B01-087_D1,0,1,0,0,0,1
AGTCACTCCGCCTCAT-1_V10B01-087_D1,2,0,3,0,0,5
GCAGCGGTGGGCATTA-1_V10B01-087_D1,5,1,0,0,0,6
TATGGAGTTTCTCGTT-1_V10B01-087_D1,1,1,0,0,0,2
ACTCAACGAATGTATT-1_V10B01-087_D1,5,1,0,0,0,6
AACACGCGGCCGCGAA-1_V10B01-087_D1,4,2,0,0,0,6
CGATATTAGCCGCAGG-1_V10B01-087_D1,2,0,1,0,0,3
AGCGTCTGAACCCGCA-1_V10B01-087_D1,1,0,0,0,0,1
GATGTCCGGATCACAT-1_V10B01-087_D1,2,0,0,0,0,2
GGTCACGTTAGATTCA-1_V10B01-087_D1,1,0,1,0,0,2
TTAAGGATACGGAGGT-1_V10B01-087_D1,10,2,0,0,0,12
GTGCGGGACCATCGGC-1_V10B01-087_D1,9,0,2,0,1,12
CCATCTTGTTCACAAT-1_V10B01-087_D1,3,0,0,0,0,3
TCCGAGAAGGCTAAGC-1_V10B01-087_D1,2,0,0,1,0,3
TGGCGGTGTGCGATTG-1_V10B01-087_D1,2,1,1,0,0,4
ATCCTGCTGCAGATAG-1_V10B01-087_D1,5,3,2,0,0,10
TTATGCGTCCCGGTCC-1_V10B01-087_D1,3,0,0,1,0,4
CATAATGAGCGGGCGA-1_V10B01-087_D1,2,0,2,0,0,4
AGACATAGATCCTTCC-1_V10B01-087_D1,4,0,1,0,0,5
GGTGAAACCGGGAATG-1_V10B01-087_D1,7,1,0,0,0,8
AACTGGTGTGGGCCTT-1_V10B01-087_D1,2,0,0,0,0,2
GTAGCGCTGTTGTAGT-1_V10B01-087_D1,3,3,1,0,0,7
TTGTTTGTGTAAATTC-1_V10B01-087_D1,1,1,1,0,0,3
GGATCAAAGGACGAGG-1_V10B01-087_D1,3,1,0,0,0,4
CGTAGCGCCGACGTTG-1_V10B01-087_D1,1,2,0,0,0,3
CAAGTGAACTTTGGTT-1_V10B01-087_D1,1,1,1,0,0,3
GTAGACAACCGATGAA-1_V10B01-087_D1,4,1,0,0,0,5
CAATGGTCGGCCTGGG-1_V10B01-087_D1,2,1,0,0,0,3
ACAGATTAGGTTAGTG-1_V10B01-087_D1,3,1,0,0,0,4
GTTATCACCTTCTGAA-1_V10B01-087_D1,6,1,2,0,0,9
TGGTATCGGTCTGTAT-1_V10B01-087_D1,0,2,0,0,0,2
GGAATAACCTCAAGAA-1_V10B01-087_D1,1,2,0,0,0,3
ATTATCTCGACAGATC-1_V10B01-087_D1,4,4,0,0,0,8
CCGAGGGATGTTAGGC-1_V10B01-087_D1,2,0,4,0,0,6
TGAGATCAAATACTCA-1_V10B01-087_D1,5,2,0,0,0,7
AAACGAAGAACATACC-1_V10B01-087_D1,1,1,1,0,0,3
CTGGTCCTAACTTGGC-1_V10B01-087_D1,1,3,1,0,0,5
TGCACGAGTCGGCAGC-1_V10B01-087_D1,1,1,0,0,0,2
ATAGTCTTTGACGTGC-1_V10B01-087_D1,1,2,0,0,0,3
TGGAGCTAAAGTTCCC-1_V10B01-087_D1,2,0,2,0,0,4
GGGTGGTCCAGCCTGT-1_V10B01-087_D1,5,1,0,0,0,6
CATGCATGGAGACCCT-1_V10B01-087_D1,3,2,0,1,0,6
ACACGGCACTATGCAT-1_V10B01-087_D1,2,0,2,0,0,4
CCCTGGTATGGGCGGC-1_V10B01-087_D1,3,1,0,0,0,4
GGAGGATTGAAAGGAG-1_V10B01-087_D1,2,0,1,0,0,3
CCGCTGGTGCCATTCA-1_V10B01-087_D1,2,1,0,1,0,4
GTTAGAGTGTGCCGCT-1_V10B01-087_D1,3,1,2,0,0,6
TCGGAATGACCATCAA-1_V10B01-087_D1,3,0,2,0,0,5
TTCAATTAGCCATAAT-1_V10B01-087_D1,3,0,0,1,0,4
GATGTGTTGTCACAAG-1_V10B01-087_D1,2,2,0,1,0,5
TCTTTCTCTTAAGGAG-1_V10B01-087_D1,4,0,0,0,0,4
ACCCTTTAGTTCTCCA-1_V10B01-087_D1,2,1,0,0,0,3
ACCACAACTCAGAACA-1_V10B01-087_D1,0,1,0,0,0,1
TATGATAAATCTAACG-1_V10B01-087_D1,1,1,1,0,0,3
GATCCTCTTGCGCTTA-1_V10B01-087_D1,3,1,1,0,0,5
TTCTACCTTTATGTTG-1_V10B01-087_D1,3,0,0,1,0,4
GAAATACCTGCTGGCT-1_V10B01-087_D1,2,0,0,0,0,2
ATTCTGAGTATGAACT-1_V10B01-087_D1,3,0,0,0,0,3
GGATTAAGCTAAGGTC-1_V10B01-087_D1,0,1,0,0,0,1
AGTACGTGGCCTGTCT-1_V10B01-087_D1,0,0,1,0,1,2
TCAGGGTGCACGAAAC-1_V10B01-087_D1,2,0,0,1,0,3
AAATTTACCGAAATCC-1_V10B01-087_D1,4,0,0,0,0,4
TTGAGGCATTTAACTC-1_V10B01-087_D1,4,0,0,0,0,4
AACCAGTATCACTCTT-1_V10B01-087_D1,2,1,0,0,0,3
CACCGGAGATATCTCC-1_V10B01-087_D1,1,0,0,0,0,1
GACTGGGCGCCGCAAC-1_V10B01-087_D1,3,1,0,0,0,4
CACGTCTATGATGTGG-1_V10B01-087_D1,3,4,0,0,0,7
TTAAGACGAACGAACC-1_V10B01-087_D1,0,1,0,1,0,2
TGACCAGCTTCAAAGT-1_V10B01-087_D1,4,1,0,0,0,5
AGAGTTAGAGACCGAT-1_V10B01-087_D1,1,0,0,1,0,2
TTCGGACTGATGCCTT-1_V10B01-087_D1,2,0,3,0,0,5
CTCGAATGGAACGTAT-1_V10B01-087_D1,1,1,1,0,0,3
GGACGGCTTGCGCAAC-1_V10B01-087_D1,1,1,2,0,0,4
CTAAGTACAGGGCTAC-1_V10B01-087_D1,0,0,0,0,0,0
ACAAATTCAGATCTGA-1_V10B01-087_D1,3,0,0,0,0,3
CATGGAAATGGGACCA-1_V10B01-087_D1,3,0,1,0,0,4
GGTGGACCACGTGTTA-1_V10B01-087_D1,3,1,1,0,0,5
CACGACGTAATAGTAA-1_V10B01-087_D1,1,1,1,0,0,3
CGGGTTCGGCACGTAT-1_V10B01-087_D1,2,0,2,1,0,5
CTGGGCTATCCTTTGG-1_V10B01-087_D1,2,0,1,1,0,4
GTATTAGGGTTCGCGT-1_V10B01-087_D1,1,0,2,0,0,3
TCATTCGTATAATTTG-1_V10B01-087_D1,3,1,3,0,0,7
AATAGCAAGCCTCCTG-1_V10B01-087_D1,2,0,1,0,0,3
CATCTACCCGAGAACG-1_V10B01-087_D1,3,0,2,0,0,5
GCTTCAGTGGGATTAC-1_V10B01-087_D1,2,1,0,0,0,3
TCTGTGATGGAGGTTG-1_V10B01-087_D1,3,1,1,0,0,5
ATCCACTTTCAGACTA-1_V10B01-087_D1,4,1,0,0,0,5
ATGGTTACGAAACATG-1_V10B01-087_D1,1,0,1,0,0,2
GGCCCAATCTAGAGGG-1_V10B01-087_D1,2,2,1,0,0,5
GATGGTGAAATAACCC-1_V10B01-087_D1,0,1,0,0,0,1
AGAGGGACAATTGTCC-1_V10B01-087_D1,1,1,0,1,0,3
CGCGTACATTCTGGAA-1_V10B01-087_D1,2,1,2,0,0,5
CAAGAAACCCTAAACT-1_V10B01-087_D1,2,1,2,0,0,5
TTGGTGCGGTGTTGAA-1_V10B01-087_D1,1,1,1,0,0,3
GGTTCCCTAGTGTCTC-1_V10B01-087_D1,0,0,0,0,0,0
CGATAACCAATTTGAG-1_V10B01-087_D1,2,0,1,0,0,3
GCCCACTGGTCCACAA-1_V10B01-087_D1,5,1,0,0,0,6
GAGGGCCGGCAGAGTC-1_V10B01-087_D1,2,0,2,0,0,4
CGACACGGATGCCCAC-1_V10B01-087_D1,1,1,1,2,0,5
CTGTCTGTGGCTGGCT-1_V10B01-087_D1,1,0,1,0,0,2
ATATTATCCCGTATTT-1_V10B01-087_D1,5,0,0,0,0,5
GCGCTGGCGGAAAGTC-1_V10B01-087_D1,1,1,1,0,0,3
ATCTAACGTCCCTATG-1_V10B01-087_D1,1,0,1,0,0,2
GTCAGACAGCGTTGGA-1_V10B01-087_D1,2,0,0,0,0,2
GCCAGGCTTAGTGGTA-1_V10B01-087_D1,5,0,1,1,0,7
ATTCAAAGTACCTGTT-1_V10B01-087_D1,1,0,0,0,0,1
TGGACGTAGGCGAATC-1_V10B01-087_D1,2,0,0,0,0,2
ACACATTGACGCAACA-1_V10B01-087_D1,4,2,0,0,0,6
GATATCAGTATGTATC-1_V10B01-087_D1,1,1,4,0,0,6
TGGGCCTTGCCTGCAT-1_V10B01-087_D1,1,0,2,0,0,3
CAAAGTCAGGTTAGCT-1_V10B01-087_D1,3,1,0,0,0,4
GGATCCCTACCAGCTA-1_V10B01-087_D1,3,0,1,0,0,4
ATCGTCCAATCGAGTC-1_V10B01-087_D1,4,0,1,0,0,5
ACATGGCTCAATTTAG-1_V10B01-087_D1,2,1,0,0,0,3
AGGCCCAGTGACTGGT-1_V10B01-087_D1,3,0,0,0,0,3
GCTTCCAGCTTAGATT-1_V10B01-087_D1,3,0,0,0,0,3
TGCTTGAAACCATGCA-1_V10B01-087_D1,4,1,0,0,0,5
CAATATTGGACTAGTG-1_V10B01-087_D1,4,1,1,0,0,6
CGTGCTGGCCTAGTCG-1_V10B01-087_D1,3,1,1,0,0,5
CCTGCGATAGAACTGT-1_V10B01-087_D1,1,0,0,0,0,1
GGGTAATGCTGTGTTT-1_V10B01-087_D1,3,0,0,0,0,3
AACGCGAACGGCAACA-1_V10B01-087_D1,4,1,0,0,0,5
TGTCGGCATGGTGGAA-1_V10B01-087_D1,1,2,1,0,0,4
AGCGTACGAGAGCTAG-1_V10B01-087_D1,0,1,1,0,0,2
ATACTCTCGCCACTCT-1_V10B01-087_D1,3,1,0,0,0,4
AATCCATGCAAGGGTG-1_V10B01-087_D1,4,1,0,0,0,5
TTAAACAGAGTCCCGC-1_V10B01-087_D1,2,0,0,0,0,2
CCACAGCTGAAATCAT-1_V10B01-087_D1,3,0,1,0,0,4
CGGTTCCGGCTTCTTG-1_V10B01-087_D1,2,0,1,0,0,3
GACGTGAGACTCCATG-1_V10B01-087_D1,1,0,0,0,0,1
TCGTTGGCTCGTCAAT-1_V10B01-087_D1,2,0,1,0,0,3
GGTGAACGGGCTAGCC-1_V10B01-087_D1,2,1,1,0,0,4
GCACTGTGCAAATGTA-1_V10B01-087_D1,2,1,0,0,0,3
ACGAGAACCCATCACG-1_V10B01-087_D1,4,0,1,0,0,5
CCAGCTACGCCTCATA-1_V10B01-087_D1,2,0,0,0,0,2
TCCCGGTCAGGAATTT-1_V10B01-087_D1,2,0,0,0,0,2
TCGCATTCAATGACTT-1_V10B01-087_D1,2,2,0,0,0,4
CTGGTTCAACGCATCA-1_V10B01-087_D1,1,0,0,0,0,1
GGTGATTTCATCTTGT-1_V10B01-087_D1,1,2,0,0,0,3
CACCCTTTCCTCGCTC-1_V10B01-087_D1,2,2,0,0,0,4
CAACTTGTAGTGGGCA-1_V10B01-087_D1,2,1,2,0,0,5
AATATCAAGGTCGGAT-1_V10B01-087_D1,3,0,1,0,0,4
ACTCAGACCTGCTTCT-1_V10B01-087_D1,3,2,0,0,0,5
TTGGAGTCTCCCTTCT-1_V10B01-087_D1,4,0,0,0,0,4
GGATACTCATGAATTG-1_V10B01-087_D1,1,1,0,0,0,2
TGGGCACAAACAGAAC-1_V10B01-087_D1,3,0,1,1,0,5
GAGCCACGGTAGTAGG-1_V10B01-087_D1,0,2,3,1,0,6
TCGATAGGCTAGTCGC-1_V10B01-087_D1,3,0,1,0,0,4
TAACCGCCCGCAGTGC-1_V10B01-087_D1,5,1,1,0,0,7
GCCTATTTGCTACACA-1_V10B01-087_D1,7,0,0,0,0,7
TTGACGATTCAGCACG-1_V10B01-087_D1,1,0,1,0,0,2
TTAAACCGGTAGCGAC-1_V10B01-087_D1,0,1,0,0,0,1
ACCGAAAGGGCCCTGC-1_V10B01-087_D1,5,0,1,0,0,6
ACGTTCCGCGCTCCGT-1_V10B01-087_D1,1,2,1,0,0,4
ATACCAGGCTAATAGA-1_V10B01-087_D1,4,0,1,0,0,5
CGGCTTTGTATGATAA-1_V10B01-087_D1,4,0,2,0,0,6
CTTGACCCGAAAGATA-1_V10B01-087_D1,1,0,0,0,0,1
CGCAGAAACATTTGCG-1_V10B01-087_D1,4,2,3,1,0,10
GACCCGTCGCCGGCTA-1_V10B01-087_D1,2,0,1,0,0,3
AATCGGGACACTACGA-1_V10B01-087_D1,1,3,3,0,0,7
GTCACAAAGTTTCCAA-1_V10B01-087_D1,2,2,1,1,0,6
TATATTCGCGTCGATA-1_V10B01-087_D1,2,0,0,0,0,2
CCTCCCGACAATCCCT-1_V10B01-087_D1,1,2,2,0,0,5
CGACATGCGATCTTCT-1_V10B01-087_D1,2,0,0,0,0,2
AACACGACTGTACTGA-1_V10B01-087_D1,3,1,1,0,0,5
CCCAACCACACTAACA-1_V10B01-087_D1,7,1,0,0,0,8
CACCGCCGACCAGCGA-1_V10B01-087_D1,3,2,2,0,0,7
TGGTATCGCATCCCAA-1_V10B01-087_D1,3,1,0,0,1,5
CAGAGTGATTTAACGT-1_V10B01-087_D1,1,0,0,0,0,1
AACCCTGGTGGAACCA-1_V10B01-087_D1,1,1,0,0,0,2
GTCAGTTGTGCTCGTT-1_V10B01-087_D1,1,2,2,0,0,5
ATTGACGTAACTCGGT-1_V10B01-087_D1,2,1,0,0,0,3
GATGTCGGTCAACTGC-1_V10B01-087_D1,4,0,2,0,0,6
AGGGCAGCGGCGTGGT-1_V10B01-087_D1,1,1,0,1,0,3
ACATCGTTAACCTAGT-1_V10B01-087_D1,1,2,2,0,0,5
TCCATTGTGACCTCGT-1_V10B01-087_D1,4,0,1,0,0,5
TGTTTAATACTTCATC-1_V10B01-087_D1,1,0,4,0,0,5
TTGCTGGCCGGGCTTC-1_V10B01-087_D1,1,0,3,0,0,4
CATATTATTTGCCCTA-1_V10B01-087_D1,2,0,0,0,0,2
CTGCCTAGCCACCAAG-1_V10B01-087_D1,0,4,0,0,0,4
ACGAGATATTTGCTTA-1_V10B01-087_D1,5,1,0,1,1,8
GACTACAATTGCTCGT-1_V10B01-087_D1,3,0,0,1,0,4
AACGTGATGAAGGACA-1_V10B01-087_D1,2,1,0,0,0,3
ACTCTCTTATACACGA-1_V10B01-087_D1,3,0,1,0,0,4
CGCATCATGGCTTCAG-1_V10B01-087_D1,2,3,1,0,0,6
CGGCTCTTCGTCGAAC-1_V10B01-087_D1,5,1,0,0,0,6
ATTCTTCGTACTTATG-1_V10B01-087_D1,4,1,1,0,0,6
AGTGAGGGTTTCTGAC-1_V10B01-087_D1,2,1,0,0,0,3
GCCAGGCGTTCGCATG-1_V10B01-087_D1,2,2,2,0,0,6
GACTAACACAGCACCT-1_V10B01-087_D1,2,1,0,0,0,3
CAATGGAATCTACATA-1_V10B01-087_D1,4,2,0,0,0,6
GTGGTCAGCGAAGTAT-1_V10B01-087_D1,1,0,3,0,0,4
ATGGCTGGAAATGGCC-1_V10B01-087_D1,2,0,0,2,0,4
ATCAGGTCGCCATTGC-1_V10B01-087_D1,1,0,1,0,0,2
TATCACCATGTAAAGT-1_V10B01-087_D1,3,0,2,1,0,6
AGCGCTTATGGGCAAG-1_V10B01-087_D1,1,1,0,1,0,3
AAGCGGCGTCATGGGT-1_V10B01-087_D1,3,0,0,0,0,3
ACTAATACGTCAGGCG-1_V10B01-087_D1,1,1,0,1,0,3
GGCTGAGCATCGTAAG-1_V10B01-087_D1,2,0,0,0,0,2
CGGTTGGGTTCAAGTT-1_V10B01-087_D1,5,2,0,0,0,7
GACTGATTGGTCACAA-1_V10B01-087_D1,0,0,0,0,0,0
AGACGGGCCGATTTAA-1_V10B01-087_D1,4,0,1,0,0,5
ACCAGTGCCCGGTCAA-1_V10B01-087_D1,2,0,0,0,0,2
GTCCTTTAATGACTTC-1_V10B01-087_D1,4,1,2,0,0,7
CCTACAAGTCCGGAAT-1_V10B01-087_D1,1,0,0,0,0,1
GCCTGCTACACTGAGA-1_V10B01-087_D1,0,1,2,0,0,3
GACTCGGTCGGCGGAT-1_V10B01-087_D1,3,1,0,0,0,4
CTAGACATATATGTAG-1_V10B01-087_D1,2,0,1,0,0,3
TCGCCCAACTGACTCC-1_V10B01-087_D1,1,0,4,0,0,5
AAACTAACGTGGCGAC-1_V10B01-087_D1,1,3,1,0,0,5
AACTGAGGTCAGCGTC-1_V10B01-087_D1,2,1,0,1,0,4
ACAATGATTCTTCTAC-1_V10B01-087_D1,3,0,1,0,0,4
ATAAGTACCCGATTGT-1_V10B01-087_D1,3,0,0,0,0,3
ATTGGGAGTTCTGTAA-1_V10B01-087_D1,0,0,2,0,0,2
CGAACATAGTCAGAAA-1_V10B01-087_D1,2,0,3,0,0,5
TAGCTCAGATCCTAGT-1_V10B01-087_D1,2,1,0,2,0,5
GTGTCGTATTCACCTT-1_V10B01-087_D1,2,1,1,0,0,4
CTCACCGATCCAAACT-1_V10B01-087_D1,1,1,0,0,0,2
ATATGTGCACAAACCA-1_V10B01-087_D1,2,2,0,0,0,4
CAGTCCAACGCCTTCT-1_V10B01-087_D1,1,4,0,0,0,5
TCGTCCGGGTACACTC-1_V10B01-087_D1,2,1,2,0,0,5
GCAGAAACGTAATCCA-1_V10B01-087_D1,2,1,1,0,0,4
TTCGAGCCGGCGCTAC-1_V10B01-087_D1,3,0,1,0,0,4
GGAAGATAAGACTGTA-1_V10B01-087_D1,0,2,3,0,0,5
ATAAGCAAACACCGAG-1_V10B01-087_D1,4,1,0,0,0,5
GCATAAATTGAACGCC-1_V10B01-087_D1,3,2,0,0,0,5
CGCCGGTGTCGCAGTA-1_V10B01-087_D1,4,0,0,0,0,4
GACCTGGTCTGGGCGT-1_V10B01-087_D1,1,0,0,0,0,1
AGCCGCTTGATTAGCG-1_V10B01-087_D1,0,0,0,0,0,0
CCCGGCTAGGTGAGAA-1_V10B01-087_D1,3,0,1,0,0,4
CGAGCCGAGCACTCGA-1_V10B01-087_D1,1,0,0,0,0,1
TAGTGCTTGAATCCTT-1_V10B01-087_D1,4,2,0,0,0,6
CAACCGCACCTAGACA-1_V10B01-087_D1,1,1,1,0,0,3
ACCACTGTTCAAGAAG-1_V10B01-087_D1,2,2,0,0,0,4
AGATGCTATAACGAGC-1_V10B01-087_D1,4,0,1,0,0,5
AATTACTCGTACGCTC-1_V10B01-087_D1,3,1,0,0,0,4
CGTCAATCTTTAACAT-1_V10B01-087_D1,1,0,0,0,0,1
CCAAAGCAGTTGGTTG-1_V10B01-087_D1,2,0,2,0,0,4
CCATATTGGATCATGA-1_V10B01-087_D1,0,0,1,0,0,1
CGTACCGAAAGTCTAG-1_V10B01-087_D1,0,0,2,0,0,2
CTCGAGATCCAAAGCA-1_V10B01-087_D1,4,1,2,0,0,7
TGGATAGAGTAACAGA-1_V10B01-087_D1,1,0,0,0,0,1
TCACAGATCCTCAAAC-1_V10B01-087_D1,1,2,1,0,0,4
AGAGCTACGAAAGCAT-1_V10B01-087_D1,2,0,1,0,0,3
TGCGTGATTGGGTGTC-1_V10B01-087_D1,0,1,2,0,0,3
CACATGTTTGGACATG-1_V10B01-087_D1,2,2,1,0,0,5
TTCGCATCCGGAAGCA-1_V10B01-087_D1,4,0,0,0,0,4
CCCTAGTGTCAGGTGT-1_V10B01-087_D1,1,1,0,0,0,2
TTACCGCCTTAGGGAA-1_V10B01-087_D1,1,0,0,0,0,1
CCAGTCCATTATTCGA-1_V10B01-087_D1,5,0,1,0,0,6
CGTAAACGCTTGAGTG-1_V10B01-087_D1,0,0,0,0,0,0
ATTCCTTCCAGGCGGT-1_V10B01-087_D1,2,0,0,0,0,2
TTCCTTTCTGTGTTGC-1_V10B01-087_D1,1,0,0,0,0,1
AGTTGACATCGGCTGG-1_V10B01-087_D1,3,0,0,0,0,3
AACTCGATGGCGCAGT-1_V10B01-087_D1,2,0,0,0,0,2
GATAAGGCAGATGCAA-1_V10B01-087_D1,1,1,2,0,0,4
GGCTGGCTAGCTTAAA-1_V10B01-087_D1,3,1,0,0,0,4
CCTCATGCAGCTACGA-1_V10B01-087_D1,5,0,0,0,0,5
GACGCCTGTTGCAGGG-1_V10B01-087_D1,4,0,0,0,0,4
TAATTAGATGGATATG-1_V10B01-087_D1,2,1,1,0,0,4
GAGGGCATCGCGTATC-1_V10B01-087_D1,1,0,0,0,0,1
CTTGTGAGTCTTTGAC-1_V10B01-087_D1,2,2,0,0,0,4
TCAACACATTGGGTAA-1_V10B01-087_D1,0,0,1,0,0,1
ACTGTATACGCGAGCA-1_V10B01-087_D1,0,1,1,0,0,2
GTGAAACGTGCTCCAC-1_V10B01-087_D1,3,0,0,0,0,3
CGAGTGCTATAGTTCG-1_V10B01-087_D1,3,3,2,0,0,8
GTACTGCATGAAGCGT-1_V10B01-087_D1,3,0,0,1,0,4
GTAACTTGCGGCAGTC-1_V10B01-087_D1,5,1,2,0,0,8
GAATCGCCGGACACGG-1_V10B01-087_D1,3,1,0,0,0,4
GGGAGTAATGGCTGGC-1_V10B01-087_D1,2,0,2,1,0,5
CATGAACCGACATTTG-1_V10B01-087_D1,1,1,0,0,0,2
TCTGTCATACAAGAGC-1_V10B01-087_D1,0,1,0,0,0,1
GTCGTCAATTATAAGG-1_V10B01-087_D1,2,1,0,0,0,3
TAAAGAGCCCGAAACC-1_V10B01-087_D1,2,2,1,2,0,7
GTACTGAGGTCGTAAC-1_V10B01-087_D1,3,0,0,0,0,3
AAAGACCCAAGTCGCG-1_V10B01-087_D1,1,2,1,0,0,4
CGTCAGTGCGCACAAG-1_V10B01-087_D1,4,0,0,0,0,4
TGTATCCTTATTCCAT-1_V10B01-087_D1,6,0,2,0,0,8
ATTCTCGTCTCTTTAG-1_V10B01-087_D1,4,1,1,0,0,6
AAAGTCACTGATGTAA-1_V10B01-087_D1,4,2,0,1,0,7
TGTCTACAGTTTCTGT-1_V10B01-087_D1,3,2,3,0,0,8
TTAACGTCGCAAGACC-1_V10B01-087_D1,2,1,1,0,0,4
CTATGTCTATTGAAAC-1_V10B01-087_D1,4,0,3,0,0,7
TCGGGTGAAACTGCTA-1_V10B01-087_D1,3,0,0,1,0,4
TGTCCCGACATAGCAC-1_V10B01-087_D1,2,0,1,0,0,3
ACAGCATAGAGCCAGT-1_V10B01-087_D1,3,0,2,0,0,5
ATATTCCCACAGGTCA-1_V10B01-087_D1,2,2,1,0,0,5
TTGGATCGACTTCTGG-1_V10B01-087_D1,8,0,0,0,0,8
CACCATCGGAGGAGAC-1_V10B01-087_D1,1,0,0,0,0,1
TCGTTCGTTATTATGT-1_V10B01-087_D1,4,0,1,0,0,5
CTTAACTTCGAAGTAC-1_V10B01-087_D1,3,0,1,0,0,4
GCACAAGTGTCGGAAG-1_V10B01-087_D1,2,0,0,0,0,2
TACCAGCTAGGTTTAA-1_V10B01-087_D1,2,0,2,0,0,4
ACGTACAGATTTCTCT-1_V10B01-087_D1,3,2,1,0,0,6
AATTTGGTTCCAAAGA-1_V10B01-087_D1,3,0,1,0,0,4
GTAAGGATTTGTCGGA-1_V10B01-087_D1,2,2,1,0,0,5
CATCATCTACCCGGAC-1_V10B01-087_D1,3,1,0,0,0,4
ACGATGGATCCGATGC-1_V10B01-087_D1,5,1,2,0,0,8
CACTCAGCTCTTGAGG-1_V10B01-087_D1,4,2,0,0,0,6
TAGATCCGAAGTCGCA-1_V10B01-087_D1,2,1,0,0,0,3
TGAAACTTATGCAAGC-1_V10B01-087_D1,0,0,1,0,0,1
GCGATTCTGGAAGCAG-1_V10B01-087_D1,3,1,1,0,0,5
CAAACTATTGAGCTTC-1_V10B01-087_D1,3,0,1,1,0,5
TAGAATTAAGGGCAAC-1_V10B01-087_D1,3,0,0,0,1,4
CGAAACATAGATGGCA-1_V10B01-087_D1,9,0,1,1,0,11
GATGGTGCCCTAGGCA-1_V10B01-087_D1,4,1,2,4,0,11
CCCGCAGGGCCCAAAG-1_V10B01-087_D1,2,0,0,0,0,2
ACAGCGCACCCGCAGC-1_V10B01-087_D1,4,1,0,0,0,5
GGTAAATGTGCGTTAC-1_V10B01-087_D1,0,3,2,1,0,6
GTCCTTCTAGTGGGTT-1_V10B01-087_D1,2,1,1,0,0,4
GGAAGCTCGCTTACAG-1_V10B01-087_D1,6,1,2,1,0,10
CACCGATACACCGAGC-1_V10B01-087_D1,2,2,0,0,0,4
CAGCCGGGCCCTCTAT-1_V10B01-087_D1,4,0,1,0,0,5
CGGAGCTTATAACACC-1_V10B01-087_D1,0,1,0,1,0,2
ATTACAACTACCGGCC-1_V10B01-087_D1,2,0,0,0,0,2
TCCTCTGGCCCATTAG-1_V10B01-087_D1,1,2,3,1,0,7
CGGCACCGTTAGCGCC-1_V10B01-087_D1,3,2,1,0,0,6
TCGGTCCCTGACTCCA-1_V10B01-087_D1,2,2,3,0,0,7
TGGTTGGAGGATCCTG-1_V10B01-087_D1,1,0,2,1,0,4
CTGCGGTAGTCACGTG-1_V10B01-087_D1,2,1,2,0,0,5
GTGCCTCAGTGTACGG-1_V10B01-087_D1,3,3,2,0,0,8
ATCGTTCACTTTCGCC-1_V10B01-087_D1,4,0,0,1,0,5
ACTTACCGGGCGCGCA-1_V10B01-087_D1,5,3,3,0,0,11
CTAGACTGCATTTCGT-1_V10B01-087_D1,2,3,0,0,0,5
TTGCCGGTGATCCCTC-1_V10B01-087_D1,2,0,0,0,0,2
CTGTCACGCCAGGCGC-1_V10B01-087_D1,0,0,0,2,0,2
CGGTATAGGTATTAGC-1_V10B01-087_D1,1,0,1,0,0,2
CCAACGCTTGCCAGGG-1_V10B01-087_D1,2,2,1,0,0,5
CGTTGAGTAATTGCGT-1_V10B01-087_D1,1,2,1,0,0,4
TGTATTTACCTAATGC-1_V10B01-087_D1,0,2,1,0,0,3
TAAATGCCGTCTCATG-1_V10B01-087_D1,3,2,1,1,0,7
CGGTTTATGAAGGAAC-1_V10B01-087_D1,1,0,0,0,0,1
GCAAGATGTGTTCGCG-1_V10B01-087_D1,0,0,0,0,0,0
AAAGGTAAGCTGTACC-1_V10B01-087_D1,3,2,0,0,0,5
GTACGTCACGTATTAA-1_V10B01-087_D1,2,3,1,0,0,6
AGTACCTTCGAGTGCT-1_V10B01-087_D1,3,0,0,0,0,3
ATTGTGACTTCGCTGC-1_V10B01-087_D1,5,4,1,0,0,10
TGTATCAGACTGAAGC-1_V10B01-087_D1,2,2,1,0,0,5
GAGACCCTGCAACGCC-1_V10B01-087_D1,1,1,0,0,0,2
TGGGTGGGATGTCATT-1_V10B01-087_D1,3,3,1,0,0,7
GGCTAATGATTGAAAT-1_V10B01-087_D1,4,1,1,0,0,6
ATAACGTTACCTCCAC-1_V10B01-087_D1,5,0,1,0,0,6
TGCGAGATGGCGGCCA-1_V10B01-087_D1,2,0,0,0,0,2
CACACTTGTATTGCGA-1_V10B01-087_D1,2,4,2,0,0,8
GCTGGTGACTCGTAGT-1_V10B01-087_D1,4,1,0,0,0,5
CGACACCGCTTAAGGA-1_V10B01-087_D1,2,0,0,0,0,2
GTAACAACTGACCTTG-1_V10B01-087_D1,5,0,2,0,0,7
CAACTGAGGGTATGAC-1_V10B01-087_D1,3,0,2,0,0,5
CTAATTATGAAGCGTA-1_V10B01-087_D1,2,1,1,0,0,4
CCGATCTTAAGAGGCT-1_V10B01-087_D1,1,0,0,0,0,1
CGACTCGGTACACGGT-1_V10B01-087_D1,3,2,0,0,0,5
TGCTGCGTCAGAGTTA-1_V10B01-087_D1,1,1,0,0,0,2
AGAGTTGCAGGCCTCC-1_V10B01-087_D1,0,0,2,0,0,2
ACTGGCGAACCTGCGT-1_V10B01-087_D1,2,1,1,0,0,4
ACTAAGGACGCACACC-1_V10B01-087_D1,1,0,0,0,0,1
CGTCCAGATGGCTCCA-1_V10B01-087_D1,1,0,2,0,0,3
ACTATCGCCGGCTAAA-1_V10B01-087_D1,2,0,0,0,0,2
GATAGCGTACCACGCG-1_V10B01-087_D1,4,1,0,0,0,5
AGGACTTATAGGAGAA-1_V10B01-087_D1,2,1,1,0,0,4
TAGTCGGGATTCTTCG-1_V10B01-087_D1,0,1,0,0,0,1
ACCATTAAGGGTGTCA-1_V10B01-087_D1,3,0,1,0,0,4
TTAATGTGTTTGCAGG-1_V10B01-087_D1,2,1,0,0,0,3
TCCGCAGCCACCTAGC-1_V10B01-087_D1,3,0,1,1,0,5
GAGGAGATCCTCATGC-1_V10B01-087_D1,1,1,1,0,0,3
GGTCCTTCATACGACT-1_V10B01-087_D1,1,2,0,0,0,3
CCCTGTTGGCAAAGAC-1_V10B01-087_D1,1,2,1,0,0,4
GTGCCTAGCTATGCTT-1_V10B01-087_D1,0,1,1,0,0,2
GTCATCTCCTACAGCT-1_V10B01-087_D1,2,1,0,0,0,3
GCGAGAAACGGGAGTT-1_V10B01-087_D1,2,1,1,0,0,4
CGTCGCGGCGGGATTT-1_V10B01-087_D1,3,0,1,0,0,4
CATTGTGTGCTAGATC-1_V10B01-087_D1,1,1,0,0,0,2
CGCGGCAGTATTACGG-1_V10B01-087_D1,1,3,1,0,0,5
GAAATGGGATGTAAAC-1_V10B01-087_D1,4,0,0,0,0,4
CATTCCCTAAGTACAA-1_V10B01-087_D1,1,2,0,0,0,3
AGTTCTGCGTTGTATC-1_V10B01-087_D1,2,2,2,0,0,6
ACCCTATAGGACTGAG-1_V10B01-087_D1,2,1,0,0,0,3
TTAGATAGGTCGATAC-1_V10B01-087_D1,1,1,0,0,0,2
ATTGATAGCAACGAGA-1_V10B01-087_D1,0,0,0,0,0,0
TCTCGGCTCCAGGACT-1_V10B01-087_D1,3,2,2,0,0,7
CTTGAGGTTATCCCGA-1_V10B01-087_D1,0,1,0,0,0,1
AAGAAGGATCAGTTAG-1_V10B01-087_D1,2,0,1,0,0,3
GTACGACGGCGCTGCG-1_V10B01-087_D1,1,2,0,0,0,3
CTTATGTTGACTACCA-1_V10B01-087_D1,3,0,0,0,0,3
CGGCACTCAAGAAAGT-1_V10B01-087_D1,2,1,0,0,0,3
GTCAAAGTTTACATAG-1_V10B01-087_D1,0,1,0,0,0,1
CTCCTAAGTTATGTCT-1_V10B01-087_D1,2,0,0,0,0,2
ACTGTGCTAGTAGATC-1_V10B01-087_D1,2,0,0,0,0,2
GTTTGGCCGCTCAGCG-1_V10B01-087_D1,3,1,1,0,0,5
TTATCCAATCGAACTC-1_V10B01-087_D1,0,0,2,0,0,2
CCGTACCCAAGCGCCA-1_V10B01-087_D1,3,1,0,0,0,4
CATACAAAGCCGAACC-1_V10B01-087_D1,2,0,0,0,0,2
GGTCGGTAATTAGACA-1_V10B01-087_D1,5,0,0,0,0,5
AGCGGGAAGGGTCCAT-1_V10B01-087_D1,1,0,1,1,0,3
GCCCACCAAGGCTGTC-1_V10B01-087_D1,4,1,0,0,0,5
GTAGACGTCGTTACAT-1_V10B01-087_D1,7,1,2,0,0,10
GAGCATCATCCCTGGG-1_V10B01-087_D1,0,1,0,0,0,1
AGGTAACCTCCTATTC-1_V10B01-087_D1,3,0,1,0,0,4
GGTTTGAGTGCTGGAA-1_V10B01-087_D1,1,2,1,0,0,4
GCACTAGTCGCGCTAT-1_V10B01-087_D1,2,2,1,0,0,5
GGTAACTATGTATCTG-1_V10B01-087_D1,4,1,0,0,0,5
GCGGTCCCTAGACGCA-1_V10B01-087_D1,3,1,2,0,0,6
CGAGCGTTGATCAGCC-1_V10B01-087_D1,2,0,0,1,0,3
AATCCAAGGGCCTGAG-1_V10B01-087_D1,4,0,0,0,0,4
CCGTGCCCATGACGGC-1_V10B01-087_D1,6,2,0,0,0,8
GAAATTCACATCGCTG-1_V10B01-087_D1,0,2,0,0,0,2
CTCTGCGAAGCAAGCA-1_V10B01-087_D1,6,0,2,0,0,8
AGTAGGTAACATACAT-1_V10B01-087_D1,2,1,2,0,0,5
ATTGGGAATATCTTGG-1_V10B01-087_D1,2,3,0,0,0,5
TAGAGCTACGAAGAAC-1_V10B01-087_D1,1,1,0,0,0,2
TGCGGCATAGTTCAAC-1_V10B01-087_D1,2,1,0,0,0,3
CCGCCGGTCAACACAC-1_V10B01-087_D1,6,0,0,0,0,6
TCGTATAGTGCAATTA-1_V10B01-087_D1,6,0,2,0,0,8
TAGTTTATTCTTGCTT-1_V10B01-087_D1,2,0,0,0,0,2
GATATCTCATGCAATA-1_V10B01-087_D1,1,0,0,0,0,1
CGTTTAAGCGGAGCAC-1_V10B01-087_D1,2,0,0,0,0,2
CATGCTGGCTCCAATT-1_V10B01-087_D1,1,1,1,0,0,3
GAAACAGCCATGCAGT-1_V10B01-087_D1,2,0,2,0,0,4
AGTTTCGCAGGTCGGA-1_V10B01-087_D1,2,2,0,0,0,4
CTCATGGCTCACAATC-1_V10B01-087_D1,3,1,2,0,0,6
AACCGTTGTGTTTGCT-1_V10B01-087_D1,1,0,0,0,0,1
ACCCTTCATCTGCGAA-1_V10B01-087_D1,6,0,0,0,0,6
TGCGGTGAAATTTCAT-1_V10B01-087_D1,4,0,0,0,0,4
CAAATTGTCAGCAAGC-1_V10B01-087_D1,1,0,2,0,0,3
GAGGTACATCCATCTT-1_V10B01-087_D1,2,1,0,0,0,3
AAATGGCATGTCTTGT-1_V10B01-087_D1,4,0,2,0,0,6
TCATCCCAGAGGGTGG-1_V10B01-087_D1,3,0,0,0,0,3
CGTAGCGAATTGTCAG-1_V10B01-087_D1,6,0,0,0,0,6
CCTAGTTAGTCGCATG-1_V10B01-087_D1,6,1,2,0,0,9
GAAACTCTAATGAAGG-1_V10B01-087_D1,5,0,1,0,0,6
TTGTATCACACAGAAT-1_V10B01-087_D1,4,0,0,0,0,4
TTCAAGCCGAGCTGAG-1_V10B01-087_D1,4,1,0,0,0,5
AGGTACGATATTGCCA-1_V10B01-087_D1,2,0,2,0,0,4
TTAAGCCGACAACTTC-1_V10B01-087_D1,5,0,0,0,0,5
GTCTTAGTACAGCCGG-1_V10B01-087_D1,6,0,0,0,0,6
TGGGTAAGGTTCCCGC-1_V10B01-087_D1,2,2,1,0,0,5
CTACGCCATTTCCGAT-1_V10B01-087_D1,1,1,1,0,0,3
GACCGTCAGGTCGTGA-1_V10B01-087_D1,1,3,0,1,0,5
TAGTTAAGATAGGATA-1_V10B01-087_D1,2,2,0,1,0,5
GAATATTCGGAGTCCC-1_V10B01-087_D1,3,0,2,0,0,5
CAAACTACGATAGAGA-1_V10B01-087_D1,5,2,0,0,0,7
CAGGAAGACTTTATAT-1_V10B01-087_D1,1,1,0,0,0,2
TTCGTAATCCCAGCGG-1_V10B01-087_D1,6,0,0,0,0,6
GTGAGGAGCGGTTGAG-1_V10B01-087_D1,2,1,1,0,0,4
CAATCCCTATACCAGC-1_V10B01-087_D1,1,0,0,0,0,1
AGGGAAACGAGGTACT-1_V10B01-087_D1,4,0,0,0,0,4
TCCTGCCAACTGGAGA-1_V10B01-087_D1,3,2,0,0,0,5
AATTTGGGACATAGTA-1_V10B01-087_D1,3,1,1,0,0,5
AACTCCTAATCCCATG-1_V10B01-087_D1,4,0,2,1,0,7
GCTCATTACTGCATGT-1_V10B01-087_D1,3,0,0,0,0,3
TCTCGAACGAGGTCAC-1_V10B01-087_D1,5,1,0,0,0,6
TCACTACGACCAATGC-1_V10B01-087_D1,1,0,1,1,0,3
GTGATGCACAACATCT-1_V10B01-087_D1,3,0,0,0,0,3
CCGACGTAAACACAAC-1_V10B01-087_D1,1,0,1,0,0,2
TGGGATGCACTCATTC-1_V10B01-087_D1,1,1,0,0,0,2
TTCCATCATGCGGTGA-1_V10B01-087_D1,3,0,1,0,0,4
TGCACAGTGAAGTTAT-1_V10B01-087_D1,1,0,1,1,0,3
CTATTGTGTTTGGTCA-1_V10B01-087_D1,2,0,0,0,0,2
TGCGAGCCCTTCCGCG-1_V10B01-087_D1,2,0,0,0,0,2
TTGAAAGGTGTAAAGG-1_V10B01-087_D1,3,0,0,0,0,3
GGTGCAGAGCCTATCG-1_V10B01-087_D1,6,0,0,0,0,6
ACTATATGCTGTGTTC-1_V10B01-087_D1,1,0,1,0,0,2
TCCTGGCGCTGCCTGG-1_V10B01-087_D1,3,0,0,0,0,3
GAGCCGAGCGTTTATT-1_V10B01-087_D1,0,1,4,0,0,5
AGAATGCGGGTTCGGA-1_V10B01-087_D1,1,1,1,0,0,3
ATGCGACAATTGGTCC-1_V10B01-087_D1,3,1,0,0,0,4
TTCCGGCTCGACTTCT-1_V10B01-087_D1,3,1,0,1,0,5
TGATTATGGCACGCAG-1_V10B01-087_D1,0,0,1,0,0,1
GGTTTGACAAGAAGCT-1_V10B01-087_D1,2,0,1,0,0,3
GCAGCTATGGACAGGT-1_V10B01-087_D1,0,0,0,0,0,0
CACCATGATCGCAAAG-1_V10B01-087_D1,1,0,0,0,0,1
GTCGGAAGGATACCAG-1_V10B01-087_D1,2,2,4,1,0,9
GGCCCAGTTATCAGCA-1_V10B01-087_D1,1,0,0,0,0,1
GGGCCTATTTAAGTAT-1_V10B01-087_D1,3,0,0,0,0,3
GTTGTTACATTGCGCT-1_V10B01-087_D1,7,0,1,0,0,8
CAACTCCGTAACTTGC-1_V10B01-087_D1,2,2,1,0,0,5
GATCTTTGCTCAAAGA-1_V10B01-087_D1,3,0,0,0,0,3
TCGCTTAATTACGAAG-1_V10B01-087_D1,0,0,0,0,0,0
CGATCATTAGAGGCAC-1_V10B01-087_D1,3,3,0,1,0,7
TGTTCTCTACTCCCTA-1_V10B01-087_D1,3,1,0,0,0,4
GCTTAGGGAAGCGGTA-1_V10B01-087_D1,3,0,0,0,0,3
CAGGTTTAGTACTACA-1_V10B01-087_D1,2,2,1,0,0,5
AAGCGGAGTGCGCGCA-1_V10B01-087_D1,3,0,2,0,0,5
TCAGATGGAGACGTAG-1_V10B01-087_D1,3,1,0,0,0,4
TCGCACTAACGTTTGT-1_V10B01-087_D1,3,0,0,0,0,3
CACGTCGGGTTCTAGA-1_V10B01-087_D1,0,2,1,0,0,3
GGAGTACACATGAGCT-1_V10B01-087_D1,2,1,0,0,0,3
GTGTGTCGACGTCGCT-1_V10B01-087_D1,0,0,0,0,0,0
GAAGCTCTTTGCTTAG-1_V10B01-087_D1,3,2,0,0,0,5
ACACCGAGCGCTCTTT-1_V10B01-087_D1,1,1,1,0,0,3
CGTAATAATTACGAGT-1_V10B01-087_D1,3,0,0,0,0,3
CATCAACACCTACTAA-1_V10B01-087_D1,5,0,0,0,0,5
CCAAGTTTCTACAGAT-1_V10B01-087_D1,4,1,0,0,0,5
ACGGGTCATGTGACTT-1_V10B01-087_D1,2,0,1,0,0,3
AGTGTGCTAAGATCGC-1_V10B01-087_D1,4,1,2,0,0,7
GGCGGTTTGCCGGTGC-1_V10B01-087_D1,5,0,0,0,0,5
GTATAATCTCCCGGAT-1_V10B01-087_D1,1,1,0,0,0,2
TAGTCCGTATGCATAA-1_V10B01-087_D1,2,1,0,0,0,3
CACTTCGTCTTATCTC-1_V10B01-087_D1,3,0,0,0,0,3
CATCCGCAGGCCCGAA-1_V10B01-087_D1,2,0,1,0,0,3
CCCTGATGTAACTCGT-1_V10B01-087_D1,4,0,2,0,0,6
CCATAGTCAGTAACCC-1_V10B01-087_D1,3,0,0,0,0,3
CGGGCCATAGCCGCAC-1_V10B01-087_D1,2,1,0,0,0,3
CTCCGGCTTGTAGACA-1_V10B01-087_D1,2,1,0,0,0,3
AACTTGCGTTCTCGCG-1_V10B01-087_D1,2,0,1,0,0,3
AATGAGTTCGCATATG-1_V10B01-087_D1,5,0,0,0,0,5
CGAGGCCAGGCATTGG-1_V10B01-087_D1,2,1,1,0,0,4
TCTGCGTCCGGTTTCT-1_V10B01-087_D1,3,0,0,0,0,3
CAATCCTGCCGTGGAG-1_V10B01-087_D1,1,0,1,0,0,2
CTGAGCAAGTAACAAG-1_V10B01-087_D1,5,1,0,0,0,6
GGGTACCCACGGTCCT-1_V10B01-087_D1,5,0,1,0,0,6
ACGGAATTTAGCAAAT-1_V10B01-087_D1,1,0,1,0,0,2
GGGCGGTCCTATTGTC-1_V10B01-087_D1,2,1,0,0,0,3
ATGTTACGAGCAATAC-1_V10B01-087_D1,3,0,1,0,0,4
AACCATGGGATCGCTA-1_V10B01-087_D1,2,1,0,0,0,3
TCGCATCCCTAAGTGT-1_V10B01-087_D1,5,0,0,1,0,6
ACTTAGTACGACAAGA-1_V10B01-087_D1,0,1,1,0,0,2
GAGCTCTCGGACCTAA-1_V10B01-087_D1,2,2,1,0,0,5
TCTATTACGCTGGCGA-1_V10B01-087_D1,4,0,0,0,0,4
AGATACGACTTCATAT-1_V10B01-087_D1,0,0,0,0,0,0
CGCTATACCGCCCACT-1_V10B01-087_D1,0,0,0,0,0,0
CAGTGTCCGCAGAATG-1_V10B01-087_D1,2,1,0,0,0,3
CCATCCATACCAAGTC-1_V10B01-087_D1,2,3,1,0,0,6
AACCCAGAGACGGAGA-1_V10B01-087_D1,2,0,0,0,0,2
GAAGAACGGTGCAGGT-1_V10B01-087_D1,0,0,1,0,0,1
GATAAATCGGTGGATG-1_V10B01-087_D1,5,0,1,0,0,6
CAGCTCGTGCTTGTGT-1_V10B01-087_D1,3,0,0,0,0,3
GAGTACGGGTATACAA-1_V10B01-087_D1,4,0,1,0,0,5
CATCGCCCGCGGCCAA-1_V10B01-087_D1,2,1,0,0,0,3
TCTTACAGAGGTACCG-1_V10B01-087_D1,4,1,0,0,0,5
TGGAAGACGAACACCA-1_V10B01-087_D1,2,1,0,0,0,3
GTTGTCGTGTTAGTTG-1_V10B01-087_D1,4,0,1,0,0,5
CCAAGGAACAGAGAGG-1_V10B01-087_D1,2,2,0,0,0,4
CTGCACCTGGAACCGC-1_V10B01-087_D1,0,0,1,0,0,1
CGCTTTCATACCGGTG-1_V10B01-087_D1,1,2,5,0,0,8
GTTCTTCCCTCGATGT-1_V10B01-087_D1,1,0,3,0,0,4
ATTTAACTCGTATTAC-1_V10B01-087_D1,2,1,0,0,0,3
AACGATAGAAGGGCCG-1_V10B01-087_D1,2,0,0,1,0,3
TATCCTGCATGGGAAT-1_V10B01-087_D1,0,0,0,0,0,0
AGGCCCATTGTACAGG-1_V10B01-087_D1,3,1,0,0,0,4
CCGGCGCATATTGGAT-1_V10B01-087_D1,3,1,1,0,0,5
ATCTGTAATTGTACCC-1_V10B01-087_D1,4,1,3,0,0,8
GAGCGAGGGAGTACCG-1_V10B01-087_D1,2,0,0,0,0,2
TTATTAGGGAAGCATC-1_V10B01-087_D1,4,0,0,0,0,4
CTTCTTACGTCGTATA-1_V10B01-087_D1,4,0,0,0,0,4
GAAGTGCTGGATAGCT-1_V10B01-087_D1,1,2,0,0,0,3
GTGCAACAAATGTGGC-1_V10B01-087_D1,3,0,0,0,0,3
CATGCGTTAGACAGAA-1_V10B01-087_D1,0,1,2,0,0,3
ACACACTTTCTACACG-1_V10B01-087_D1,1,0,0,0,0,1
AGCCCTAAGCGAAGTT-1_V10B01-087_D1,1,0,0,0,0,1
ATTAATTCGGTCACTC-1_V10B01-087_D1,6,0,0,0,0,6
AACAGGAAATCGAATA-1_V10B01-087_D1,0,0,1,1,0,2
ACGTTTAGTTGTGATC-1_V10B01-087_D1,0,2,1,0,0,3
TCCTTCAGTGGTCGAA-1_V10B01-087_D1,2,0,0,0,0,2
CGAACGCCCAGTGCCG-1_V10B01-087_D1,3,0,1,0,0,4
CCTCGAAGTGGACGGG-1_V10B01-087_D1,2,0,0,0,0,2
CTCTGTTTGAGGATTC-1_V10B01-087_D1,4,0,0,0,0,4
TGGGCACGTTCTATGG-1_V10B01-087_D1,4,0,0,0,0,4
ACTATTCGTCCGTGGT-1_V10B01-087_D1,2,0,1,0,0,3
CCTCTGGCCTAGACGG-1_V10B01-087_D1,5,0,1,0,0,6
CCATAAACAACCCGAC-1_V10B01-087_D1,1,0,0,0,0,1
CATAGTACATTGAGAG-1_V10B01-087_D1,0,0,1,0,0,1
ATTTCATTATTTCGCG-1_V10B01-087_D1,3,0,1,0,0,4
CAACTATATCGAATGC-1_V10B01-087_D1,0,0,0,0,0,0
CTAGTATTCGGAATTA-1_V10B01-087_D1,1,1,1,0,0,3
GTGGAACCTACATGCG-1_V10B01-087_D1,4,1,1,0,0,6
CCTAAAGGCTGACGCT-1_V10B01-087_D1,0,1,1,1,0,3
CGTGACATTGGGTCGT-1_V10B01-087_D1,1,0,0,0,0,1
CCAATCGGTAGATCGA-1_V10B01-087_D1,1,1,0,1,0,3
ATTGTCGCAATACCTT-1_V10B01-087_D1,6,0,2,0,0,8
AAATTACACGACTCTG-1_V10B01-087_D1,2,1,0,0,0,3
CACTCCTCTCGGTCGG-1_V10B01-087_D1,1,0,1,0,0,2
AAATAACCATACGGGA-1_V10B01-087_D1,2,1,1,0,0,4
AGTTACTCTATCGTGG-1_V10B01-087_D1,2,0,2,0,0,4
CGTTAGCTCACAACTG-1_V10B01-087_D1,2,0,2,0,0,4
GAATGTATGGCAGGTC-1_V10B01-087_D1,8,0,1,0,0,9
GCAACCACCAGACCGG-1_V10B01-087_D1,2,0,2,0,0,4
TCACTCGTGCAACGGC-1_V10B01-087_D1,5,0,1,0,0,6
AAACAGAGCGACTCCT-1_V10B01-087_D1,1,0,0,0,0,1
CAGCCTCTCCTCAAGA-1_V10B01-087_D1,1,0,0,0,0,1
TTGCGTGAACGCTTAG-1_V10B01-087_D1,4,2,0,0,0,6
CCGCCTGCGAATTGGT-1_V10B01-087_D1,3,1,3,0,0,7
AGATGAGGGTTGCGAT-1_V10B01-087_D1,1,0,0,0,0,1
CGGTGGGCTCCAGCCT-1_V10B01-087_D1,3,1,2,0,0,6
GGCAGCGGTAATCCTA-1_V10B01-087_D1,6,0,3,0,0,9
GCTAGCAGGGAGTGGG-1_V10B01-087_D1,3,1,1,0,0,5
CTCAAGACATTAGCGC-1_V10B01-087_D1,1,2,1,0,0,4
CACGGCGCGCCAAAGG-1_V10B01-087_D1,0,0,0,0,0,0
TGCAATTTGGGCACGG-1_V10B01-087_D1,3,0,0,0,0,3
ATGCCAATCGCTCTGC-1_V10B01-087_D1,1,1,0,0,0,2
GCTGGACCCAAAGTGG-1_V10B01-087_D1,1,0,0,0,0,1
ATTCCTAAGACGTGGA-1_V10B01-087_D1,2,1,1,0,0,4
TCCGGAGGAAGGGCTG-1_V10B01-087_D1,2,0,0,0,0,2
TCGGTGACCGCTCCGG-1_V10B01-087_D1,1,1,1,0,0,3
TCCGAAGTAGTCACCA-1_V10B01-087_D1,5,0,0,0,0,5
CATGTAGGAGCGCCAA-1_V10B01-087_D1,2,1,1,0,0,4
CACAAGAAAGATATTA-1_V10B01-087_D1,3,1,0,1,0,5
AGGGTCAGTAACCCTA-1_V10B01-087_D1,1,0,1,0,0,2
TAAGCCCTTACGACCA-1_V10B01-087_D1,2,1,0,0,0,3
ATACCGTCATCCATAA-1_V10B01-087_D1,2,0,0,0,0,2
GGACGTCCATAGTTGG-1_V10B01-087_D1,2,1,0,0,0,3
CATCAAACTGGCGCCC-1_V10B01-087_D1,1,0,0,0,0,1
AAACGTGTTCGCCCTA-1_V10B01-087_D1,2,0,0,0,0,2
AAATTGGTGAGAAGCA-1_V10B01-087_D1,1,3,0,0,0,4
GGTCATTGTAGTCATA-1_V10B01-087_D1,6,0,1,0,0,7
TGCAGTGAGGCTCGGG-1_V10B01-087_D1,1,0,1,0,0,2
GAACATTAGTATGTTA-1_V10B01-087_D1,4,0,0,0,0,4
GGTTTGCGAACACGTA-1_V10B01-087_D1,2,1,2,0,0,5
ACACAAATATTCCTAG-1_V10B01-087_D1,3,0,0,0,0,3
TTGGGTTTATTCAGCG-1_V10B01-087_D1,3,2,0,1,0,6
ATTCGCAGAGGACACT-1_V10B01-087_D1,1,0,0,0,0,1
GATTTAGTGCGTACTG-1_V10B01-087_D1,3,0,0,0,0,3
TAGAAACACAATAGTG-1_V10B01-087_D1,2,1,0,0,0,3
CAGTAGATGATGTCCG-1_V10B01-087_D1,5,0,0,0,0,5
TCTTAACTCGGATGTA-1_V10B01-087_D1,1,0,0,0,0,1
TACATCTTGTTTCTTG-1_V10B01-087_D1,4,0,1,1,0,6
TTCATAGGGTGTCCAT-1_V10B01-087_D1,2,0,0,0,0,2
TGAAGTAGCTTACGGA-1_V10B01-087_D1,3,1,0,0,0,4
GCACAAGTGGATCATA-1_V10B01-087_D1,0,0,1,0,0,1
GGGCGAATTTCTCCAC-1_V10B01-087_D1,1,0,0,0,0,1
ATGTTCCTGCCCACCT-1_V10B01-087_D1,2,1,0,1,0,4
GCTCAACCTCTTAGAG-1_V10B01-087_D1,3,1,0,0,0,4
ATAGCTGCTCTTGTTA-1_V10B01-087_D1,0,1,4,0,0,5
CGTCAGCTATTTACTC-1_V10B01-087_D1,0,2,0,0,0,2
ATCTGATAGTGTCTTA-1_V10B01-087_D1,1,0,0,0,0,1
TGCACTATGTGAGTGC-1_V10B01-087_D1,1,0,0,0,0,1
CCGACAAACACATGAG-1_V10B01-087_D1,3,0,1,0,0,4
GCCTTGTATATGCAGT-1_V10B01-087_D1,3,0,0,0,0,3
ATAATACCGTTAGCCG-1_V10B01-087_D1,0,0,0,0,0,0
ACACTCCAATGTCACT-1_V10B01-087_D1,1,0,0,0,0,1
AGTTGCTGACTGATAT-1_V10B01-087_D1,3,2,2,0,0,7
GGCGCTCCTCATCAAT-1_V10B01-087_D1,3,2,1,0,0,6
TGCCTGACATCGGTCA-1_V10B01-087_D1,1,0,0,0,0,1
TTGGCCATCTTGCGCT-1_V10B01-087_D1,4,0,0,0,0,4
CAGTGGTTGCACATGA-1_V10B01-087_D1,2,0,0,0,0,2
AGAATTGTTTGACATA-1_V10B01-087_D1,2,1,0,0,0,3
AAATGCTCGTTACGTT-1_V10B01-087_D1,4,1,0,0,0,5
CACCTAATAGAGTCGT-1_V10B01-087_D1,1,0,0,0,0,1
CATTTCTAGCAGACTA-1_V10B01-087_D1,3,1,2,0,0,6
CCGAAAGTGGTGAGCA-1_V10B01-087_D1,5,1,1,0,0,7
AGTCAGCCACCGCCTG-1_V10B01-087_D1,3,0,0,0,0,3
TCATCACTCGAGCTCG-1_V10B01-087_D1,1,1,1,0,0,3
CTCAGGACTCACCTGT-1_V10B01-087_D1,2,2,0,1,0,5
CGGTGTACTTGATCCC-1_V10B01-087_D1,1,2,0,0,0,3
CCTACGGCTCAGTCGA-1_V10B01-087_D1,10,1,0,0,2,13
GTACTTGGGCACTTCT-1_V10B01-087_D1,2,1,0,1,0,4
TGATTTCCTCCTGACG-1_V10B01-087_D1,3,1,0,0,0,4
CCTCACCAATCTTGAC-1_V10B01-087_D1,2,1,1,0,0,4
GGTGAGATGCAGATAA-1_V10B01-087_D1,0,0,0,0,0,0
GCTAGTTTCATTGAGG-1_V10B01-087_D1,1,0,0,0,0,1
AGGACATCGCACGTCG-1_V10B01-087_D1,0,1,0,0,0,1
GTGGACGTGCTGAGAC-1_V10B01-087_D1,3,2,0,1,0,6
TAAGGAACTTGTGGGA-1_V10B01-087_D1,1,1,0,0,0,2
TCGCTGTGCGTAAATC-1_V10B01-087_D1,0,0,0,0,0,0
GCATCCCTAACTTTGA-1_V10B01-087_D1,2,1,0,0,0,3
CACCCACACGTCACCC-1_V10B01-087_D1,2,1,0,0,0,3
CCCTCATTCTGGAATT-1_V10B01-087_D1,0,0,0,0,0,0
AGGGCGTGATCGGCTA-1_V10B01-087_D1,0,1,1,0,0,2
GGTGCGGATAAGTGGC-1_V10B01-087_D1,2,1,0,0,0,3
TAATATTGAAATTCGC-1_V10B01-087_D1,1,1,1,0,0,3
CTTACACTGGGAAATA-1_V10B01-087_D1,3,1,0,0,0,4
ACCAAGAACGCGTGTC-1_V10B01-087_D1,2,0,0,0,0,2
GCCTTCAGCCCTACCG-1_V10B01-087_D1,1,1,0,0,0,2
GATGCTACAAGCGCCT-1_V10B01-087_D1,0,1,1,1,0,3
CCGGGACCCGCAGAGA-1_V10B01-087_D1,3,0,0,0,0,3
GTTCCAGTCTGACCAT-1_V10B01-087_D1,2,1,0,0,0,3
ATGATCGGGAATAGAC-1_V10B01-087_D1,3,0,0,0,0,3
TTGGATTGGGTACCAC-1_V10B01-087_D1,1,0,0,0,0,1
TACCTCACGCTTGTAC-1_V10B01-087_D1,2,0,2,0,0,4
CATGGCAGGAAGATCG-1_V10B01-087_D1,3,0,1,1,0,5
ATGACGCCGGCTCTAA-1_V10B01-087_D1,0,2,2,0,0,4
AGCGACATCCCATTCA-1_V10B01-087_D1,2,0,0,0,0,2
AGTAATGTCTTGCCGC-1_V10B01-087_D1,5,1,0,0,0,6
TTCTTAGTGGCTCAGA-1_V10B01-087_D1,2,1,1,0,0,4
CGTCTGGAAGGGCCCG-1_V10B01-087_D1,2,1,4,0,0,7
ACGTGCGCCTCGTGCA-1_V10B01-087_D1,2,1,1,0,0,4
AGAGCGGGCTAATCAT-1_V10B01-087_D1,2,0,2,0,0,4
GCGTCGAAATGTCGGT-1_V10B01-087_D1,1,1,0,0,0,2
AACTGATATTAGGCCT-1_V10B01-087_D1,1,2,0,0,0,3
CGAGCTGGGCTTTAGG-1_V10B01-087_D1,0,0,1,0,0,1
GGGTGTTTCAGCTATG-1_V10B01-087_D1,0,0,0,0,0,0
TTAATTTCAGACGCGG-1_V10B01-087_D1,3,0,0,0,0,3
ACTGCCGTCGTAACTC-1_V10B01-087_D1,5,0,1,0,0,6
GTGCACGAAAGTGACT-1_V10B01-087_D1,0,1,0,1,0,2
ATCTCCCTGCAATCTA-1_V10B01-087_D1,5,0,0,0,0,5
ACGCCAGATGATTTCT-1_V10B01-087_D1,4,0,0,0,0,4
AGCTATTTAATCCAAC-1_V10B01-087_D1,2,0,0,0,0,2
CCACGAGAAGAGAATC-1_V10B01-087_D1,1,0,0,0,0,1
GATTCCGCGTTTCCGT-1_V10B01-087_D1,0,0,0,1,0,1
GTCGGATGTAGCGCGC-1_V10B01-087_D1,1,1,0,0,0,2
TATTTATACCGAGTAG-1_V10B01-087_D1,0,0,1,0,0,1
GTAGGTGATCCGTGTA-1_V10B01-087_D1,1,0,1,0,0,2
AGTTAAGCGGTCCCGG-1_V10B01-087_D1,1,0,0,0,0,1
CTGGCGACATAAGTCC-1_V10B01-087_D1,3,0,0,0,0,3
TTGGCCTAGAATTTCG-1_V10B01-087_D1,1,0,0,0,0,1
GGCATATCGGTTCTGC-1_V10B01-087_D1,3,0,1,0,0,4
GGGCGTCCACTGGCTC-1_V10B01-087_D1,0,1,1,0,0,2
TTACCCATTGCCGGGT-1_V10B01-087_D1,2,0,0,0,0,2
TTAGACACGATCGTTG-1_V10B01-087_D1,2,0,1,0,0,3
GCGCTGATCCAGACTC-1_V10B01-087_D1,1,0,0,0,0,1
TTCGGCAACCCGCTGA-1_V10B01-087_D1,4,0,2,0,0,6
GATATTTCCTACATGG-1_V10B01-087_D1,3,1,1,0,0,5
CTGCGTTACGATATAA-1_V10B01-087_D1,1,1,0,1,0,3
TAATAAACAAGGAGAT-1_V10B01-087_D1,1,0,3,0,0,4
AACCTTTACGACGTCT-1_V10B01-087_D1,0,0,0,0,0,0
AGTCCCGCCTTTAATT-1_V10B01-087_D1,3,0,0,0,0,3
TGAGATTAGGCCCTAA-1_V10B01-087_D1,2,1,1,0,0,4
AGTGTATTGCGCATTG-1_V10B01-087_D1,3,1,1,0,0,5
GTTGGATTCAGTGGCT-1_V10B01-087_D1,3,0,2,0,0,5
TAAAGCTGCAATAGGG-1_V10B01-087_D1,1,0,0,0,0,1
AGTAGGAAGGAAGTTG-1_V10B01-087_D1,2,0,2,0,0,4
TATCACTTCGAGTAAC-1_V10B01-087_D1,3,0,1,0,0,4
TGATCTACGCTGATCT-1_V10B01-087_D1,2,0,1,1,0,4
GGATCATCCCGTACGC-1_V10B01-087_D1,5,0,0,0,0,5
TGACACTTCTCTTTGC-1_V10B01-087_D1,4,0,1,0,0,5
AGCCCTTCTAATCCGA-1_V10B01-087_D1,5,0,0,0,0,5
CACCGCGTCCACTCTA-1_V10B01-087_D1,3,1,0,0,0,4
TAATTGGAATCGGGAA-1_V10B01-087_D1,4,1,0,0,0,5
TCGTAAGCTCCGAGGA-1_V10B01-087_D1,1,2,1,0,0,4
TATATTACAAATGTCG-1_V10B01-087_D1,6,0,1,0,0,7
CGCGAGAGGGACTTGT-1_V10B01-087_D1,1,0,1,0,0,2
GGACCTACGGTAACGT-1_V10B01-087_D1,1,2,1,0,0,4
GAAATATGCTTGAATG-1_V10B01-087_D1,1,1,0,0,0,2
CCGTATTAGCGCAGTT-1_V10B01-087_D1,4,0,1,0,0,5
AGGCGTCTATGGACGG-1_V10B01-087_D1,3,0,0,0,0,3
AACATCGATACGTCTA-1_V10B01-087_D1,0,0,0,0,0,0
TGAATATGCTATAAAC-1_V10B01-087_D1,5,1,0,0,0,6
ACCAAACACCCAGCGA-1_V10B01-087_D1,2,0,1,0,0,3
TGGCTTGTACAAGCTT-1_V10B01-087_D1,4,0,0,1,0,5
GAATGAAGGTCTTCAG-1_V10B01-087_D1,2,1,0,0,0,3
AGATACCAGCACTTCA-1_V10B01-087_D1,3,0,1,0,0,4
GCGGTCCCGGTGAAGG-1_V10B01-087_D1,0,0,0,0,0,0
GAGGCATTTGCAGCAG-1_V10B01-087_D1,2,0,0,0,0,2
GGCAAGCCAGGGATAG-1_V10B01-087_D1,0,0,0,0,0,0
TCTACGGGCTCAGTTG-1_V10B01-087_D1,1,0,0,0,0,1
TCTGCGAATCGTTCGC-1_V10B01-087_D1,6,0,0,0,0,6
AGCTCGTTGATGGAAA-1_V10B01-087_D1,2,1,1,0,0,4
TGAATGAGATACAGCA-1_V10B01-087_D1,1,0,1,1,0,3
ACCCTTGCCTGGGTCG-1_V10B01-087_D1,2,1,0,0,0,3
GGCGAACCGTTCTGAT-1_V10B01-087_D1,5,1,0,0,0,6
GCGATGTCTGTGCTTG-1_V10B01-087_D1,3,0,0,0,0,3
ATTAACACCTGAGATA-1_V10B01-087_D1,4,0,0,0,0,4
GAAATCTGACCAAGTT-1_V10B01-087_D1,4,0,2,0,0,6
CCTGACAAACTCGCGC-1_V10B01-087_D1,5,0,0,0,0,5
ATGTCATTTCCCATTG-1_V10B01-087_D1,3,1,0,0,0,4
GCGGTGCGGAGCATCG-1_V10B01-087_D1,4,1,0,0,0,5
CGGAAAGCAAATGTGC-1_V10B01-087_D1,5,1,0,0,0,6
GCTGAGCAACGGTTCT-1_V10B01-087_D1,4,0,2,0,0,6
TCACTCTTCGTCTGTC-1_V10B01-087_D1,1,1,0,0,0,2
GATCTTCATTGTCCTC-1_V10B01-087_D1,2,1,1,0,0,4
ACTCGATGTATTTCAT-1_V10B01-087_D1,2,0,0,0,0,2
TGAAGAGCGGTCCTAG-1_V10B01-087_D1,1,1,0,0,0,2
TAAACGTCGTCAATGA-1_V10B01-087_D1,1,0,0,0,0,1
ACGTTATTGGTCACTC-1_V10B01-087_D1,3,2,0,0,0,5
ATAGCCTCAGTACCCA-1_V10B01-087_D1,4,1,1,0,0,6
CGGGAGTATACCGCCG-1_V10B01-087_D1,3,2,1,0,0,6
GTCCTACAGGCGGCTC-1_V10B01-087_D1,2,2,1,0,0,5
CGGATAAGCGGACATG-1_V10B01-087_D1,8,0,0,0,0,8
AACTTCTGCGTCTATC-1_V10B01-087_D1,3,0,0,0,0,3
GGGTTCAGACGAACAA-1_V10B01-087_D1,4,1,2,0,0,7
AGTCTGGACATCCTTG-1_V10B01-087_D1,1,1,3,0,0,5
TTGAACGAATCCTTTG-1_V10B01-087_D1,2,0,1,0,0,3
GAAATACTAAACGTTT-1_V10B01-087_D1,3,1,0,0,0,4
CCCGCGCAATGCACCC-1_V10B01-087_D1,1,0,0,0,0,1
TTCGGCTAGAGATGGT-1_V10B01-087_D1,1,1,1,0,0,3
GACACGAGTTAGAGGA-1_V10B01-087_D1,3,3,0,0,0,6
GAGGTCCCAAAGATCT-1_V10B01-087_D1,2,1,0,0,0,3
TAACTCCATGGAGGCT-1_V10B01-087_D1,3,2,1,0,0,6
CTTGTTTATGTAGCCA-1_V10B01-087_D1,2,1,0,0,0,3
GATGGCGCACACATTA-1_V10B01-087_D1,0,0,1,1,0,2
ATAATAGTGTAGGGAC-1_V10B01-087_D1,2,0,0,0,0,2
CGCTATTCAATGTATG-1_V10B01-087_D1,1,1,0,0,0,2
ATATTGCTGTCAAAGT-1_V10B01-087_D1,0,0,1,0,0,1
GGATTCAGTACGGTGG-1_V10B01-087_D1,2,1,0,0,0,3
TTCTTAGTGAACGGTG-1_V10B01-087_D1,4,0,2,0,0,6
AATGGTTCTCACAAGC-1_V10B01-087_D1,2,1,1,0,0,4
TATACACGCAAAGTAT-1_V10B01-087_D1,1,0,0,0,0,1
CTTCATAGCTCAAGAA-1_V10B01-087_D1,3,1,0,0,0,4
CAACGGTTCTTGATAC-1_V10B01-087_D1,3,0,2,0,0,5
ACACCCGAGAAATCCG-1_V10B01-087_D1,0,1,0,0,0,1
TCTATCATGCAGTTAC-1_V10B01-087_D1,0,2,1,0,0,3
CCCGCCATGCTCCCGT-1_V10B01-087_D1,1,0,1,0,0,2
CGCTTCCACTGAAATC-1_V10B01-087_D1,4,0,2,0,0,6
CACTGTCCAAGTGAGA-1_V10B01-087_D1,4,0,1,0,0,5
ATTACTAGCCTCTTGC-1_V10B01-087_D1,1,1,0,0,0,2
CATAGTAGCATAGTAG-1_V10B01-087_D1,2,1,1,0,0,4
CAACTCCTTGATCCCG-1_V10B01-087_D1,2,0,0,0,0,2
AAGTAGAAGACCGGGT-1_V10B01-087_D1,2,0,0,0,0,2
GCGGGAACCAGGCCCT-1_V10B01-087_D1,3,0,1,0,0,4
ATTAGATTGATAGCGG-1_V10B01-087_D1,2,0,1,0,0,3
CTCGGTCCGTAGCCTG-1_V10B01-087_D1,0,2,0,0,0,2
TGGCTTTGGGTAGACA-1_V10B01-087_D1,3,0,2,0,0,5
TATCCATATCATGCGA-1_V10B01-087_D1,8,0,0,0,1,9
GGAGTGCCGCCCTGGA-1_V10B01-087_D1,0,1,1,0,0,2
TGAGAATGCTTTACCG-1_V10B01-087_D1,1,0,0,0,0,1
TTAACCAACCCTCCCT-1_V10B01-087_D1,2,2,1,0,0,5
TGTTTCGGTACTTCTC-1_V10B01-087_D1,3,0,0,0,0,3
TTGCTGAAGGAACCAC-1_V10B01-087_D1,4,1,0,0,0,5
TATTTAGTCTAGATCG-1_V10B01-087_D1,0,0,2,0,0,2
CTCCGGCCTAATATGC-1_V10B01-087_D1,2,0,0,0,0,2
TTGTGGCCCTGACAGT-1_V10B01-087_D1,1,0,1,0,0,2
TCGCCGGTCGATCCGT-1_V10B01-087_D1,3,0,2,0,0,5
CCATAGGTTGGCGTGG-1_V10B01-087_D1,2,1,0,0,0,3
GAACGACCGAATGATA-1_V10B01-087_D1,3,1,0,0,0,4
TCCGATAATTGCCATA-1_V10B01-087_D1,1,1,0,0,0,2
CATTACGTCGGCCCGT-1_V10B01-087_D1,2,0,0,0,0,2
CAAGCACCAAATGCCT-1_V10B01-087_D1,1,1,0,0,0,2
TGCATGGATCGGATCT-1_V10B01-087_D1,3,0,1,0,0,4
GAAATCGCGCGCAACT-1_V10B01-087_D1,2,0,0,0,0,2
CTGAAAGAGATCCGAC-1_V10B01-087_D1,0,0,1,0,0,1
CACCTCGATGGTGGAC-1_V10B01-087_D1,1,0,0,0,0,1
ATTTGTTCCAGGGCTC-1_V10B01-087_D1,3,0,2,0,0,5
TGGGCCACAAGAGCGC-1_V10B01-087_D1,2,0,0,0,0,2
CCTTCTTGATCCAGTG-1_V10B01-087_D1,5,1,0,0,0,6
CCTCGCCAGCAAATTA-1_V10B01-087_D1,4,1,0,0,0,5
TTCATGGCGCAACAGG-1_V10B01-087_D1,3,2,1,0,0,6
TTAATCAGTACGTCAG-1_V10B01-087_D1,1,1,1,0,0,3
CCTATCTATATCGGAA-1_V10B01-087_D1,2,0,2,0,0,4
ATTATACTTTGCTCGT-1_V10B01-087_D1,2,0,0,0,0,2
ATGGATCCGGCGTCCG-1_V10B01-087_D1,2,1,0,0,0,3
CGCCCGCTTCCGTACA-1_V10B01-087_D1,1,0,0,0,0,1
GGATTCCGCTATACCC-1_V10B01-087_D1,0,1,0,0,0,1
CGGTCTATCAACCCGT-1_V10B01-087_D1,1,0,0,0,0,1
ATGCCGGTTGATGGGA-1_V10B01-087_D1,6,0,1,0,0,7
TCATGCAGGTTCTCAT-1_V10B01-087_D1,5,0,2,0,0,7
TGAGCTTTAATGACGC-1_V10B01-087_D1,2,1,1,0,0,4
TCCCTTAGATTACTCG-1_V10B01-087_D1,1,1,0,0,0,2
ATATCTCCCTCGTTAA-1_V10B01-087_D1,1,0,0,0,0,1
AGCTCTTCCCAGTGCA-1_V10B01-087_D1,1,0,1,0,0,2
TCGCTAAACCGCTATC-1_V10B01-087_D1,0,2,1,0,0,3
CACATTCTTTCGATGG-1_V10B01-087_D1,1,0,0,0,0,1
GATATGCGGTAGCCAA-1_V10B01-087_D1,0,1,0,0,0,1
CGTTTCACTTCGGGCG-1_V10B01-087_D1,4,0,1,0,0,5
CCAATTACGGGTCGAG-1_V10B01-087_D1,5,0,0,0,0,5
GCAGGTAGAGTATGGT-1_V10B01-087_D1,1,0,1,0,0,2
GTCGTATTGGCGTACA-1_V10B01-087_D1,3,0,0,0,0,3
GAAATTAGCACGGATA-1_V10B01-087_D1,3,1,1,0,0,5
AATGCACCAAGCAATG-1_V10B01-087_D1,1,1,0,0,0,2
AGGACGCTCGATGTTG-1_V10B01-087_D1,5,0,0,0,0,5
GGCTAAAGGGCGGGTC-1_V10B01-087_D1,5,0,0,0,0,5
CATCTATCCCGTGTCT-1_V10B01-087_D1,2,0,0,0,0,2
CAGTAACTATTTATTG-1_V10B01-087_D1,2,1,0,0,0,3
CATATACTACTGATAA-1_V10B01-087_D1,3,1,0,0,0,4
GCGTTCGGAGACCGGG-1_V10B01-087_D1,1,1,0,1,0,3
AAGTTCAGTCTGCGTA-1_V10B01-087_D1,5,0,0,0,0,5
CGAAGCTATAAATTCA-1_V10B01-087_D1,2,0,0,0,0,2
CGCGGTCACAAACCAA-1_V10B01-087_D1,6,0,1,0,0,7
GGGAATGAGCCCTCAC-1_V10B01-087_D1,2,1,1,1,0,5
ACGGAGCGCAAATTAC-1_V10B01-087_D1,1,0,0,0,0,1
CGTTCTTCGCACACCT-1_V10B01-087_D1,1,0,0,0,0,1
GAATAGCCCTGCGGTC-1_V10B01-087_D1,2,0,1,0,0,3
AATAGCTACCGCGTGC-1_V10B01-087_D1,1,0,1,0,0,2
CCGAGCTGTGCTTGTC-1_V10B01-087_D1,1,1,2,0,0,4
GATGACGATGATCGCG-1_V10B01-087_D1,2,0,0,0,0,2
GCCTATGCTGGGCCTT-1_V10B01-087_D1,0,2,0,0,0,2
TTACTGTCTAGAGCTC-1_V10B01-087_D1,1,0,2,0,0,3
AGCGGTTGCCGCTCTG-1_V10B01-087_D1,4,1,0,0,0,5
GCTTGCAGCACAATTG-1_V10B01-087_D1,2,0,0,0,0,2
CCGGAGGTCTTATGGT-1_V10B01-087_D1,3,1,0,0,0,4
ACAGTATACCGTGGGA-1_V10B01-087_D1,4,0,0,0,0,4
GGGATCCCAATACAAA-1_V10B01-087_D1,4,0,0,0,0,4
ATTACGACTCCACAGT-1_V10B01-087_D1,3,1,1,0,0,5
CTCACACGCAAGCCTA-1_V10B01-087_D1,1,2,0,0,0,3
CCAGATGTAAATGGGT-1_V10B01-087_D1,4,2,0,0,0,6
GAACTTGTGCACGGGA-1_V10B01-087_D1,2,1,0,0,0,3
AAGCCGCTTTACCTTG-1_V10B01-087_D1,3,2,0,0,0,5
TCCATTCCCACTAGAG-1_V10B01-087_D1,4,0,0,0,0,4
AGAGCGCTTGTAACGG-1_V10B01-087_D1,0,0,2,0,0,2
TGGGTTCCCGGACGGA-1_V10B01-087_D1,5,0,0,0,0,5
GCTGCGCCTCCCACGT-1_V10B01-087_D1,2,1,1,0,0,4
CTGTTGGCTCTTCTGA-1_V10B01-087_D1,3,0,0,0,0,3
TTGTTCTAGATACGCT-1_V10B01-087_D1,4,0,0,0,0,4
CCCTCAAGCTCTTAGT-1_V10B01-087_D1,0,1,0,0,0,1
TGGTCTAGCTTACATG-1_V10B01-087_D1,5,0,0,0,0,5
ATGCACCTTCCTTAAT-1_V10B01-087_D1,3,0,2,1,0,6
GGGATACGGTAATAAT-1_V10B01-087_D1,2,0,0,0,0,2
AGTTCACCGGTTGGAC-1_V10B01-087_D1,4,1,0,0,0,5
GACATACTGTCGCAGA-1_V10B01-087_D1,4,0,0,1,0,5
TGGACACCGTTGCTTG-1_V10B01-087_D1,2,0,1,0,0,3
TGCGATGCTAATGGCT-1_V10B01-087_D1,0,1,0,0,0,1
TTCTGTTTCCTGTCGC-1_V10B01-087_D1,4,2,0,0,0,6
CGTTGTAAACGTCAGG-1_V10B01-087_D1,3,0,0,0,0,3
GATCGGCGATAAGTCG-1_V10B01-087_D1,0,0,0,0,0,0
AGCCTTAAAGCGGAAG-1_V10B01-087_D1,6,1,1,0,0,8
TCCGTAACCACAATCC-1_V10B01-087_D1,1,2,0,0,0,3
GAATGCCGAAATGACC-1_V10B01-087_D1,1,1,0,0,0,2
TATACTCATGCGGCAA-1_V10B01-087_D1,2,1,1,0,0,4
TAGTGTCAGAAACGGC-1_V10B01-087_D1,1,1,0,0,0,2
CGTCATACCATATCCA-1_V10B01-087_D1,1,0,0,0,0,1
TAGTACCTTAGTGGTC-1_V10B01-087_D1,1,1,1,0,0,3
CTGGCGGGAATAAGTA-1_V10B01-087_D1,3,1,1,0,0,5
AGTGTGGTCTATTGTG-1_V10B01-087_D1,3,1,1,0,0,5
GCTATCGCGGCGCAAC-1_V10B01-087_D1,1,0,0,0,0,1
CAGTAATCCCTCCCAG-1_V10B01-087_D1,3,1,1,0,0,5
GTATTAAGGCGTCTAA-1_V10B01-087_D1,0,0,2,0,0,2
CTAATTTCAACAACAC-1_V10B01-087_D1,3,0,0,0,0,3
TTAGCAACATGGATGT-1_V10B01-087_D1,3,0,0,0,0,3
ATGCTCAGTGTTGCAT-1_V10B01-087_D1,2,1,0,0,0,3
GATGTTTGTGCGAGAT-1_V10B01-087_D1,5,0,1,0,0,6
CACTTCGCCACAGGCT-1_V10B01-087_D1,4,0,2,0,0,6
CTGTATGGTGTAGAAA-1_V10B01-087_D1,3,0,1,0,0,4
TACGTGCACTATGCTG-1_V10B01-087_D1,3,3,0,0,0,6
GTATCAGCTTGGGTTC-1_V10B01-087_D1,3,1,2,0,0,6
TAACAAAGGGAGAAGC-1_V10B01-087_D1,2,0,2,0,0,4
TTACATCGTGGCCTGG-1_V10B01-087_D1,2,1,1,0,0,4
TCTGAACCGGTCGGCT-1_V10B01-087_D1,0,0,0,0,0,0
GGCTCGTGCCACCAGC-1_V10B01-087_D1,3,0,1,0,0,4
TATAAGTGAGGATAGC-1_V10B01-087_D1,3,0,2,0,0,5
GCCCGCGCGTTTGACA-1_V10B01-087_D1,5,1,0,0,0,6
TGCTGGTTGGACAATT-1_V10B01-087_D1,2,0,0,0,0,2
GCCTAGCGATCTGACC-1_V10B01-087_D1,0,1,0,0,0,1
CCATGCTCTGCAGGAA-1_V10B01-087_D1,5,0,1,0,0,6
TATAAATCCACAAGCT-1_V10B01-087_D1,2,1,0,0,0,3
CGCTCGACATAATGAT-1_V10B01-087_D1,5,1,0,0,0,6
CCAATTGAATGTTAAT-1_V10B01-087_D1,3,2,1,0,0,6
GCTAATACCGAATGCC-1_V10B01-087_D1,4,0,1,0,0,5
TTCAACGACCCGACCG-1_V10B01-087_D1,5,0,0,0,0,5
TTCCTCGAGGGTGTCT-1_V10B01-087_D1,1,0,0,0,0,1
CAACGACCCGTTTACA-1_V10B01-087_D1,2,0,0,0,0,2
CTTGTACTTGTTGACT-1_V10B01-087_D1,2,0,0,0,0,2
TCTCTAATAGCTGGTA-1_V10B01-087_D1,2,2,0,0,0,4
ATTATGCCATAGGGAG-1_V10B01-087_D1,1,0,0,0,0,1
GACAACGCAGCTTACG-1_V10B01-087_D1,1,0,0,0,0,1
AGATGACTCGCCCACG-1_V10B01-087_D1,0,1,2,0,0,3
GTGCGGGTCTCCAAAT-1_V10B01-087_D1,3,1,0,0,0,4
GTACGAGATTGCGACA-1_V10B01-087_D1,2,0,1,0,0,3
GTATAGGACTCAGTAG-1_V10B01-087_D1,1,1,0,0,0,2
TTGCACGGAGCAGCAC-1_V10B01-087_D1,1,1,0,0,0,2
CACAGCTAGGGAGTGA-1_V10B01-087_D1,2,0,1,0,0,3
ATACTAGCATGACCCT-1_V10B01-087_D1,5,1,0,0,0,6
CCAAGACTTCTGCGAA-1_V10B01-087_D1,2,0,0,0,0,2
ACATAATAAGGCGGTG-1_V10B01-087_D1,1,1,1,1,0,4
TAATACACAGTAGTAT-1_V10B01-087_D1,3,0,0,0,0,3
TCTTGGTAACACCAAA-1_V10B01-087_D1,0,0,0,0,0,0
AACTGGGTCCCGACGT-1_V10B01-087_D1,0,1,0,0,0,1
ATCACTTCATCCTCGC-1_V10B01-087_D1,2,0,0,0,0,2
TGGAAGGATAAAGATG-1_V10B01-087_D1,3,0,1,0,0,4
CATGATGCACAATTCT-1_V10B01-087_D1,1,1,0,0,0,2
TGCCTGATCAAACGAT-1_V10B01-087_D1,3,0,0,0,0,3
ATAGGGATATCCTTGA-1_V10B01-087_D1,0,1,0,0,0,1
CACCTAATCAGTTTAC-1_V10B01-087_D1,4,2,1,0,0,7
TGTGACTACGCCAGTC-1_V10B01-087_D1,1,1,0,0,0,2
CCCGACCATAGTCCGC-1_V10B01-087_D1,0,0,0,0,0,0
CGCGCCCGACTTAATA-1_V10B01-087_D1,1,1,0,0,0,2
TGCCACCTGGCGAAAC-1_V10B01-087_D1,2,0,0,0,0,2
CTGCCAAGGTTGGAAG-1_V10B01-087_D1,1,0,0,0,0,1
TCTCCAACGTAGGTTA-1_V10B01-087_D1,4,0,0,0,0,4
TTCTTGGAGTAATGAG-1_V10B01-087_D1,4,0,0,0,0,4
GTCTCGATCTGCTTTC-1_V10B01-087_D1,1,0,0,0,0,1
TACTCTCCGAACAAAT-1_V10B01-087_D1,1,0,0,0,0,1
ATCACATTAGAATATC-1_V10B01-087_D1,1,2,1,0,0,4
TACGGGATGCTAGCAG-1_V10B01-087_D1,0,0,1,0,0,1
AGCTGAAGTAAACCAA-1_V10B01-087_D1,0,0,0,0,0,0
CATGGGTCGGGTGTGG-1_V10B01-087_D1,1,1,1,0,0,3
CACCCACGAGGCAATT-1_V10B01-087_D1,4,0,0,0,0,4
TGCCATTACTAAAGAA-1_V10B01-087_D1,2,0,1,0,0,3
CCGTTACGTTAGAACA-1_V10B01-087_D1,2,0,0,1,0,3
GCCAGGAGTAACCGAT-1_V10B01-087_D1,1,0,0,0,0,1
GGAAAGTGCCCATGCC-1_V10B01-087_D1,1,0,0,0,0,1
TCTTACCGGAACTCGT-1_V10B01-087_D1,2,2,2,1,0,7
TATGTCAAGACCGACT-1_V10B01-087_D1,2,0,0,0,0,2
CCTAACTAAGGCTCTA-1_V10B01-087_D1,1,1,0,0,0,2
GCGGTGAACTGCGCTC-1_V10B01-087_D1,2,0,0,1,0,3
CCTCGCGCGATATAGG-1_V10B01-087_D1,3,1,0,0,0,4
ATCGGCAAGCAGTCCA-1_V10B01-087_D1,0,0,0,1,0,1
AGATCGTGCATAAGAT-1_V10B01-087_D1,3,0,0,0,0,3
ATTCAGGACCTATTTC-1_V10B01-087_D1,1,0,2,0,0,3
AGCTAGAAGCAGAAGT-1_V10B01-087_D1,0,2,0,0,0,2
TTCGCTATCTGACGTG-1_V10B01-087_D1,0,1,0,0,0,1
TTCCGCAGAGAAATAT-1_V10B01-087_D1,3,0,0,0,0,3
CAGTACATTCTCTAAA-1_V10B01-087_D1,1,1,0,0,0,2
GTGAAGATTTCAAGTG-1_V10B01-087_D1,1,0,1,1,0,3
AACGCATGATCTGGGT-1_V10B01-087_D1,2,1,0,0,0,3
CCCAGAGGAGGGCGTA-1_V10B01-087_D1,2,2,2,0,0,6
GGAAACCTTGTTGAAT-1_V10B01-087_D1,2,2,2,1,0,7
GTGAAGCCGTATAGTC-1_V10B01-087_D1,4,0,0,0,0,4
GAGCTGTCGTCTCGGA-1_V10B01-087_D1,1,1,0,0,0,2
TGTCATTTGTTGGGAA-1_V10B01-087_D1,3,1,1,0,0,5
ACCAACACCACACACT-1_V10B01-087_D1,1,1,1,0,0,3
AAATGATTCGATCAGC-1_V10B01-087_D1,1,2,0,0,0,3
CTGCTTTATGTCCGCG-1_V10B01-087_D1,2,3,2,1,0,8
GCGAGAGGCCATGTAA-1_V10B01-087_D1,2,1,0,0,0,3
ATTGACCGGCGATGAC-1_V10B01-087_D1,2,0,1,0,0,3
ACCCTGGTAACGCCCT-1_V10B01-087_D1,1,1,1,1,0,4
GTTGGACCGCATCAGG-1_V10B01-087_D1,4,0,1,0,0,5
CGTTTACAAGGCAGCT-1_V10B01-087_D1,1,1,0,0,0,2
CGGTCCATGAGACTCC-1_V10B01-087_D1,3,1,0,0,0,4
GTTCGTCTGGGTCCCT-1_V10B01-087_D1,2,2,1,0,0,5
TGTACTACTCTCACGG-1_V10B01-087_D1,3,0,1,0,0,4
AGTGAAGATGGTGTCC-1_V10B01-087_D1,0,1,0,0,0,1
GAGGGCCATAATATTA-1_V10B01-087_D1,1,0,0,0,0,1
ACTCCCGTAGACTAGG-1_V10B01-087_D1,1,1,0,0,0,2
CGTCAAATGGTCGCAG-1_V10B01-087_D1,1,0,0,1,0,2
AAGTCTAGTAGCTGCC-1_V10B01-087_D1,1,2,0,1,0,4
AAGAAATCACCAGATT-1_V10B01-087_D1,3,5,0,0,0,8
GAGTGCACGGACAACA-1_V10B01-087_D1,0,0,0,0,0,0
GTTCAAATCAGATGTC-1_V10B01-087_D1,6,0,0,0,0,6
CATGGCTCCCTATGTC-1_V10B01-087_D1,5,0,1,0,0,6
GGCCACACGAAAGCCT-1_V10B01-087_D1,1,0,0,0,0,1
GAAGCCGGGTAAGCTC-1_V10B01-087_D1,3,0,0,0,0,3
TTGCGCTCTCTCGCTT-1_V10B01-087_D1,1,1,0,0,0,2
TACATGACCTTATCCG-1_V10B01-087_D1,1,1,1,0,0,3
GTCCTTCTACAACCCA-1_V10B01-087_D1,3,1,1,0,0,5
TATATGCTGGGTTGCC-1_V10B01-087_D1,6,0,1,0,0,7
GTTTATGGGATTTAGA-1_V10B01-087_D1,1,0,0,0,0,1
GGAACCCGAACAAGAA-1_V10B01-087_D1,2,0,0,0,0,2
AACGTTATCAGCACCT-1_V10B01-087_D1,0,0,1,0,0,1
CATCGTCCGGTTACTA-1_V10B01-087_D1,1,2,0,0,0,3
AGACAGCTCAGAATCC-1_V10B01-087_D1,2,1,0,0,0,3
GCAGATCCTCGCAAAT-1_V10B01-087_D1,1,2,0,0,0,3
GGGTCATGCGTACCAT-1_V10B01-087_D1,3,1,0,0,0,4
CTGGTCATTCCAATCC-1_V10B01-087_D1,1,0,0,1,0,2
TCAGGGCGCAAACTCG-1_V10B01-087_D1,2,0,0,0,0,2
GATGCCAGCAGAAGGC-1_V10B01-087_D1,1,0,0,0,0,1
GTTATTAACGTGGGAG-1_V10B01-087_D1,5,1,1,0,0,7
AATACAATGTTTCAGG-1_V10B01-087_D1,4,0,1,0,0,5
TTGCTGCACCTATCCA-1_V10B01-087_D1,4,0,0,0,0,4
CCAGAGACAAAGCCGG-1_V10B01-087_D1,1,1,1,1,0,4
CCGAAGTATATTGTTC-1_V10B01-087_D1,1,0,0,0,0,1
GCTAAACCTGAGGTGA-1_V10B01-087_D1,4,0,0,0,0,4
TCATACTTACAGATCC-1_V10B01-087_D1,0,0,0,0,0,0
CGAGCACTTCAAGTTT-1_V10B01-087_D1,1,1,0,0,0,2
TAGCAACCTGTCACAA-1_V10B01-087_D1,0,0,1,0,0,1
TGGGAAATGCCTTTCC-1_V10B01-087_D1,0,2,0,0,0,2
AGACCATGGGATACAA-1_V10B01-087_D1,2,0,0,0,0,2
TAAATGAATCCGTTTC-1_V10B01-087_D1,8,0,0,0,0,8
ACAACGGTCCCTGCGA-1_V10B01-087_D1,1,0,1,0,0,2
GTCACTCTCCAAATCT-1_V10B01-087_D1,3,2,0,0,0,5
TTCTACTTGCGAGGGC-1_V10B01-087_D1,4,0,1,0,0,5
CGCAATTACTTTCGGT-1_V10B01-087_D1,5,0,1,0,0,6
CTGTTCATCTCACGGG-1_V10B01-087_D1,3,0,1,0,0,4
TTCTTGTAACCTAATG-1_V10B01-087_D1,2,0,0,0,0,2
GCTTGATGATAATCAG-1_V10B01-087_D1,1,0,0,0,0,1
TTGGCTCGCATGAGAC-1_V10B01-087_D1,4,0,1,1,0,6
GCCCAGTTGGTATGCC-1_V10B01-087_D1,1,1,0,0,0,2
ATTCCTCCGCCAGTGC-1_V10B01-087_D1,4,1,0,0,0,5
TCGTCCGCTGGCGTCT-1_V10B01-087_D1,2,1,0,0,0,3
GGAGAAGTCATTGGCA-1_V10B01-087_D1,2,2,1,0,0,5
TTGTTAGCAAATTCGA-1_V10B01-087_D1,2,1,0,0,0,3
TCTAGCATCTTCGATG-1_V10B01-087_D1,0,0,1,0,0,1
TTCTAGGCCAATTGTG-1_V10B01-087_D1,0,2,1,0,0,3
TCACGGTCATCGCACA-1_V10B01-087_D1,1,0,1,0,0,2
ATGAAGCCAAGGAGCC-1_V10B01-087_D1,1,1,2,0,0,4
AATGACTGTCAGCCGG-1_V10B01-087_D1,3,1,0,0,0,4
CCAAACAGAACCCTCG-1_V10B01-087_D1,2,0,1,0,0,3
TATCGATGATTAAACG-1_V10B01-087_D1,3,3,0,0,0,6
GAACACACATCAACCA-1_V10B01-087_D1,1,1,0,0,0,2
CCCGTCAGCGTCTGAC-1_V10B01-087_D1,7,0,0,0,0,7
AGCATCGTCGATAATT-1_V10B01-087_D1,3,0,1,0,0,4
GACTAAGATCATGCAC-1_V10B01-087_D1,2,0,2,0,0,4
TAGGGTGTTTCAAGAG-1_V10B01-087_D1,3,0,0,0,0,3
TGGTTCGTAGCAAAGG-1_V10B01-087_D1,0,0,0,0,0,0
CTGTTCACTGCCTGTG-1_V10B01-087_D1,3,1,1,0,0,5
ATGTGCATCCGACGCA-1_V10B01-087_D1,3,1,0,0,0,4
TTGTCGTTCAGTTACC-1_V10B01-087_D1,0,0,1,0,0,1
CGGGATCAATGTAAGA-1_V10B01-087_D1,0,0,1,0,0,1
TTATCTGTATCATAAC-1_V10B01-087_D1,1,1,0,0,0,2
ATCGACTCTTTCCGTT-1_V10B01-087_D1,4,0,2,0,0,6
CTCATTTGATGGGCGG-1_V10B01-087_D1,2,0,1,0,0,3
GTAAGCGGGCAGTCAG-1_V10B01-087_D1,0,1,0,0,0,1
TCTATCGGTCGCAACA-1_V10B01-087_D1,2,0,1,0,0,3
AACGCGGTCTCCAGCC-1_V10B01-087_D1,2,1,0,1,0,4
ATTAATACTACGCGGG-1_V10B01-087_D1,2,1,1,0,0,4
CTTTAACTTTCAAAGG-1_V10B01-087_D1,2,0,1,0,0,3
CGTACCTGATAGGCCT-1_V10B01-087_D1,2,0,0,0,0,2
GAATGTTGGGTAATCT-1_V10B01-087_D1,1,1,5,0,0,7
TGCGGAGTAAAGGTGC-1_V10B01-087_D1,2,1,0,1,0,4
CCTGAATATTTACATA-1_V10B01-087_D1,1,2,1,0,0,4
TTGCTCCCATACCGGA-1_V10B01-087_D1,1,0,1,0,0,2
CCTCTAATCTGCCAAG-1_V10B01-087_D1,3,1,1,0,0,5
AGGTTGAGGCACGCTT-1_V10B01-087_D1,1,1,1,0,0,3
TCCCGTCAGTCCCGCA-1_V10B01-087_D1,6,1,1,0,0,8
TCCGATGACTGAGCTC-1_V10B01-087_D1,1,0,0,0,0,1
CAGCCTCCTGCAGAGG-1_V10B01-087_D1,2,2,0,0,0,4
CTTAGCCTTCCACATG-1_V10B01-087_D1,2,0,0,0,0,2
ATTAATGAACCAGTCG-1_V10B01-087_D1,2,0,1,0,0,3
ACGATACATAGAACTA-1_V10B01-087_D1,1,0,2,0,0,3
AGCCACTCCCGTGCTT-1_V10B01-087_D1,2,0,0,0,0,2
ATACGGGTTTCGATTG-1_V10B01-087_D1,4,0,1,0,0,5
CTGTCAAATGGCTCGG-1_V10B01-087_D1,1,1,2,0,0,4
GCTCGGAATTTAAAGC-1_V10B01-087_D1,5,1,0,0,0,6
TAGGCATGTTACGCCA-1_V10B01-087_D1,0,1,0,0,0,1
TGGCAACTCGCGCGCC-1_V10B01-087_D1,2,0,0,0,0,2
ATCAGTAGGCAGGGAT-1_V10B01-087_D1,4,0,0,0,0,4
TATCGATCTATGCATA-1_V10B01-087_D1,3,1,0,0,0,4
CGACTCAGGATGTTAT-1_V10B01-087_D1,2,1,0,0,0,3
GCCATATTGCACACAG-1_V10B01-087_D1,8,0,1,1,0,10
AATTCATAAGGGATCT-1_V10B01-087_D1,0,0,1,0,0,1
CGGTAGAGGTGCAGGT-1_V10B01-087_D1,0,0,0,0,0,0
AATGATGATACGCTAT-1_V10B01-087_D1,3,1,1,0,0,5
CTTGTGCTCACCGATT-1_V10B01-087_D1,4,1,2,0,0,7
TTCCAATCAGAGCTAG-1_V10B01-087_D1,2,1,0,0,0,3
CGATGGACCCTACGCC-1_V10B01-087_D1,1,0,0,0,0,1
GGTCGGATAAACGGCG-1_V10B01-087_D1,0,1,0,0,0,1
TTAGCTAATACGATCT-1_V10B01-087_D1,0,2,0,0,0,2
CTCGATATTTGCGAGC-1_V10B01-087_D1,2,1,0,0,0,3
ATTACTTACTGGGCAT-1_V10B01-087_D1,1,0,2,0,0,3
CTAGCCGATGTTATGA-1_V10B01-087_D1,0,1,0,0,0,1
TACTGCAATCAATTAC-1_V10B01-087_D1,0,3,1,1,0,5
TAGTCTGTGACGTTGC-1_V10B01-087_D1,2,3,0,0,0,5
CTCGTTTCTAATGTTT-1_V10B01-087_D1,4,1,1,0,0,6
TTCGTTCAACGAAGTT-1_V10B01-087_D1,3,0,0,0,0,3
CTGAATTTATTGCCAG-1_V10B01-087_D1,2,1,0,0,0,3
TGGAATATCCTTGACC-1_V10B01-087_D1,2,1,0,0,0,3
CAGATCATTTAAAGTC-1_V10B01-087_D1,3,1,0,0,0,4
CTCCTTTACGCAAGTC-1_V10B01-087_D1,3,2,0,0,0,5
TCCCAAACAGACAACG-1_V10B01-087_D1,0,1,0,0,0,1
ATCGCTGCGTGCAGCA-1_V10B01-087_D1,0,1,0,0,0,1
TTAGTTCAAGTGTTCG-1_V10B01-087_D1,0,2,0,0,0,2
AAACTCGTGATATAAG-1_V10B01-087_D1,2,2,0,0,0,4
TTAACGAACAAGCAGT-1_V10B01-087_D1,0,2,1,0,0,3
GTTATATCAGGAGCCA-1_V10B01-087_D1,3,0,1,0,0,4
CAAATTGGATTATGCC-1_V10B01-087_D1,3,0,1,2,0,6
CGAGGAGCTTCCATAT-1_V10B01-087_D1,2,2,0,0,0,4
GGAGACCAATGTGCTT-1_V10B01-087_D1,3,1,1,1,0,6
CATTGATGAACACGCC-1_V10B01-087_D1,2,3,0,1,0,6
GTCAATGCTATAATTT-1_V10B01-087_D1,0,3,0,0,0,3
ACCACCCTCTCTTCTA-1_V10B01-087_D1,1,3,0,0,0,4
TGGAGGGAAACACCTC-1_V10B01-087_D1,1,0,0,1,0,2
CACGGACGTGGATGGC-1_V10B01-087_D1,2,0,0,0,0,2
AACTTTCTCGATCATG-1_V10B01-087_D1,0,1,0,0,0,1
CGTATTGTTTCCTAAT-1_V10B01-087_D1,0,0,1,13,0,14
CCTACTGCGGCGGCCA-1_V10B01-087_D1,0,0,0,0,0,0
CGCAATCGATCATTAG-1_V10B01-087_D1,0,1,0,0,0,1
TGGTTATGCTTGCGGT-1_V10B01-087_D1,2,0,0,0,0,2
GGCTTGGCTCTCACCT-1_V10B01-087_D1,2,1,1,0,0,4
ATTGGTAGGATCCGCT-1_V10B01-087_D1,3,0,0,0,0,3
TCAGGGCGACTTCCTT-1_V10B01-087_D1,1,1,1,0,0,3
TCTGCAGATTCGAGTC-1_V10B01-087_D1,2,2,0,0,0,4
CTCTCGCTGTACTATG-1_V10B01-087_D1,0,0,0,1,0,1
AATAGTCGCGAGTCGG-1_V10B01-087_D1,0,1,0,0,0,1
AGTTACCCTTAAGACT-1_V10B01-087_D1,2,0,0,1,0,3
CTTAAATAAGACCCAT-1_V10B01-087_D1,2,1,0,0,0,3
GGTTGTGCTCTTGTCC-1_V10B01-087_D1,1,0,0,0,0,1
GTGAGTCTAAGACGGA-1_V10B01-087_D1,6,0,0,0,0,6
CGCGACACTGCGCAGC-1_V10B01-087_D1,3,1,1,0,0,5
GCTCGCGGTTCCGCTC-1_V10B01-087_D1,4,1,0,0,0,5
TTAACTCACGCGTGGA-1_V10B01-087_D1,1,3,2,0,0,6
GGAACGGCCTGCAGCC-1_V10B01-087_D1,1,1,3,0,0,5
GTAGAAACGGGTGGAG-1_V10B01-087_D1,1,0,0,0,0,1
TAATGAAAGACCCTTG-1_V10B01-087_D1,0,2,0,0,0,2
AGGCTTGCTAGACACC-1_V10B01-087_D1,1,1,0,0,0,2
TTGCGTAGTTTGAGGA-1_V10B01-087_D1,4,0,0,0,0,4
CGCCCTTGAAGGCTGA-1_V10B01-087_D1,0,1,1,0,0,2
CCCGGTGGAAGAACCT-1_V10B01-087_D1,3,0,1,0,0,4
TTAACACCTCGAACAT-1_V10B01-087_D1,4,0,1,0,0,5
GATTCCTATACGGCGC-1_V10B01-087_D1,1,0,1,0,0,2
TTACCCTAACAGTCCT-1_V10B01-087_D1,3,0,0,0,0,3
ACCCACCTACATGCTC-1_V10B01-087_D1,1,2,1,0,0,4
AAAGGGCAGCTTGAAT-1_V10B01-087_D1,2,1,0,0,0,3
CACACAGGGATAGATT-1_V10B01-087_D1,0,1,1,0,0,2
AGAGCGTACAAGCTCG-1_V10B01-087_D1,2,0,1,0,0,3
TCTTACGGCATCCGAC-1_V10B01-087_D1,4,1,0,0,0,5
GCCTATTCCGATATAG-1_V10B01-087_D1,2,1,0,0,0,3
GAAAGTGACTAACTGC-1_V10B01-087_D1,4,1,2,0,0,7
CCGGAATGGTTTCAGT-1_V10B01-087_D1,4,2,2,0,0,8
AGTATAATACTAGGCA-1_V10B01-087_D1,0,1,0,0,0,1
TAACTATCGAAGGTCC-1_V10B01-087_D1,3,2,0,0,0,5
ATGAGGAGTGTTAATC-1_V10B01-087_D1,5,1,0,0,0,6
TGTGTCGCGAGTTGCA-1_V10B01-087_D1,5,1,2,0,0,8
ATCCAACGCAGTCATA-1_V10B01-087_D1,3,2,0,0,0,5
AAGGCGCGTAAAGCTT-1_V10B01-087_D1,3,0,0,0,0,3
AGTCGGCCCAAACGAC-1_V10B01-087_D1,0,1,0,0,0,1
AACGTCAGACTAGTGG-1_V10B01-087_D1,2,0,0,0,0,2
ACTACCAGCTCTCTGG-1_V10B01-087_D1,1,0,0,0,0,1
GCAAGTGCACAGAGAA-1_V10B01-087_D1,0,0,0,0,1,1
ACACCTTAAGTAGGGC-1_V10B01-087_D1,3,1,0,0,0,4
TTCGACGGGAAGGGCG-1_V10B01-087_D1,1,1,0,0,0,2
TTCGCACTCGCGTGCT-1_V10B01-087_D1,3,0,1,0,0,4
TATTTGTTACCCTTTA-1_V10B01-087_D1,6,1,0,0,0,7
CGCTGTGACGCCGCAC-1_V10B01-087_D1,3,2,0,0,0,5
GTTGCACGGAGTTTCG-1_V10B01-087_D1,1,1,2,0,0,4
GTTTCCTGGAGGGTGA-1_V10B01-087_D1,2,0,2,0,0,4
ACACCCAGCATGCAGC-1_V10B01-087_D1,3,0,0,0,0,3
TCAACCATGTTCGGGC-1_V10B01-087_D1,1,1,0,0,0,2
TTACAACTACGCATCC-1_V10B01-087_D1,3,1,1,0,0,5
TCCGATGGTGCGACAT-1_V10B01-087_D1,3,2,0,0,0,5
GGGCGTACATTTATAT-1_V10B01-087_D1,0,2,1,0,0,3
AGCGACCAACGATATT-1_V10B01-087_D1,4,0,1,0,0,5
ACACAAAGACGGGTGG-1_V10B01-087_D1,2,1,0,0,0,3
ATCGCACGCCGGGAGA-1_V10B01-087_D1,2,1,3,0,0,6
GCTCTAAACCCTGACG-1_V10B01-087_D1,2,0,2,0,0,4
AATGCAACCGGGTACC-1_V10B01-087_D1,0,0,0,0,0,0
TCAAACAACCGCGTCG-1_V10B01-087_D1,3,4,0,0,0,7
TATGCTCCCTACTTAC-1_V10B01-087_D1,4,2,0,0,0,6
AAAGGGATGTAGCAAG-1_V10B01-087_D1,1,0,0,0,0,1
ACGATCATACATAGAG-1_V10B01-087_D1,5,0,0,0,0,5
TTGTTCAGTGTGCTAC-1_V10B01-087_D1,4,1,1,0,0,6
ATGCATGATCCAGGAT-1_V10B01-087_D1,2,2,0,0,0,4
AGTCTTCTCCTCAAAT-1_V10B01-087_D1,2,1,0,0,0,3
GATTCCCTTGTCGCAG-1_V10B01-087_D1,1,0,1,0,0,2
CTCGCACCTATATAGT-1_V10B01-087_D1,3,1,1,0,0,5
ACTCAATAAAGGCACG-1_V10B01-087_D1,1,0,0,0,0,1
AACCGAGCTTGGTCAT-1_V10B01-087_D1,2,1,2,0,0,5
TAAGGCAACATAAGAT-1_V10B01-087_D1,1,1,0,0,0,2
CACGCACAGCGCAGCT-1_V10B01-087_D1,1,0,0,0,0,1
GGTTTACAATCTCAAT-1_V10B01-087_D1,6,4,1,0,0,11
TGCAGGATCGGCAAAG-1_V10B01-087_D1,4,1,0,0,0,5
ATAACGGAGTCCAACG-1_V10B01-087_D1,2,0,0,0,0,2
AACGATATGTCAACTG-1_V10B01-087_D1,4,0,1,0,0,5
GACAACGACCATTGAA-1_V10B01-087_D1,4,1,1,0,0,6
TTGACCATGTTCTCCG-1_V10B01-087_D1,3,0,0,0,0,3
AGTACGGGCACCTGGC-1_V10B01-087_D1,5,0,1,0,0,6
CGCCATCCGATTATGA-1_V10B01-087_D1,3,2,0,0,0,5
AAGGTATCCTAATATA-1_V10B01-087_D1,2,1,0,0,0,3
TGTTGTCAAGAAGTCT-1_V10B01-087_D1,0,1,0,0,0,1
CAGTGAATAAATGACT-1_V10B01-087_D1,2,0,0,0,0,2
CACCTTGCGAAACTCG-1_V10B01-087_D1,2,0,0,0,0,2
CATTTAGCGGACCATG-1_V10B01-087_D1,1,1,0,0,0,2
CCAGTCTAGACGGCGC-1_V10B01-087_D1,3,0,0,0,0,3
TCGCTTTAAACGTTTG-1_V10B01-087_D1,2,1,0,0,0,3
GTGAAACGGCGCCACC-1_V10B01-087_D1,3,1,2,0,0,6
GGGCTCATCGAACCCA-1_V10B01-087_D1,1,0,0,0,0,1
TTGATGTGTAGTCCCG-1_V10B01-087_D1,3,4,2,0,0,9
CAGTAGCCCACGCGGT-1_V10B01-087_D1,1,0,0,0,0,1
AGCGCGGGTGCCAATG-1_V10B01-087_D1,3,1,1,0,0,5
TAATCGATCCGTACGT-1_V10B01-087_D1,0,0,0,0,0,0
AGTGGCGGCAATTTGA-1_V10B01-087_D1,2,0,1,0,0,3
CCTTTCAATGAAGAAA-1_V10B01-087_D1,4,0,0,0,0,4
CTCAGTCACGACAAAT-1_V10B01-087_D1,1,1,1,1,0,4
ATAGGCTAGCTTCGCA-1_V10B01-087_D1,0,2,0,0,0,2
CGGTTCAAGTAGGTGT-1_V10B01-087_D1,1,0,0,0,0,1
CAGTCGAGGATGCAAT-1_V10B01-087_D1,2,0,0,0,0,2
TATCACCCAACCGACC-1_V10B01-087_D1,3,1,1,0,0,5
AATGATGCGACTCCTG-1_V10B01-087_D1,0,0,0,0,0,0
TGGAACCACTGACACA-1_V10B01-087_D1,0,0,0,0,0,0
GCCAATAGGGCATCTC-1_V10B01-087_D1,1,0,0,0,0,1
TTCTTTGGTCGCGACG-1_V10B01-087_D1,1,1,0,0,0,2
ATTAGATTCCTCAGCA-1_V10B01-087_D1,1,0,0,0,0,1
CCGTGGAACGATCCAA-1_V10B01-087_D1,4,1,1,0,0,6
GGGTCGTGGCAAGTGT-1_V10B01-087_D1,3,1,0,0,0,4
TCGCTCGGCACCAGCG-1_V10B01-087_D1,1,2,1,0,0,4
ACGCAATCACTACAGC-1_V10B01-087_D1,3,2,0,0,0,5
CTCTAATGCATTGATC-1_V10B01-087_D1,2,2,0,0,0,4
GTCTCGACTAAGTTTG-1_V10B01-087_D1,3,1,0,0,0,4
TGGTTTAAACGTGGGT-1_V10B01-087_D1,1,1,1,0,0,3
CGCAGATCTTCACCCG-1_V10B01-087_D1,2,2,1,2,0,7
TCCAGATGTACGCCAA-1_V10B01-087_D1,4,0,0,0,0,4
CATTGCGGGTCAATTC-1_V10B01-087_D1,3,1,0,0,0,4
GACGTTCGTAAATACA-1_V10B01-087_D1,5,2,0,0,0,7
TACACCGTCGTTAGTC-1_V10B01-087_D1,3,0,1,0,0,4
ACGGGCGTATGCGACA-1_V10B01-087_D1,1,0,0,0,0,1
GAAGGCTACCATTGTT-1_V10B01-087_D1,1,0,0,0,0,1
TAAATCTTTACACCTC-1_V10B01-087_D1,2,1,2,0,0,5
AGTTTATGTAAAGACA-1_V10B01-087_D1,2,0,0,0,0,2
AGGAGACATCCACAGT-1_V10B01-087_D1,3,0,2,1,0,6
CAACCTGAACCTGCCA-1_V10B01-087_D1,0,0,0,0,0,0
AGTCCCTCGCAGAAAG-1_V10B01-087_D1,2,0,0,0,0,2
AAATGTATCTTATCCC-1_V10B01-087_D1,0,2,0,0,0,2
ACTCTAAACCTGGGAT-1_V10B01-087_D1,2,1,0,0,0,3
GCTGGCAGGTGCCGTG-1_V10B01-087_D1,0,0,1,0,0,1
CTCATTCGTGAACATC-1_V10B01-087_D1,2,2,1,0,0,5
TCGCCGGATGGGCAAG-1_V10B01-087_D1,4,1,0,0,0,5
GGACTAAGTCAGGAGT-1_V10B01-087_D1,1,0,0,0,0,1
TATCAAAGGTCTGTAA-1_V10B01-087_D1,2,0,0,0,0,2
TTCAGTTTGTGGCAGC-1_V10B01-087_D1,2,0,0,0,0,2
TGTTCATAAATGTGCT-1_V10B01-087_D1,5,0,0,0,0,5
CTTAGCCCGGATAGTG-1_V10B01-087_D1,1,2,0,0,0,3
GATGCGAATGGTATTA-1_V10B01-087_D1,2,0,0,0,0,2
TCTAACTGTATGTAAA-1_V10B01-087_D1,4,1,1,0,0,6
TTAAACCTGGTTCCTT-1_V10B01-087_D1,0,0,0,0,0,0
GCTAAGTAAAGGCGAT-1_V10B01-087_D1,2,1,1,0,0,4
AGTTACCGCACATGGT-1_V10B01-087_D1,3,0,0,0,0,3
GACTGCGGCACGTGTA-1_V10B01-087_D1,0,0,1,0,0,1
TGGTGATCGTATTTGT-1_V10B01-087_D1,1,3,0,0,0,4
TTATCGCCTGCGAAGC-1_V10B01-087_D1,1,0,0,0,0,1
TGGAATTAGACGCTTT-1_V10B01-087_D1,2,1,0,0,0,3
TCGTCACACTGTTAGC-1_V10B01-087_D1,4,4,1,0,0,9
TTATGTTTGCGATAGA-1_V10B01-087_D1,3,0,0,0,0,3
GGTGCTGATCACAAAG-1_V10B01-087_D1,0,1,1,0,0,2
CATAGCCGCCCGGGAT-1_V10B01-087_D1,0,1,0,0,0,1
GGTTAGTTACGGCGCC-1_V10B01-087_D1,1,0,0,0,0,1
ATTCCCACATAAACAA-1_V10B01-087_D1,5,1,0,1,0,7
ATTCAGTAGCAGGGTC-1_V10B01-087_D1,2,1,0,0,0,3
CAGTTCCGCGGGTCGA-1_V10B01-087_D1,4,1,0,0,0,5
AAGAGATGAATCGGTA-1_V10B01-087_D1,2,2,2,0,0,6
CGCAATTCTACAATAA-1_V10B01-087_D1,1,1,0,0,0,2
TAACGCTTTGAGAGCG-1_V10B01-087_D1,2,1,0,0,0,3
AGGCTATGGTTAGCTT-1_V10B01-087_D1,3,0,0,0,0,3
GAGGAATGGAGAGGTT-1_V10B01-087_D1,3,2,0,0,0,5
TCCTCTACGAGATGGC-1_V10B01-087_D1,1,1,1,0,0,3
TTGATTATGCAGATGA-1_V10B01-087_D1,2,0,1,0,0,3
TCAGTACTGACCCGCG-1_V10B01-087_D1,0,1,0,0,0,1
TTATGACAAACTGGAT-1_V10B01-087_D1,3,3,0,0,0,6
GTAAGTAGGGTATACC-1_V10B01-087_D1,3,1,1,0,0,5
CGCAAACACGAGTTAC-1_V10B01-087_D1,2,0,1,0,0,3
TGGCCGTATATTGACC-1_V10B01-087_D1,5,0,0,0,0,5
ACTGTAGCACTTTGGA-1_V10B01-087_D1,4,1,1,0,0,6
GCTCTATGTTACGTGC-1_V10B01-087_D1,2,1,0,0,0,3
TGCGCGATTAACGGAG-1_V10B01-087_D1,1,0,2,0,0,3
GAATCGACATGGTCAC-1_V10B01-087_D1,4,1,1,0,0,6
GACTAAGTAGGCTCAC-1_V10B01-087_D1,4,1,0,0,0,5
ATCTTGACCTGCAACG-1_V10B01-087_D1,1,1,0,0,0,2
ATGCACTACCGCATTG-1_V10B01-087_D1,1,0,0,0,0,1
CAGATACTAACATAGT-1_V10B01-087_D1,1,1,0,0,0,2
GATCGACACTATCTGA-1_V10B01-087_D1,3,0,0,0,0,3
ATAGAGTACTGGGACA-1_V10B01-087_D1,5,1,1,0,0,7
CCTACTGCTTACACTT-1_V10B01-087_D1,1,0,1,0,0,2
CCTGCTATTTGAGAAG-1_V10B01-087_D1,3,0,1,0,0,4
CGCGTTCATGAAATAC-1_V10B01-087_D1,2,0,0,0,0,2
CATTATGCTTGTTGTG-1_V10B01-087_D1,3,0,0,0,0,3
CCAGGGACGTGGCCTC-1_V10B01-087_D1,2,1,0,0,0,3
TATGGATGTGCTACGC-1_V10B01-087_D1,2,1,1,0,0,4
GTACTAAGATTTGGAG-1_V10B01-087_D1,2,1,0,0,0,3
AGACCCGCCCTCCTCG-1_V10B01-087_D1,3,2,0,0,0,5
CGCATTAGCTAATAGG-1_V10B01-087_D1,3,0,0,0,0,3
GCTCTCGGGTACCGAA-1_V10B01-087_D1,0,1,0,0,0,1
CACCGCCAGAAGGTTT-1_V10B01-087_D1,2,3,0,0,0,5
TCCCAAAGACGAAGGA-1_V10B01-087_D1,1,0,0,0,0,1
ATGGATTGACCAAACG-1_V10B01-087_D1,3,2,1,0,0,6
GTCATGGACATGACTA-1_V10B01-087_D1,6,3,1,0,0,10
CTACTGCCACCTGACC-1_V10B01-087_D1,1,0,0,0,0,1
TTATATTTGGCAATCC-1_V10B01-087_D1,5,2,0,0,0,7
AGCACCAGTACTCACG-1_V10B01-087_D1,3,0,0,0,0,3
CATGGTCTAGATACCG-1_V10B01-087_D1,2,0,1,0,0,3
TCTACCGTCCACAAGC-1_V10B01-087_D1,1,1,0,0,0,2
CTAGTTGGGCCCGGTA-1_V10B01-087_D1,1,1,0,0,0,2
TCCCGCGTACTCCTGG-1_V10B01-087_D1,2,1,0,0,0,3
CAGAGCATGAGCTTGC-1_V10B01-087_D1,2,2,1,0,0,5
ACACGGGAACTTAGGG-1_V10B01-087_D1,1,1,0,0,0,2
GGCTCTGCTCCAACGC-1_V10B01-087_D1,2,0,0,0,0,2
AGAACGTGGTACATTC-1_V10B01-087_D1,5,0,0,1,0,6
CAATAAACCTTGGCCC-1_V10B01-087_D1,2,2,2,0,0,6
ACTTCGCCATACGCAC-1_V10B01-087_D1,3,2,0,0,0,5
ATCTGGTTAAGACTGT-1_V10B01-087_D1,3,0,1,0,0,4
TCGTAAGACGACATTG-1_V10B01-087_D1,4,1,0,0,0,5
GTGTACCTTGGCTACG-1_V10B01-087_D1,1,1,0,0,0,2
GCCCGTAATACCTTCT-1_V10B01-087_D1,6,0,0,0,0,6
CGGTCAAGTGGGAACC-1_V10B01-087_D1,0,1,0,0,0,1
TTGTAAGGCCAGTTGG-1_V10B01-087_D1,1,1,0,0,0,2
GGAGCACCAAGAACTA-1_V10B01-087_D1,1,1,0,0,0,2
TAATAGTGACGACCAG-1_V10B01-087_D1,2,0,0,0,0,2
CTAAATCCTATTCCGG-1_V10B01-087_D1,3,0,0,0,0,3
CGAGTTCTGTCCCACC-1_V10B01-087_D1,1,0,0,0,0,1
AGGCAGATGCGTAAAC-1_V10B01-087_D1,4,1,1,0,0,6
AAGGATGAGGGACCTC-1_V10B01-087_D1,8,0,0,0,0,8
AGAGAACCGTCTAGGA-1_V10B01-087_D1,4,0,0,0,0,4
GAGGGCGCAGCTCTGC-1_V10B01-087_D1,4,1,0,1,0,6
AAGATTGGCGGAACGT-1_V10B01-087_D1,3,0,0,0,0,3
CCAGTAGTCTGATCCA-1_V10B01-087_D1,4,0,0,0,0,4
AAGGGACAGATTCTGT-1_V10B01-087_D1,2,2,0,0,0,4
ATAGAGTTATCAACTT-1_V10B01-087_D1,0,2,0,0,0,2
AAATTACCTATCGATG-1_V10B01-087_D1,0,1,0,0,0,1
GATCCTAAATCGGGAC-1_V10B01-087_D1,3,1,0,0,0,4
TTACAGACCTAAATGA-1_V10B01-087_D1,3,0,0,0,0,3
CCTCACCTTAGCATCG-1_V10B01-087_D1,1,1,0,0,0,2
CATGCGACCAGTTTAA-1_V10B01-087_D1,4,0,1,0,0,5
AACATATCAACTGGTG-1_V10B01-087_D1,2,1,1,0,0,4
CTATAAGAGCCAATCG-1_V10B01-087_D1,0,2,0,0,0,2
AATATCGAGGGTTCTC-1_V10B01-087_D1,2,2,0,0,0,4
GTACTCCTGGGTATGC-1_V10B01-087_D1,5,1,0,1,0,7
ATAAGTAGGATTCAGA-1_V10B01-087_D1,0,2,1,0,0,3
AGGTCGCGGAGTTACT-1_V10B01-087_D1,2,2,0,1,0,5
CTAATTCTCAGATATT-1_V10B01-087_D1,2,0,0,0,0,2
GCCAACCATTTCCGGA-1_V10B01-087_D1,5,3,1,0,0,9
TGATCCCAGCATTAGT-1_V10B01-087_D1,8,0,0,1,0,9
CGTTGTAAGATTGATT-1_V10B01-087_D1,2,0,0,1,0,3
GAAACCATGGTGCGCT-1_V10B01-087_D1,2,3,0,0,0,5
AATCTATGCCGGAGCC-1_V10B01-087_D1,5,1,1,0,0,7
GACTCCCAGAATAAGG-1_V10B01-087_D1,6,2,0,0,0,8
TATGATCCGGCACGCC-1_V10B01-087_D1,1,2,1,1,0,5
CCGCTTGCTGACATGG-1_V10B01-087_D1,7,1,0,0,0,8
TGGTTAAGGGCGCTGG-1_V10B01-087_D1,3,1,1,0,2,7
TTGATAGTCAATACAT-1_V10B01-087_D1,3,0,0,0,0,3
GGTTTAATTGAGCAGG-1_V10B01-087_D1,4,0,0,0,1,5
CATTACATAGATTGTG-1_V10B01-087_D1,1,0,0,0,1,2
GGTACACCAGATTTAT-1_V10B01-087_D1,1,0,0,0,0,1
GGCCCGTATACCATGC-1_V10B01-087_D1,0,0,0,0,0,0
ATCTTTCGTATAACCA-1_V10B01-087_D1,0,0,1,0,0,1
GAGATGACAATCCTTA-1_V10B01-087_D1,0,0,0,0,2,2
AAAGCTTGCCTACATA-1_V10B01-087_D1,1,0,0,1,0,2
CCAATAGATTTCATCT-1_V10B01-087_D1,2,1,0,0,0,3
GGGCACGAATTGGCCG-1_V10B01-087_D1,2,0,1,0,0,3
TCGTTGACAGGGTCCC-1_V10B01-087_D1,4,0,0,0,0,4
ATCGTATTCCGAGAAC-1_V10B01-087_D1,1,0,0,0,0,1
GGGAATTCTGTCCAGT-1_V10B01-087_D1,3,0,0,0,0,3
ACGCGTTTCTTAAGAG-1_V10B01-087_D1,2,0,0,0,0,2
GAGAGCGCAGTCCCTG-1_V10B01-087_D1,2,0,0,0,0,2
GTCCTATTGTTGTGGT-1_V10B01-087_D1,3,0,1,1,0,5
CATCTGCAGGATCATT-1_V10B01-087_D1,1,0,0,0,0,1
GAGTCGACAGACCCTC-1_V10B01-087_D1,2,0,2,0,0,4
AAGTGCAAAGGTAGAC-1_V10B01-087_D1,2,1,0,0,0,3
AGGGTGGATAGTGCAT-1_V10B01-087_D1,2,1,1,0,0,4
TGATAGCGGGATTCTA-1_V10B01-087_D1,2,1,0,0,0,3
GTCAGTTTGGTAGTCG-1_V10B01-087_D1,1,0,0,0,0,1
GCATTCGAAATGAACA-1_V10B01-087_D1,2,1,0,0,0,3
AAAGACTGGGCGCTTT-1_V10B01-087_D1,0,1,2,0,0,3
TAACAATATTTGTTGC-1_V10B01-087_D1,2,1,0,0,0,3
CCAGCTTCCGCCCGCA-1_V10B01-087_D1,0,0,1,0,0,1
GATATGGATTACGCGG-1_V10B01-087_D1,2,2,0,0,0,4
AGAGCAGTTATGAGAC-1_V10B01-087_D1,3,0,1,0,0,4
TCACATCTTATCTGAT-1_V10B01-087_D1,1,1,1,0,0,3
TATGAAGACAGGTGCG-1_V10B01-087_D1,5,2,1,0,0,8
TACCTGCTGCACTGTG-1_V10B01-087_D1,2,0,0,0,3,5
TAGGTCCAAGTAAGGA-1_V10B01-087_D1,3,1,3,1,0,8
GAAACTCGTGCGATGC-1_V10B01-087_D1,0,0,0,0,0,0
AACAATTACTCTACGC-1_V10B01-087_D1,0,0,0,1,0,1
CCGCACGTGACCTCGG-1_V10B01-087_D1,3,1,0,0,0,4
AACTTGCCCGTATGCA-1_V10B01-087_D1,2,0,0,0,0,2
GGGTATGTATGCACTT-1_V10B01-087_D1,4,1,0,0,0,5
TTCGTACTCCAGAACG-1_V10B01-087_D1,4,0,0,0,0,4
GAATTTCTCGCTGCAG-1_V10B01-087_D1,1,1,0,0,0,2
AACAGGATGGGCCGCG-1_V10B01-087_D1,2,0,0,0,0,2
GACGTGTAGGGATTAT-1_V10B01-087_D1,3,1,0,0,0,4
TAGGTGAGCCCTACTC-1_V10B01-087_D1,3,0,1,0,0,4
CTAATTCGCACGCGCT-1_V10B01-087_D1,1,2,3,0,0,6
GAAGCTTGCTGACCGC-1_V10B01-087_D1,4,1,0,0,0,5
GGTTAGGCTTGGAGAA-1_V10B01-087_D1,2,2,1,0,0,5
ACAAGGACAAGAGGTT-1_V10B01-087_D1,1,2,0,0,0,3
AGGCCACCCGTTATGA-1_V10B01-087_D1,2,0,1,2,0,5
GTGGGCTTAGACACAC-1_V10B01-087_D1,1,2,0,0,0,3
CGTGTCCCATTCGCGA-1_V10B01-087_D1,6,0,0,0,0,6
TGGAGTGATGCGATGA-1_V10B01-087_D1,2,0,1,0,0,3
AACAACTGGTAGTTGC-1_V10B01-087_D1,1,0,0,0,0,1
CCTGGCTAGACCCGCC-1_V10B01-087_D1,2,1,1,0,0,4
CGCAATTAGGGTAATA-1_V10B01-087_D1,0,1,1,0,1,3
TCGAAATTTAGGACCA-1_V10B01-087_D1,1,0,0,0,0,1
AGACTAGCCTTCCAGA-1_V10B01-087_D1,5,0,0,0,0,5
TTGATCTAACTTTGTC-1_V10B01-087_D1,0,1,0,0,0,1
AAGGAGCGGTTGGTGC-1_V10B01-087_D1,1,2,0,0,0,3
ACTTGGGACCCGGTGG-1_V10B01-087_D1,1,0,0,0,0,1
TGATCTCCGGCGCCAG-1_V10B01-087_D1,2,0,0,0,0,2
CAGTTCAAATTGACAC-1_V10B01-087_D1,3,2,0,0,0,5
GTCCGGCTGAATTGCG-1_V10B01-087_D1,1,0,0,0,0,1
CTGGAAATGGATGCTT-1_V10B01-087_D1,0,0,2,0,0,2
TGATCGGTTTGACCCT-1_V10B01-087_D1,0,1,0,0,0,1
TAGAGTCTAAGCGAAC-1_V10B01-087_D1,0,0,1,0,0,1
GAGACTGATGGGTAGA-1_V10B01-087_D1,1,2,1,0,0,4
TAGCTAAGTCCGGGAG-1_V10B01-087_D1,2,2,0,0,0,4
GGGCGATATGTGTGAA-1_V10B01-087_D1,1,2,0,0,0,3
CTCGAGGTCGAACAGT-1_V10B01-087_D1,3,0,0,0,0,3
GATCCCTTTATACTGC-1_V10B01-087_D1,1,2,0,0,0,3
GTCATGCACCTCCGTT-1_V10B01-087_D1,2,1,1,0,0,4
ACTTTCCTATAGCTTC-1_V10B01-087_D1,5,1,0,0,0,6
TCGCTCGATATATTCC-1_V10B01-087_D1,2,2,0,0,0,4
ATAGGTTGGGCAGATG-1_V10B01-087_D1,3,2,0,0,0,5
CAATTAAGGGTGATGA-1_V10B01-087_D1,1,1,0,0,0,2
ACCGACTGAGTCCCAC-1_V10B01-087_D1,2,1,0,0,0,3
CCTGTCACCCGGGCTC-1_V10B01-087_D1,0,3,0,0,0,3
GATCGGTGGCCATAAC-1_V10B01-087_D1,3,2,0,0,0,5
CCTATGGGTTACCGTC-1_V10B01-087_D1,1,1,0,0,0,2
TTGGGACACTGCCCGC-1_V10B01-087_D1,2,2,0,1,0,5
CGAGGCTAAATATGGC-1_V10B01-087_D1,0,0,0,0,0,0
TCAGGGTGTAACGTAA-1_V10B01-087_D1,1,2,0,1,0,4
CGAGAGATGTGAACCT-1_V10B01-087_D1,3,0,0,0,0,3
TCGCTGGGCGGATTGT-1_V10B01-087_D1,3,1,2,0,0,6
AGATCTCAGGTGTGAT-1_V10B01-087_D1,2,0,0,0,0,2
TGGCCAAACTGAAGTA-1_V10B01-087_D1,1,0,2,0,0,3
GCTTCCGTCCCTAGAC-1_V10B01-087_D1,5,0,1,0,0,6
CAGCAGCCCGTTCCTT-1_V10B01-087_D1,1,1,1,0,0,3
TGTATAACAGATCCTG-1_V10B01-087_D1,2,0,0,0,0,2
CGCGGGAATTAGGCAG-1_V10B01-087_D1,0,1,1,0,0,2
TGCATGTGGTAATCTA-1_V10B01-087_D1,1,0,1,0,0,2
ACAATTTGAGCAGTGG-1_V10B01-087_D1,2,1,0,0,0,3
GAGCTAAGGGCATATC-1_V10B01-087_D1,2,1,1,0,0,4
CCAGATAGTTGAGTGA-1_V10B01-087_D1,1,0,1,0,0,2
CCACAATGTACGTCTT-1_V10B01-087_D1,2,2,0,0,0,4
CAATGGATCTCTACCA-1_V10B01-087_D1,4,3,0,0,0,7
TGTGGCAAAGCGTATG-1_V10B01-087_D1,4,2,0,0,0,6
TAAAGCGTTAGGAGAA-1_V10B01-087_D1,4,1,0,0,0,5
TCCGTTTAGCCTTGAA-1_V10B01-087_D1,2,2,0,0,0,4
CAGCTCGACAAGTTAA-1_V10B01-087_D1,1,0,0,0,0,1
GCCTATAGTGTCAGGG-1_V10B01-087_D1,3,1,0,0,0,4
ATAGACAACGGGACCT-1_V10B01-087_D1,1,2,1,0,0,4
CTACTATCTTTCAGAG-1_V10B01-087_D1,2,3,0,0,0,5
GCGCTGCTTTGCATTT-1_V10B01-087_D1,1,1,0,0,0,2
GCGCATCCAGTCAGCA-1_V10B01-087_D1,6,3,1,0,0,10
GACTCGCGGGAATGAC-1_V10B01-087_D1,2,1,0,0,0,3
CTGGTAACGAGCTCTT-1_V10B01-087_D1,1,1,0,0,1,3
TCCGGCCTAGCGTACA-1_V10B01-087_D1,2,0,0,0,0,2
TCTAGGTGGCGACGCT-1_V10B01-087_D1,9,0,0,0,0,9
ACGCTAGTGATACACT-1_V10B01-087_D1,3,1,0,0,0,4
ATCTGCACCTCTGCGA-1_V10B01-087_D1,3,2,0,0,0,5
CCTCACCTGAGGGAGC-1_V10B01-087_D1,2,2,0,0,0,4
AGTGAGCCTCGCCGCC-1_V10B01-087_D1,4,0,0,0,0,4
ACGAGTACGGATGCCC-1_V10B01-087_D1,3,0,0,0,0,3
GGTACCATTAAGACGG-1_V10B01-087_D1,3,0,0,0,0,3
TTCTGCTAGACTCCAA-1_V10B01-087_D1,1,0,0,0,0,1
TAACTATTACGCCAAA-1_V10B01-087_D1,2,0,0,0,0,2
GCATTCAAGGCAACGC-1_V10B01-087_D1,4,4,0,0,0,8
AGTACATCATTTATCA-1_V10B01-087_D1,3,0,0,0,0,3
GTCGTGTCTGGTCATC-1_V10B01-087_D1,1,1,0,0,0,2
AGTCTAAAGTATACTC-1_V10B01-087_D1,1,0,0,0,1,2
CGGCCCAACCTGTAGT-1_V10B01-087_D1,2,0,0,1,0,3
AGGGAGACATACTTCG-1_V10B01-087_D1,0,0,0,0,2,2
TCCCTAGATCAATAGG-1_V10B01-087_D1,1,0,1,0,2,4
TCCCGTCGCGTCATAG-1_V10B01-087_D1,1,0,1,0,3,5
CGCATCCATCAGCCAG-1_V10B01-087_D1,2,0,0,0,4,6
CTGCACCTAGTCCACA-1_V10B01-087_D1,1,0,0,0,1,2
CGAGGATCGGGAACGA-1_V10B01-087_D1,0,0,0,0,5,5
TCTGACGGGCTAACCC-1_V10B01-087_D1,1,0,0,0,0,1
GTCTTCCTCACCTAAG-1_V10B01-087_D1,1,2,0,0,0,3
GGTGATGAAGGAAGTG-1_V10B01-087_D1,2,0,0,0,0,2
TCAATACAATTGCTGC-1_V10B01-087_D1,7,0,0,0,0,7
GCAACCCAAGTTGTTT-1_V10B01-087_D1,2,1,0,0,0,3
ATGAAGTGGACCCAGC-1_V10B01-087_D1,1,1,0,0,0,2
GAGAATCTCACGATCA-1_V10B01-087_D1,1,0,0,0,0,1
TATATCATTGATCAGT-1_V10B01-087_D1,1,2,0,0,0,3
AACTTTACGGGAGCTT-1_V10B01-087_D1,1,0,0,0,0,1
TTCTTGTGTCCATCAG-1_V10B01-087_D1,3,1,1,0,0,5
ACAATTTAGGAGGCTC-1_V10B01-087_D1,4,0,0,0,0,4
ATACTTGTTCTCGAGC-1_V10B01-087_D1,1,2,1,0,0,4
CACGGGATTGAGGGTT-1_V10B01-087_D1,1,1,0,0,0,2
GTTAATGTCTATCTTA-1_V10B01-087_D1,0,1,0,0,0,1
GCGTTATATTTGGAAC-1_V10B01-087_D1,3,1,0,0,0,4
CGTCAAGGCTATAAAT-1_V10B01-087_D1,3,2,0,0,0,5
TTAGCTCTGTAATCCG-1_V10B01-087_D1,3,2,2,0,0,7
AATGGTCCACCGTTCA-1_V10B01-087_D1,1,1,0,0,0,2
GTCATTGCATTGACCC-1_V10B01-087_D1,2,0,0,0,0,2
TGTCCGTGGCGCCTTT-1_V10B01-087_D1,1,1,2,0,0,4
TCAACTAACGTATAAC-1_V10B01-087_D1,0,0,0,0,0,0
TCCTCTCCAGTTGTCC-1_V10B01-087_D1,2,1,0,0,0,3
TGTGTTCGTATCCAAG-1_V10B01-087_D1,2,0,0,0,0,2
CCGCGTAGGTAAGGGC-1_V10B01-087_D1,0,1,1,0,0,2
CTGCGGGTGAAATGTT-1_V10B01-087_D1,2,0,0,0,0,2
TATCTACAGAGGTAAT-1_V10B01-087_D1,2,1,1,0,0,4
CTACTCTAGGCCCGGC-1_V10B01-087_D1,1,2,0,0,0,3
ACAAGCAGTGCCTAGC-1_V10B01-087_D1,3,1,0,0,0,4
TACAAGTCTCGTGCAT-1_V10B01-087_D1,2,1,0,0,0,3
TCGGAATGCGCTCTGA-1_V10B01-087_D1,5,1,0,0,1,7
TCGCGTCCAGAAGGTC-1_V10B01-087_D1,4,0,0,0,0,4
TATGGCCCGGCCTCGC-1_V10B01-087_D1,4,0,0,0,0,4
GCTGGCATATTCACCT-1_V10B01-087_D1,2,2,0,0,0,4
GTCAGAATAGTCTATG-1_V10B01-087_D1,2,1,0,0,0,3
GGCGTCCTATCCGCTG-1_V10B01-087_D1,4,0,0,0,0,4
CGGAGTTTGAGAGACA-1_V10B01-087_D1,2,2,0,0,0,4
AGCACTTAAGGACGCC-1_V10B01-087_D1,4,1,0,0,0,5
TCCACAATGGTTTACG-1_V10B01-087_D1,3,2,1,0,0,6
CCAACGATGCACTGAT-1_V10B01-087_D1,2,0,0,0,0,2
ATTTACAGTTTACTGG-1_V10B01-087_D1,3,0,0,0,0,3
CCCTGAAATGAGTTGA-1_V10B01-087_D1,0,2,0,0,0,2
CAAACGGTCGCACTTT-1_V10B01-087_D1,3,0,1,0,0,4
TGATTCGTCTATCACT-1_V10B01-087_D1,2,1,0,0,0,3
TCAGGTTCTTTGAGAA-1_V10B01-087_D1,2,1,0,0,0,3
CACGCAGCGAGGCTTT-1_V10B01-087_D1,0,0,0,0,0,0
TTAAGCGCCTGACCCA-1_V10B01-087_D1,1,1,0,0,0,2
CTTACACGGTATTCCA-1_V10B01-087_D1,2,0,0,0,0,2
AAGGCTGTGCTCATCG-1_V10B01-087_D1,3,2,0,0,0,5
GACCAGAGCCCTGTAG-1_V10B01-087_D1,6,0,2,0,0,8
TCCCAGGCTTAGCTAA-1_V10B01-087_D1,3,2,1,0,0,6
ATTGAAGATCTTAGTG-1_V10B01-087_D1,1,1,0,0,0,2
AGTTCCTACAGAATTA-1_V10B01-087_D1,1,0,0,0,0,1
GGGCTGGTTAGTCGCG-1_V10B01-087_D1,1,1,0,0,0,2
GAAATGGCGGTGTTAG-1_V10B01-087_D1,6,0,0,0,0,6
TACGAACACGACTTCA-1_V10B01-087_D1,2,1,1,0,0,4
ACCACAAGTTTCTATC-1_V10B01-087_D1,1,1,1,1,0,4
ATATTTAACCCTCAAG-1_V10B01-087_D1,3,0,1,0,0,4
GATCATTCCAAACATT-1_V10B01-087_D1,0,0,2,0,0,2
TCCAGGCGAGTACGGT-1_V10B01-087_D1,5,0,1,0,0,6
GTTTGACCAAATCCTA-1_V10B01-087_D1,1,0,1,0,0,2
CACAGCACCCACGGCA-1_V10B01-087_D1,3,0,0,0,0,3
TGCAAGAATGACGTAA-1_V10B01-087_D1,1,3,0,1,0,5
GCGAAGCCATACCCGT-1_V10B01-087_D1,3,0,0,0,0,3
TCCTTTCTTACGCTTA-1_V10B01-087_D1,2,3,1,0,0,6
GCTGCTCTCCGGACAC-1_V10B01-087_D1,0,1,1,0,0,2
ACTGTCTTCTTTAGAA-1_V10B01-087_D1,3,0,1,0,0,4
TCAAACTTAGATTGTT-1_V10B01-087_D1,0,1,0,0,0,1
CTATGTCACTAGCCCA-1_V10B01-087_D1,1,0,0,0,0,1
TGCGCAAAGCATTTGG-1_V10B01-087_D1,6,2,2,1,0,11
TTAATGTAGACCAGGT-1_V10B01-087_D1,2,1,1,0,0,4
GGCGGTAGGATCATTG-1_V10B01-087_D1,6,2,1,0,0,9
GGCAATAGTCAATGAG-1_V10B01-087_D1,4,1,0,0,0,5
ACACGAGACTCCTTCT-1_V10B01-087_D1,0,0,1,0,0,1
GACACAAGGGAAGAAA-1_V10B01-087_D1,0,1,0,0,0,1
TCAGCAAATGCATCTC-1_V10B01-087_D1,2,3,0,0,0,5
GAGATCTGTCACTCCG-1_V10B01-087_D1,1,1,0,0,0,2
ATGCCGGTCTTGCATA-1_V10B01-087_D1,3,1,0,0,0,4
TTGGGCGGCGGTTGCC-1_V10B01-087_D1,0,1,2,0,0,3
TTGTTGTGTGTCAAGA-1_V10B01-087_D1,2,0,0,0,0,2
ACTGTACGATACACAT-1_V10B01-087_D1,3,1,0,0,0,4
TCCACTTTATCTAGGT-1_V10B01-087_D1,2,1,0,0,0,3
GGTCTGAGAATCTGGA-1_V10B01-087_D1,2,0,1,0,0,3
TAGAAAGGTGGCGCTA-1_V10B01-087_D1,4,0,0,0,0,4
TATGTCTCATTGTGCC-1_V10B01-087_D1,5,0,1,0,0,6
GGATTTCACTTCTATA-1_V10B01-087_D1,3,2,1,0,0,6
TGAGTGGTCCGTGACG-1_V10B01-087_D1,1,0,1,0,0,2
CGCTTTCTTGCATTCG-1_V10B01-087_D1,4,0,0,0,0,4
ACCCAACGCCCGTGGC-1_V10B01-087_D1,2,0,0,0,0,2
GAACGTCTCATGGTCG-1_V10B01-087_D1,3,3,0,0,0,6
AGGGTTCCCTTTGGTT-1_V10B01-087_D1,2,0,0,0,0,2
GTAGCTTCCTCTTGTT-1_V10B01-087_D1,2,3,0,1,0,6
GCATGAGGGACGCGGC-1_V10B01-087_D1,3,0,0,0,0,3
CTACCCTAAGGTCATA-1_V10B01-087_D1,1,0,0,0,0,1
TCACCGCTCGGCACTC-1_V10B01-087_D1,3,0,0,0,0,3
GGCTCGCGTTGAGGTA-1_V10B01-087_D1,2,1,0,0,0,3
CTAACGAAACTTGCTG-1_V10B01-087_D1,3,3,0,0,0,6
TTAAACTCGAATTCAT-1_V10B01-087_D1,1,0,0,1,0,2
TACTTTACTGAGCCGG-1_V10B01-087_D1,4,1,0,0,0,5
GCTTGGATCGATTAGG-1_V10B01-087_D1,3,1,1,0,0,5
CGGTTATCCAACAGTG-1_V10B01-087_D1,3,0,0,0,0,3
CAGACCTGTAAGTGTT-1_V10B01-087_D1,2,0,0,0,0,2
GACGGTCAATAGAAGC-1_V10B01-087_D1,3,2,0,0,0,5
CTGACTGCGCAGCTCG-1_V10B01-087_D1,3,0,0,0,0,3
CCATACCTTTACTTGT-1_V10B01-087_D1,3,0,0,0,0,3
GTAATAAAGGGCTCCC-1_V10B01-087_D1,3,0,0,0,0,3
GTGAACTCCCATTCGA-1_V10B01-087_D1,4,0,0,0,0,4
GTGGTTACTTCTTTCG-1_V10B01-087_D1,2,0,0,0,1,3
TCAGAACCTCCACAGG-1_V10B01-087_D1,1,0,2,0,0,3
TCCCACTCTCTTCCGG-1_V10B01-087_D1,3,0,0,0,0,3
ATCTTGACTTGTCCAA-1_V10B01-087_D1,2,0,0,0,4,6
TCGGGAACGTGCCTAG-1_V10B01-087_D1,2,0,0,0,0,2
GTTAGCCGTAAATCAA-1_V10B01-087_D1,1,0,1,0,8,10
ATTTACTAAGTCCATT-1_V10B01-087_D1,4,0,0,0,1,5
GGGTGCATATGAAAGC-1_V10B01-087_D1,1,0,0,0,2,3
TCCGAATGGTCCTGAG-1_V10B01-087_D1,1,0,0,0,1,2
TGATGGCTGTTTCTGA-1_V10B01-087_D1,1,0,0,0,2,3
AAATAAGGTAGTGCCC-1_V10B01-087_D1,0,0,0,0,4,4
CCACTATCCGGGTCAC-1_V10B01-087_D1,1,0,0,0,6,7
CCATACTCGCCTCTCC-1_V10B01-087_D1,1,2,0,0,0,3
ACGATACCTATCCTGA-1_V10B01-087_D1,2,2,0,0,0,4
CTCACCAGTACAAGTG-1_V10B01-087_D1,1,1,1,0,0,3
CGAAGACGGTGAGTGC-1_V10B01-087_D1,2,1,0,0,0,3
AAATTAATAAGCGCGA-1_V10B01-087_D1,1,0,2,0,0,3
GGGCCCTTATCTATAC-1_V10B01-087_D1,3,1,0,0,0,4
CTGCCCACGAAGCGTT-1_V10B01-087_D1,1,1,1,0,0,3
GGACAAGTTGCAGTGA-1_V10B01-087_D1,5,2,1,0,0,8
GTCCGAGAGCAATCAT-1_V10B01-087_D1,2,0,1,0,0,3
ATGGCAGCCGAGAAAC-1_V10B01-087_D1,3,0,0,0,0,3
CCTCGGATGCTACCTG-1_V10B01-087_D1,2,1,0,0,0,3
ATACGGTGAAGATGCA-1_V10B01-087_D1,1,1,0,0,0,2
ACATCAGCTGGGACGC-1_V10B01-087_D1,3,1,0,0,0,4
GGTTGTGTAGCCTGGC-1_V10B01-087_D1,4,0,0,0,0,4
CCTGCGTTCTACGCTT-1_V10B01-087_D1,2,1,0,0,0,3
GAACGTTAGGAAGACG-1_V10B01-087_D1,3,0,0,0,0,3
CTGATAGTGTATCTCA-1_V10B01-087_D1,3,1,0,0,0,4
TTCTGCGAGCGCCCTT-1_V10B01-087_D1,3,0,0,0,0,3
CTTTGGCGCTTTATAC-1_V10B01-087_D1,2,1,1,0,0,4
TCCGAACTTGGCTTAC-1_V10B01-087_D1,3,1,2,0,0,6
TAGATTCCTGGTTATT-1_V10B01-087_D1,3,0,0,0,0,3
CCGACAAAGGGAGTGC-1_V10B01-087_D1,2,0,1,0,0,3
CCATGGCCCTTGTACC-1_V10B01-087_D1,1,2,0,1,0,4
GAAATATCACCATCAG-1_V10B01-087_D1,4,0,0,0,0,4
ACGAAATGGGCGGCAC-1_V10B01-087_D1,4,1,0,0,0,5
GTGAGCGTGCTGCACT-1_V10B01-087_D1,2,1,0,0,0,3
CCGCGGGTACGAAGAA-1_V10B01-087_D1,4,1,1,0,0,6
TCCCTGGCTCGCTGGA-1_V10B01-087_D1,6,2,0,0,0,8
CAGCTTAGTAGGTAGC-1_V10B01-087_D1,2,1,1,0,0,4
CACGAAAGTTAGTCCC-1_V10B01-087_D1,0,1,0,0,0,1
ACCTAATCGACTTCCT-1_V10B01-087_D1,1,0,1,0,0,2
AAGTAGTGACGCGAGG-1_V10B01-087_D1,3,2,0,0,0,5
TCCGATTACATTGCCG-1_V10B01-087_D1,1,3,0,0,0,4
CCTCCGACAATTCAAG-1_V10B01-087_D1,4,0,0,0,0,4
GTTCACAGGAGTCTAG-1_V10B01-087_D1,0,0,0,0,0,0
CGAAGTTGCTCTGTGT-1_V10B01-087_D1,1,0,1,0,0,2
GTCGGATATCTCAGAC-1_V10B01-087_D1,0,0,0,0,0,0
CGCTCTCCGTAGATTA-1_V10B01-087_D1,3,0,0,0,0,3
CAAGCAACGTCGGAGT-1_V10B01-087_D1,3,2,1,0,0,6
CCATTCCCTGCCCACA-1_V10B01-087_D1,1,0,0,0,0,1
CTTTGGCTTTAGTAAA-1_V10B01-087_D1,0,2,0,0,0,2
GGCTATTAAGTTGTAT-1_V10B01-087_D1,2,2,0,0,0,4
CCATTAGCGATAATCC-1_V10B01-087_D1,2,1,0,0,0,3
TGTTCTTCCATTGACT-1_V10B01-087_D1,4,2,0,0,0,6
AGATAACTTCAGGGCC-1_V10B01-087_D1,2,2,0,0,0,4
ATAGACGAAGAGAAAG-1_V10B01-087_D1,1,1,1,0,0,3
GGCGGAGTAATATTAG-1_V10B01-087_D1,1,1,1,0,0,3
TGACCCACGTTAGACA-1_V10B01-087_D1,0,1,1,0,0,2
TCACAGGTTATTGGGC-1_V10B01-087_D1,3,1,0,0,0,4
TCACGCATTGTAGATC-1_V10B01-087_D1,5,0,2,0,0,7
TTGAAGAATTCCCAGG-1_V10B01-087_D1,3,2,2,1,0,8
AAATGGTCAATGTGCC-1_V10B01-087_D1,0,2,1,0,0,3
TAGTGCCCTCCAGAGT-1_V10B01-087_D1,3,0,0,0,0,3
GGTATTGCCGAGTTTA-1_V10B01-087_D1,0,0,0,0,0,0
CGTATTAAGAGATCTA-1_V10B01-087_D1,2,0,1,0,0,3
ACTGTCCAGGATTATA-1_V10B01-087_D1,3,3,1,0,0,7
CGGGCAGCTAAACCGC-1_V10B01-087_D1,0,0,0,0,0,0
TTGCTGATCATGTTCG-1_V10B01-087_D1,4,1,1,0,0,6
TATGGGTACGTATCGT-1_V10B01-087_D1,6,1,0,0,0,7
CAGCTCACTGAGACAT-1_V10B01-087_D1,3,1,1,1,1,7
GGGACTGCATAGATAG-1_V10B01-087_D1,3,1,0,0,0,4
ACGCATTCGTGAGTAC-1_V10B01-087_D1,4,1,0,0,1,6
CTCTGGACGCCTGGTG-1_V10B01-087_D1,2,5,0,0,0,7
AGGGTTTAGTTCGGGA-1_V10B01-087_D1,4,2,0,0,0,6
GGGAGAACTCACAGTA-1_V10B01-087_D1,6,1,0,0,0,7
ATCAATCTGGGCTGCA-1_V10B01-087_D1,4,0,0,0,0,4
TCTTCGATACCAATAA-1_V10B01-087_D1,1,3,0,0,0,4
ACGTAGATTGCTGATG-1_V10B01-087_D1,1,2,1,0,0,4
TCTTGATGCGTAGCGA-1_V10B01-087_D1,1,0,0,0,0,1
GGGCTGCCTAGGGCGA-1_V10B01-087_D1,3,2,0,0,0,5
CTCTCACAATCGATGA-1_V10B01-087_D1,0,1,0,1,0,2
CCAAGCGTAACTCGTA-1_V10B01-087_D1,3,0,0,0,0,3
ACAACAGCATGAGCTA-1_V10B01-087_D1,2,0,0,0,0,2
GTCCCAACGTAAAGTA-1_V10B01-087_D1,3,1,1,0,0,5
TCGGAGTACATGAGTA-1_V10B01-087_D1,2,1,0,0,0,3
GGGAGTTAATGAGGCG-1_V10B01-087_D1,2,1,0,0,0,3
CCGGGCGGTCTCGTCA-1_V10B01-087_D1,3,2,1,0,0,6
CCGTAAGTTGGTCCCA-1_V10B01-087_D1,2,0,2,1,0,5
GGAGGGCTTGGTTGGC-1_V10B01-087_D1,2,2,0,0,1,5
TCGGACGCCCAGCCCA-1_V10B01-087_D1,5,3,0,0,0,8
TCTGTGCCATCATAGT-1_V10B01-087_D1,3,1,1,1,0,6
GTACTGGAGTTAGACC-1_V10B01-087_D1,2,2,0,0,0,4
GGAATGCGCTAGCGTG-1_V10B01-087_D1,2,2,1,0,0,5
GTGTGAATAACTTAGG-1_V10B01-087_D1,6,0,0,0,0,6
GGTCGGCCAGGAGCTT-1_V10B01-087_D1,2,1,0,0,0,3
TAGCCGGCGGTCAGCG-1_V10B01-087_D1,0,1,1,0,0,2
CGGGTGTACCCATTTA-1_V10B01-087_D1,1,2,0,0,0,3
AGTGATTCAAGCAGGA-1_V10B01-087_D1,4,1,0,0,0,5
GTTGGATTGAGAACAC-1_V10B01-087_D1,2,2,0,0,0,4
CACACGCGCTGTCTTA-1_V10B01-087_D1,6,1,0,0,0,7
TAGACGCCCGTACCGG-1_V10B01-087_D1,5,0,0,0,0,5
GGTTTCAATCGGTCAG-1_V10B01-087_D1,1,0,0,0,0,1
AATCTGCGTTGGGACG-1_V10B01-087_D1,8,1,1,0,0,10
TTACGGATGGTTCGAG-1_V10B01-087_D1,4,0,0,0,0,4
CGGCAGGGTCGGGTTG-1_V10B01-087_D1,2,2,2,0,0,6
GCTTTCAGAGGAGGTG-1_V10B01-087_D1,1,0,0,0,0,1
TCTTCCCATGGGCACA-1_V10B01-087_D1,6,0,0,0,0,6
TACCGCGGACTTGCAG-1_V10B01-087_D1,3,0,0,0,0,3
AGAATTATGGATTCGA-1_V10B01-087_D1,5,0,1,0,0,6
ATTGATGAGTCCTAAC-1_V10B01-087_D1,2,0,0,0,1,3
TAGGTCGCCGGAACTG-1_V10B01-087_D1,0,0,0,0,0,0
TAACCTACCGTCCGAG-1_V10B01-087_D1,2,0,0,0,0,2
CTTAGTAGGCCTACAG-1_V10B01-087_D1,2,0,0,0,0,2
CTAGATGTGAGTGTAA-1_V10B01-087_D1,0,0,0,0,0,0
ACTCCCGAATTCGTTT-1_V10B01-087_D1,2,0,1,0,1,4
GTTCATCGTTTGGCTG-1_V10B01-087_D1,2,0,0,0,2,4
ACTTTACCCTCATGAA-1_V10B01-087_D1,2,0,0,0,0,2
GCGAGAGTTGCGTCCA-1_V10B01-087_D1,0,0,0,0,0,0
GTTCGGGCGTACCATT-1_V10B01-087_D1,1,0,0,0,0,1
CGACTTTGTATAGCCT-1_V10B01-087_D1,0,0,0,0,4,4
GCCATCGATGCTGCAT-1_V10B01-087_D1,0,0,0,0,1,1
GCATTTCCAAGGCTCC-1_V10B01-087_D1,11,0,0,0,0,11
ATGTAAGGCTGCTCTT-1_V10B01-087_D1,5,0,0,0,1,6
GTGACGAGGGTGACCC-1_V10B01-087_D1,1,0,0,0,0,1
GGTATGAAAGAACTGA-1_V10B01-087_D1,4,1,0,0,0,5
GTGGCCTAATATCATT-1_V10B01-087_D1,1,2,0,0,0,3
CCTGTGAAACCGTAAC-1_V10B01-087_D1,0,0,0,0,0,0
GGCAGAGAGATCGGGA-1_V10B01-087_D1,1,2,0,0,0,3
TAGCGTCGAATATTGA-1_V10B01-087_D1,3,2,0,0,0,5
CGCCGACTATTCGCTA-1_V10B01-087_D1,3,2,0,0,0,5
TCTGGCGCAAGCCGGG-1_V10B01-087_D1,0,1,1,0,0,2
AGTGGTTGCGTATAGG-1_V10B01-087_D1,1,2,0,0,0,3
ATCGGTTACCTAGTAA-1_V10B01-087_D1,3,0,0,0,0,3
CCTGCCCGTTGTCTAG-1_V10B01-087_D1,2,1,0,0,0,3
GCACACGCCCATGGTC-1_V10B01-087_D1,4,1,1,0,0,6
AGTACGGCCCGTATCG-1_V10B01-087_D1,1,1,0,0,0,2
TATCTAGCCTAAAGGA-1_V10B01-087_D1,2,1,0,0,0,3
CACTCGGTTAGGAGGA-1_V10B01-087_D1,2,1,0,0,0,3
ATGTTCGTCGACCCAC-1_V10B01-087_D1,4,1,0,0,0,5
TTCCTCTGCCCGAATA-1_V10B01-087_D1,5,0,0,0,0,5
TTACTATCGGCTTCTC-1_V10B01-087_D1,2,0,0,0,0,2
GCCGCATTAGTCCGGC-1_V10B01-087_D1,5,1,0,0,0,6
TAAGGGCTGGGAGAGG-1_V10B01-087_D1,3,1,0,0,0,4
TAAGCAGGCGACACGC-1_V10B01-087_D1,3,3,0,0,0,6
AGCACTACCGGCCTGT-1_V10B01-087_D1,2,2,0,0,0,4
GAAAGCCCTTTGGACC-1_V10B01-087_D1,3,0,0,0,0,3
GACCGACTGAAGCGTC-1_V10B01-087_D1,0,3,0,0,0,3
CGGTGAAGACTAAAGT-1_V10B01-087_D1,2,3,0,0,0,5
CCCTGCGCTACGCATA-1_V10B01-087_D1,1,2,0,0,0,3
TACTGGACAGCTCGGC-1_V10B01-087_D1,1,3,0,0,0,4
TTAGTAGGGCGGCGGG-1_V10B01-087_D1,2,1,0,0,0,3
GAGGCTATCAAAGTCG-1_V10B01-087_D1,1,1,0,0,1,3
TTACCATTGATTACCC-1_V10B01-087_D1,4,3,0,0,0,7
ATACCACGGGCAACTT-1_V10B01-087_D1,3,0,0,0,0,3
TGTCCTAAGTCACCGC-1_V10B01-087_D1,1,1,1,0,0,3
AGGTAGGTACAAAGCT-1_V10B01-087_D1,1,2,0,0,0,3
GGCATACAGGTAGCGG-1_V10B01-087_D1,4,0,0,0,0,4
TGTAGTGATCTATAAT-1_V10B01-087_D1,1,2,0,0,0,3
TCCCGGGTGTGCTGCT-1_V10B01-087_D1,1,1,0,0,0,2
TACGATGTTGATCATC-1_V10B01-087_D1,6,1,0,0,0,7
CCTCTCTCCCATCTAG-1_V10B01-087_D1,1,0,1,0,1,3
GCAGGACTATAGAATA-1_V10B01-087_D1,1,3,0,0,0,4
CTAGTGAAGGACAGGA-1_V10B01-087_D1,0,0,0,0,0,0
TACGAGAACTTCACGT-1_V10B01-087_D1,3,2,0,0,0,5
CGTTGTTTCAATTCCC-1_V10B01-087_D1,2,1,1,0,0,4
GCAAATATTACGCTTT-1_V10B01-087_D1,4,0,1,0,0,5
CCAATAGTGCCGTCGA-1_V10B01-087_D1,0,1,0,0,0,1
ATTGCTGCTCCTCCAT-1_V10B01-087_D1,1,1,0,0,0,2
GAGATCTGCTTGGCAT-1_V10B01-087_D1,0,1,1,0,0,2
GCCGAAATTCCTACGT-1_V10B01-087_D1,4,1,0,0,0,5
GGCACTCCACTGGGCA-1_V10B01-087_D1,5,3,0,0,0,8
GGGTCACCGTGACGGT-1_V10B01-087_D1,0,2,1,0,0,3
CACTTAATCAGACGGA-1_V10B01-087_D1,5,1,1,0,0,7
CGTTTCGCTCATTACA-1_V10B01-087_D1,1,3,1,0,0,5
ATAAAGGCTCGGTCGT-1_V10B01-087_D1,1,2,0,0,0,3
CACTAAAGTTGCCTAT-1_V10B01-087_D1,2,0,0,0,1,3
GTGCTCAAGTACTGTC-1_V10B01-087_D1,1,1,0,0,0,2
CCATGCCTGTTTAGTA-1_V10B01-087_D1,5,2,1,0,0,8
TCTAGTTATCAGAAGA-1_V10B01-087_D1,1,3,2,0,0,6
TTGTAATCCGTACTCG-1_V10B01-087_D1,3,2,0,0,0,5
TCCCAGCTTTAGTCTG-1_V10B01-087_D1,1,1,1,0,0,3
CTACGCACGGAGTACC-1_V10B01-087_D1,0,3,0,0,0,3
AAATTAACGGGTAGCT-1_V10B01-087_D1,4,1,0,0,0,5
CGGCCACGCACAAAGT-1_V10B01-087_D1,2,1,1,0,0,4
GAAGCGTGAGGAATTT-1_V10B01-087_D1,2,1,1,1,0,5
ATATCTTAGGGCCTTC-1_V10B01-087_D1,1,2,0,0,0,3
ACGCGGGCCAAGGACA-1_V10B01-087_D1,2,0,1,0,0,3
GCGAGTTCTGCAAAGA-1_V10B01-087_D1,3,2,0,0,0,5
TATTCGTGCCAGAATA-1_V10B01-087_D1,3,4,0,0,0,7
AGGGCTGCAGTTACAG-1_V10B01-087_D1,3,1,0,0,1,5
CTAGCATAGTATAATG-1_V10B01-087_D1,2,2,0,0,0,4
TAGGTTCGAGTTCGTC-1_V10B01-087_D1,6,1,0,0,0,7
GAATTATAGTGAAAGG-1_V10B01-087_D1,1,2,0,0,0,3
CTATCGGGTCTCAACA-1_V10B01-087_D1,6,0,0,0,1,7
GCGCTAATTGAATAGA-1_V10B01-087_D1,4,3,0,0,1,8
ATGCGACAGTCCCATT-1_V10B01-087_D1,5,0,1,0,0,6
GGTAGTGCTCGCACCA-1_V10B01-087_D1,3,1,0,0,0,4
AAGCTCGTGCCAAGTC-1_V10B01-087_D1,5,3,0,0,0,8
TATTCAATTCTAATCC-1_V10B01-087_D1,1,3,0,0,0,4
TTCAAAGTCTCTAGCC-1_V10B01-087_D1,0,3,1,0,1,5
TTGAATATGGACTTTC-1_V10B01-087_D1,5,2,0,0,0,7
AAGAGCTCTTTATCGG-1_V10B01-087_D1,4,3,0,0,0,7
TTACTCCGGCCGGGAA-1_V10B01-087_D1,2,1,0,0,0,3
AAACGAGACGGTTGAT-1_V10B01-087_D1,3,2,0,0,0,5
GCTAAGTAGTTTCTCT-1_V10B01-087_D1,3,0,1,0,0,4
ATAACGCCGGAGGGTC-1_V10B01-087_D1,7,1,0,0,1,9
GGATCCGGAATATACT-1_V10B01-087_D1,2,1,0,0,0,3
TGAAAGGACCTGACTC-1_V10B01-087_D1,8,2,0,0,0,10
TCCGCGGCAGCATCTG-1_V10B01-087_D1,1,1,0,0,0,2
TGCATATGTCTGTCAC-1_V10B01-087_D1,4,1,0,0,2,7
TGTAGGAGAAATTTCC-1_V10B01-087_D1,6,1,1,0,1,9
AGTGAGACTTCCAGTA-1_V10B01-087_D1,5,1,0,0,1,7
CCCAAACATGCTGCTC-1_V10B01-087_D1,3,2,0,0,1,6
GCTTATGAAGCAGGAA-1_V10B01-087_D1,2,0,1,0,0,3
TTCTAACCGAAGCTTA-1_V10B01-087_D1,2,0,0,0,0,2
GGATGTCCTTACCGCA-1_V10B01-087_D1,0,0,1,0,2,3
AGGGTGCTCTCGAGGG-1_V10B01-087_D1,1,0,0,0,0,1
AACTCTCAATAGAGCG-1_V10B01-087_D1,1,0,0,0,2,3
TCTGAATTCCGTACAA-1_V10B01-087_D1,3,0,0,0,0,3
GCGTGGTACTGGGTTA-1_V10B01-087_D1,1,0,0,0,1,2
CGTCGGATAGTGTTGA-1_V10B01-087_D1,1,0,1,0,0,2
ATATGTCTCCCTAGCC-1_V10B01-087_D1,3,0,0,0,0,3
TCTTTAAGACTATGAA-1_V10B01-087_D1,4,0,0,0,1,5
TCATTTAAGTCTCCGA-1_V10B01-087_D1,1,0,0,0,0,1
GATATTGAGATTGGCG-1_V10B01-087_D1,3,0,0,0,0,3
TGACATCGAGCGGACC-1_V10B01-087_D1,2,0,0,0,0,2
GCGTAAATGGCCATAA-1_V10B01-087_D1,2,0,0,0,3,5
ATTGTACAACTCGGCT-1_V10B01-087_D1,0,0,0,0,5,5
TACGCTATAGAAACCT-1_V10B01-087_D1,1,0,2,0,2,5
CACCCAAATCTTATGT-1_V10B01-087_D1,1,0,0,0,2,3
AGATGATGGAGTCTGG-1_V10B01-087_D1,1,0,0,0,1,2
CCACGGTGCCCGGTAG-1_V10B01-087_D1,11,0,0,3,0,14
TCAAGAAATACTAGCT-1_V10B01-087_D1,3,0,0,0,3,6
CAAGGTCCTATAGGCT-1_V10B01-087_D1,0,0,0,0,0,0
CAAACCAGGTCTGCAT-1_V10B01-087_D1,3,0,0,0,0,3
ACAAGCTATATGGAAG-1_V10B01-087_D1,1,1,0,0,0,2
TCGCCCACTGCGAGAG-1_V10B01-087_D1,3,1,1,0,0,5
AGCCGCAAATTCAAAT-1_V10B01-087_D1,1,1,1,0,0,3
TTAACGTTAAAGCCTG-1_V10B01-087_D1,2,2,1,0,0,5
CAGCGCCAACACGATA-1_V10B01-087_D1,7,0,0,0,1,8
ATCCAATGGTACCGAA-1_V10B01-087_D1,0,3,0,0,0,3
GTGCTGCAGATAAGGA-1_V10B01-087_D1,4,1,0,0,1,6
GGCCTTTGCAACTGGC-1_V10B01-087_D1,4,2,0,0,0,6
GTCGTACCTACGATTG-1_V10B01-087_D1,2,3,0,0,0,5
TAGAAATTCACGTATA-1_V10B01-087_D1,2,0,0,0,0,2
AGAATAAATCTTCAGG-1_V10B01-087_D1,2,1,0,0,0,3
CATTGCGAAATGGGCG-1_V10B01-087_D1,1,6,0,0,0,7
GTCTACTCAATTACAA-1_V10B01-087_D1,2,0,0,0,2,4
TGTAATGACCACAATA-1_V10B01-087_D1,2,4,0,0,0,6
AAAGTCGACCCTCAGT-1_V10B01-087_D1,1,0,0,0,0,1
TACTCGGCACGCCGGG-1_V10B01-087_D1,5,2,0,0,0,7
AGGTGTATCGCCATGA-1_V10B01-087_D1,1,0,0,1,1,3
TGTGCTTTACGTAAGA-1_V10B01-087_D1,5,0,0,1,1,7
AAACCTCATGAAGTTG-1_V10B01-087_D1,3,0,0,0,0,3
TATAGGGTACTCATGA-1_V10B01-087_D1,3,4,0,0,0,7
CCAGCTGATGGTACTT-1_V10B01-087_D1,1,0,0,0,0,1
AATATTGGAGTATTGA-1_V10B01-087_D1,0,1,0,0,0,1
GGCCCTCACCCACTTA-1_V10B01-087_D1,3,0,0,0,0,3
AACCAAGACTTCTCTG-1_V10B01-087_D1,5,0,0,0,0,5
TCGTATTACCCATTGC-1_V10B01-087_D1,4,1,0,0,0,5
ATTCGACGCCGGGCCT-1_V10B01-087_D1,0,1,0,0,0,1
GGCGCAGGACATCTTC-1_V10B01-087_D1,7,3,1,0,0,11
GTACTCCCTTATCGCT-1_V10B01-087_D1,3,1,0,0,0,4
TGGTCTGTTGGGCGTA-1_V10B01-087_D1,4,5,0,0,2,11
AATAACAACGCTCGGC-1_V10B01-087_D1,3,0,1,0,1,5
CATACCCGTACCCAGT-1_V10B01-087_D1,4,2,0,0,2,8
ACAATCCATTTAAACC-1_V10B01-087_D1,3,2,0,0,0,5
GTTACAATTGGTGACG-1_V10B01-087_D1,3,3,0,0,0,6
TTGCCCTGATCACGGG-1_V10B01-087_D1,0,0,0,0,0,0
CTAACCGCGCGCCCGT-1_V10B01-087_D1,2,0,0,0,1,3
CTAAAGAATGCCTACT-1_V10B01-087_D1,1,0,0,0,0,1
ACCCATCTTGAGGGTA-1_V10B01-087_D1,2,1,0,0,1,4
GATCTTTGCAGGGTAT-1_V10B01-087_D1,3,0,0,0,0,3
GGGTACTTCATGAACT-1_V10B01-087_D1,3,0,0,0,0,3
GCCGCTTGTGAGAAAC-1_V10B01-087_D1,2,3,0,0,0,5
CCTGTAAGACATGATA-1_V10B01-087_D1,3,1,1,0,0,5
CGACAGTTCGCGTTAT-1_V10B01-087_D1,1,0,0,0,0,1
ACGATGCATATGTTAT-1_V10B01-087_D1,2,1,0,0,0,3
TGTTCCGCTTCCATGA-1_V10B01-087_D1,1,3,0,0,0,4
GGATGACGCGAGTTTA-1_V10B01-087_D1,1,2,0,0,0,3
GAAGTTTCCACTCAAT-1_V10B01-087_D1,4,2,0,0,0,6
GCGAGGCCCGAGCAGA-1_V10B01-087_D1,3,0,0,0,0,3
CATACTATGTAATTGT-1_V10B01-087_D1,2,0,0,0,0,2
CCAATGTCACAGCAAG-1_V10B01-087_D1,0,4,0,0,0,4
GTTGGATTTGCGTTGG-1_V10B01-087_D1,2,3,1,0,0,6
GGGAGGATGCCCGAAA-1_V10B01-087_D1,1,2,0,0,0,3
GATCGCGGGCTCTCCA-1_V10B01-087_D1,2,2,1,0,0,5
GTTCGCCATAAGTGCC-1_V10B01-087_D1,5,0,0,0,1,6
AGATTATAGGACGTTT-1_V10B01-087_D1,3,0,0,0,0,3
TCGAGACCAACACCGT-1_V10B01-087_D1,2,1,0,0,0,3
TATGGGACCGAGCAGG-1_V10B01-087_D1,4,2,0,0,1,7
GATGCGTCCTGCATTC-1_V10B01-087_D1,3,3,1,0,0,7
TATGGTCTGAGTAACA-1_V10B01-087_D1,1,3,0,0,0,4
GCATAGAGCACTCAGG-1_V10B01-087_D1,1,0,1,0,0,2
CTTCATTGTCAGTGGA-1_V10B01-087_D1,3,1,1,0,0,5
GCAGATTAGGGATATC-1_V10B01-087_D1,8,0,0,0,0,8
CCTGTCGCCCGTAAAT-1_V10B01-087_D1,5,1,0,0,0,6
CAATTTCGTATAAGGG-1_V10B01-087_D1,2,3,0,0,0,5
GTACACTTACCTGAAG-1_V10B01-087_D1,2,2,0,0,0,4
CCAGCCTGGACCAATA-1_V10B01-087_D1,4,0,0,0,0,4
ATGGAGCAGGCCGTGA-1_V10B01-087_D1,5,3,0,0,0,8
GTCATTAGAGCGAACG-1_V10B01-087_D1,2,1,0,0,0,3
AAGACTGCAAGCTACT-1_V10B01-087_D1,2,0,0,0,1,3
CTAGTCACGTCTTAAG-1_V10B01-087_D1,4,0,0,0,0,4
ACTCTTGTATAGTAAC-1_V10B01-087_D1,3,1,0,0,1,5
ATTAGGCGATGCTTTC-1_V10B01-087_D1,2,1,0,0,1,4
TTCGGGACTAATCGCG-1_V10B01-087_D1,1,1,0,0,0,2
TGGACTGTTCGCTCAA-1_V10B01-087_D1,3,0,0,0,1,4
AACGTGCGAAAGTCTC-1_V10B01-087_D1,3,1,0,0,1,5
CCACCCAAGGAAAGTG-1_V10B01-087_D1,0,0,0,0,0,0
CCGCACAAAGACCAAC-1_V10B01-087_D1,2,0,0,0,1,3
GCGATTGTTAACGTTA-1_V10B01-087_D1,3,0,0,0,0,3
ACTCGTCAGTAATCCC-1_V10B01-087_D1,5,0,0,0,0,5
GGTGATAAGGAGCAGT-1_V10B01-087_D1,3,0,1,0,0,4
AAGAGGCATGGATCGC-1_V10B01-087_D1,2,1,0,0,0,3
CACGTTCGTGCTCTAG-1_V10B01-087_D1,1,0,0,0,1,2
CTATTTGGTTACGGAT-1_V10B01-087_D1,2,1,2,1,0,6
GTACAGAGGCAAGGGT-1_V10B01-087_D1,0,0,0,0,1,1
GGGCCGGCCGAAGTAC-1_V10B01-087_D1,5,0,1,0,0,6
CCTGAACGATATATTC-1_V10B01-087_D1,1,0,0,0,0,1
CCGGGCTGCTCCATAC-1_V10B01-087_D1,1,0,0,0,0,1
TACTTGTTAGTAGTCC-1_V10B01-087_D1,1,0,0,0,0,1
CCTAGGCGTAGCGATC-1_V10B01-087_D1,2,0,0,0,1,3
CTGGCGCACAGGTCTG-1_V10B01-087_D1,2,0,1,0,1,4
ACTTATACTTACCCGG-1_V10B01-087_D1,3,0,0,0,0,3
GAAGTCTCCCTAGCGA-1_V10B01-087_D1,0,0,0,0,0,0
ACCGATGGTAGCATCG-1_V10B01-087_D1,1,0,0,0,1,2
CGAGTTTATCGGACTG-1_V10B01-087_D1,3,0,0,0,0,3
CATAACGGACAGTCGT-1_V10B01-087_D1,0,0,0,0,1,1
TGACGATGCACTAGAA-1_V10B01-087_D1,1,0,0,0,1,2
TAGGGAGCTTGGGATG-1_V10B01-087_D1,3,0,0,0,1,4
AGGGTCGATGCGAACT-1_V10B01-087_D1,0,0,0,0,1,1
TATATCCCTGGGAGGA-1_V10B01-087_D1,0,0,0,0,2,2
CATCTTACACCACCTC-1_V10B01-087_D1,7,0,0,0,2,9
GTGCGACAGGGAGTGT-1_V10B01-087_D1,0,0,0,0,1,1
CCGATCTCAACCTTAT-1_V10B01-087_D1,3,0,0,0,1,4
ACGATCATCTTGTAAA-1_V10B01-087_D1,1,0,0,0,1,2
CTAGGTCTGAAGGAAT-1_V10B01-087_D1,6,0,0,0,0,6
AAATAGCTTAGACTTT-1_V10B01-087_D1,1,0,0,0,0,1
ACAGGTGTGTTGTTGC-1_V10B01-087_D1,0,0,0,0,0,0
TGAACTGCTATGACTT-1_V10B01-087_D1,5,0,0,0,0,5
TGACATATATGACGAT-1_V10B01-087_D1,2,0,0,0,0,2
AAGTCTTCTGTGGCCT-1_V10B01-087_D1,4,1,0,0,0,5
ACCAGACCATAACAAC-1_V10B01-087_D1,4,0,0,0,0,4
TGAGACGTACCTCTCA-1_V10B01-087_D1,2,0,0,0,0,2
GACCGTTACATGCGAC-1_V10B01-087_D1,0,0,0,0,0,0
GGTTCGGATTATACTA-1_V10B01-087_D1,1,0,0,0,0,1
CCTCCTGAGCCCACAT-1_V10B01-087_D1,1,0,0,0,0,1
CCGCGATTTGGTAGGT-1_V10B01-087_D1,1,1,0,0,2,4
AATCTCTACTGTGGTT-1_V10B01-087_D1,1,0,0,0,0,1
ACTTTGACTGCATCCT-1_V10B01-087_D1,1,0,0,0,0,1
CCCTGACTAACAAATT-1_V10B01-087_D1,3,1,0,0,0,4
ACGCTGTGAGGCGTAG-1_V10B01-087_D1,1,0,0,0,1,2
GCATACGAGGTCTTTA-1_V10B01-087_D1,0,0,0,0,0,0
TCGGGATTCAAACATA-1_V10B01-087_D1,1,0,0,0,1,2
GGGCCCTACGAAAGGG-1_V10B01-087_D1,1,0,0,0,0,1
CGCCAAGAAGCCGAGT-1_V10B01-087_D1,1,0,0,0,1,2
GGTACATCTGGGACGA-1_V10B01-087_D1,2,0,0,0,1,3
GGATGCTGGCGTTCCT-1_V10B01-087_D1,1,0,0,0,0,1
CCGATTCGAGGGACCC-1_V10B01-087_D1,3,0,0,0,0,3
CCACTGGTGGCTGGTT-1_V10B01-087_D1,0,0,0,0,2,2
GACAGGCACACACTAT-1_V10B01-087_D1,3,0,0,0,0,3
TCAACGCGACCGGCAG-1_V10B01-087_D1,0,0,0,0,1,1
CTACGACTAGCTATAA-1_V10B01-087_D1,1,1,2,0,0,4
CGGTTGACCTGGCATA-1_V10B01-087_D1,0,0,0,0,1,1
ATCCTGAATCGCTGCG-1_V10B01-087_D1,1,0,0,0,2,3
GTTTCATATCGTCGCT-1_V10B01-087_D1,0,0,0,0,1,1
ATAAATATTAGCAGCT-1_V10B01-087_D1,0,0,1,0,1,2
AAGAGGATGTACGCGA-1_V10B01-087_D1,2,0,0,0,0,2
TCCTGCGTTGATACTC-1_V10B01-087_D1,3,0,0,0,0,3
CGTGCATTGTCGACGC-1_V10B01-087_D1,1,0,0,0,1,2
CCGGGTTCGAGGTTAC-1_V10B01-087_D1,4,0,0,0,0,4
CCCAATTTCACAACTT-1_V10B01-087_D1,1,0,1,0,0,2
TGATTTATTAGCTGTG-1_V10B01-087_D1,2,1,0,0,0,3
TGGAAGAAGGGAACGT-1_V10B01-087_D1,0,0,0,0,3,3
GACGCTTGCTTCTAAA-1_V10B01-087_D1,0,0,0,0,1,1
GGGAACGGGAGGTTAG-1_V10B01-087_D1,1,0,0,0,0,1
GCGGCTCTGACGTACC-1_V10B01-087_D1,5,1,0,0,1,7
ACGTTAGATTTGCCCG-1_V10B01-087_D1,1,0,0,0,0,1
GAGAGGGCGCGAGGTT-1_V10B01-087_D1,5,2,0,0,0,7
GCGTCTCTGCATTGGG-1_V10B01-087_D1,0,0,0,0,0,0
GCAGCACACAGCCCAG-1_V10B01-087_D1,7,0,1,0,1,9
CAGGCCGTTTGGGTGT-1_V10B01-087_D1,1,0,0,0,0,1
AACTCAAGTTAATTGC-1_V10B01-087_D1,2,0,1,0,0,3
CTTCGTAGATAGGTGA-1_V10B01-087_D1,0,0,0,0,0,0
TGCAGAGTACCGAGCA-1_V10B01-087_D1,2,0,1,0,1,4
GAAGTGATTTATCGTG-1_V10B01-087_D1,3,0,0,0,0,3
CGCTACGGGACATTTA-1_V10B01-087_D1,2,0,0,0,1,3
CCACACTGAGATATTA-1_V10B01-087_D1,1,0,0,0,0,1
CGATCCGACCCAGTGC-1_V10B01-087_D1,2,0,0,0,0,2
CTGTACTTCTTAGCAT-1_V10B01-087_D1,0,0,0,0,3,3
ACTTATTAGGATCGGT-1_V10B01-087_D1,2,0,1,0,1,4
TAGTCCGCAGAGAATG-1_V10B01-087_D1,0,0,0,0,3,3
TTCACGAAAGGATCAC-1_V10B01-087_D1,3,0,0,0,2,5
TACATTTCTAACGTGC-1_V10B01-087_D1,0,0,0,0,3,3
ACCATATCCGCAATAA-1_V10B01-087_D1,4,0,0,0,0,4
CACTCAAGAGCTATGG-1_V10B01-087_D1,0,1,0,0,1,2
TGTACGAACAAATCCG-1_V10B01-087_D1,1,0,0,0,1,2
ATCATCCAATATTTGT-1_V10B01-087_D1,0,0,0,0,0,0
CGCTATTCTTAGGCTC-1_V10B01-087_D1,0,0,0,0,0,0
TGGCAGCAGTAATAGT-1_V10B01-087_D1,1,0,0,0,3,4
TCACGTGCCCGATTCA-1_V10B01-087_D1,2,0,0,0,1,3
CATACGGCGTCTGGGC-1_V10B01-087_D1,0,0,0,0,2,2
CACATGATTCAGCAAC-1_V10B01-087_D1,2,0,0,0,2,4
GCTAGTAGAGCTTGTA-1_V10B01-087_D1,2,0,0,0,3,5
TGCTGTTGAAGAACTC-1_V10B01-087_D1,0,0,0,0,1,1
TAGCGTTGGGTCTTAC-1_V10B01-087_D1,4,0,1,0,0,5
TAACATACAATGTGGG-1_V10B01-087_D1,0,0,0,0,1,1
GATCGTGACTGATATC-1_V10B01-087_D1,4,0,0,0,0,4
TTATATACGCTGTCAC-1_V10B01-087_D1,0,0,0,0,2,2
AGCTCTAGACGTTCCA-1_V10B01-087_D1,0,0,0,0,1,1
CGAGGGACTGCGGTCG-1_V10B01-087_D1,0,0,0,0,1,1
TAATTTCCGTCCAGTA-1_V10B01-087_D1,1,0,0,0,1,2
TCCTTCAATCCCTACG-1_V10B01-087_D1,5,1,1,0,0,7
TACCTATCCCTAGAGG-1_V10B01-087_D1,1,0,0,0,0,1
GCATGGGTACTGACGC-1_V10B01-087_D1,2,0,1,0,0,3
GTCGGGAACATGGTAG-1_V10B01-087_D1,1,0,0,0,0,1
GCAAATGAGGACACTT-1_V10B01-087_D1,1,0,0,0,2,3
GAATGGGCTTATCGAC-1_V10B01-087_D1,3,0,0,0,0,3
TGGTCGTGCAAGGCAA-1_V10B01-087_D1,4,0,0,0,7,11
CACCACGCCACACAGA-1_V10B01-087_D1,4,0,0,0,0,4
GAACCTCGACCTACAC-1_V10B01-087_D1,2,0,0,1,3,6
CAATACGCTCTGAGGC-1_V10B01-087_D1,1,0,0,0,2,3
TGGTAAGCAGGATTGA-1_V10B01-087_D1,5,0,0,0,1,6
AGTGGCTCCGTCGGCC-1_V10B01-087_D1,4,0,0,0,0,4
GATCGGATAGAACCAT-1_V10B01-087_D1,5,0,0,0,0,5
GCTACAGTACGGACCG-1_V10B01-087_D1,0,0,0,0,0,0
TTCAGGCGTCAAAGCC-1_V10B01-087_D1,1,0,0,0,3,4
AGAGATCTCTAAAGCG-1_V10B01-087_D1,0,0,1,0,1,2
GTGGCGGTCCCAGCGT-1_V10B01-087_D1,1,0,1,0,4,6
CCGTTCCGAATCTCGG-1_V10B01-087_D1,0,0,0,0,1,1
AGCTTGATCTTAACTT-1_V10B01-087_D1,11,0,0,0,0,11
CCTGTACTCACGCCCA-1_V10B01-087_D1,1,0,0,0,5,6
AAGTGACGACCGAATT-1_V10B01-087_D1,11,0,0,0,0,11
CTCACTTGGCTGGTAA-1_V10B01-087_D1,1,1,0,0,3,5
CGCCTGGCCTACGTAA-1_V10B01-087_D1,0,0,0,0,0,0
CCCGTAAGTCTAGGCC-1_V10B01-087_D1,0,0,0,0,0,0
TTGGACATGTGGCTTA-1_V10B01-087_D1,7,0,0,0,0,7
ATTACGCGCTGGCAGG-1_V10B01-087_D1,4,0,0,0,2,6
ACGCGCTACACAGGGT-1_V10B01-087_D1,11,0,0,0,5,16
TACGTTTACCGGCAAT-1_V10B01-087_D1,1,0,0,0,0,1
TAGTCTAACAACGAGA-1_V10B01-087_D1,1,0,0,0,0,1
TCTGGGTAGCGCTCAT-1_V10B01-087_D1,0,0,0,0,2,2
AGATACCGGTGTTCAC-1_V10B01-087_D1,1,0,0,0,0,1
TCCAACTTTAAATTCT-1_V10B01-087_D1,1,0,0,0,1,2
GTCTATCTGAGTTTCT-1_V10B01-087_D1,1,0,0,0,1,2
AGTTAAACACTTGCGA-1_V10B01-087_D1,0,0,0,0,2,2
ATCCAGGATTCGTGAA-1_V10B01-087_D1,1,0,0,0,1,2
CGATACCTCGCGGACA-1_V10B01-087_D1,0,0,0,0,5,5
AATTAAAGGTCGGCGT-1_V10B01-087_D1,0,0,0,0,1,1
GACCGTGCTGACGGTG-1_V10B01-087_D1,0,0,0,0,2,2
GGTACAAACATGCTAT-1_V10B01-087_D1,0,0,0,0,5,5
CGTGAAGTTAATTCAC-1_V10B01-087_D1,0,0,0,0,2,2
TACGCCATATTCTAAT-1_V10B01-087_D1,0,0,0,0,1,1
TACATAGGCATACACC-1_V10B01-087_D1,0,0,0,0,1,1
TGTGTCGAAGTCGAGG-1_V10B01-087_D1,7,0,0,0,1,8
GGATCAGAGCCATCAG-1_V10B01-087_D1,0,0,0,0,0,0
GTCCCAATCATCCCGC-1_V10B01-087_D1,3,0,0,0,0,3
TGCCACACTAGAGGAA-1_V10B01-087_D1,8,0,0,1,0,9
TGAATTTCACTTGCCT-1_V10B01-087_D1,5,0,0,0,0,5
CTCAGATTGTGATAAG-1_V10B01-087_D1,1,0,0,3,0,4
CGGACGTTACTTGAAG-1_V10B01-087_D1,8,0,0,1,0,9
CCAGTCAAATCTCTTA-1_V10B01-087_D1,11,0,0,0,0,11
TCAACGAGGAGACAAA-1_V10B01-087_D1,16,0,0,0,0,16
CATCGGACGGGTTAAT-1_V10B01-087_D1,10,0,0,0,0,10
TATCTACCACAGCGGG-1_V10B01-087_D1,12,0,0,0,0,12
ACATCGATCGTTTACC-1_V10B01-087_D1,16,0,0,0,0,16
GAATCTGAACATTCTC-1_V10B01-087_D1,11,0,0,0,0,11
CAGTCTGTATACTGGG-1_V10B01-087_D1,16,0,0,0,0,16
CGACCTACTAGACAAT-1_V10B01-087_D1,0,0,1,0,1,2
GAGTCTTGTAAAGGAC-1_V10B01-087_D1,1,0,0,0,0,1
AATATCCTAGCAAACT-1_V10B01-087_D1,0,0,0,0,1,1
CCCTAGGCAACAAGAG-1_V10B01-087_D1,1,0,0,0,0,1
ACAAAGAAGGTAGGCC-1_V10B01-087_D1,2,0,1,0,1,4
CCCTGGCTGTTCCTTC-1_V10B01-087_D1,2,0,0,0,0,2
TCGCCGCACCGCGTGA-1_V10B01-087_D1,0,0,0,0,0,0
TATAGCGCACGTTATC-1_V10B01-087_D1,2,0,0,0,0,2
TTATCTGACATTAGGA-1_V10B01-087_D1,2,0,1,0,1,4
AGTGGTGTTACCCGTG-1_V10B01-087_D1,0,0,2,0,0,2
GCCAAGAATACTTCTG-1_V10B01-087_D1,3,0,0,0,0,3
CCGGCGTGAGACTCTG-1_V10B01-087_D1,1,0,0,1,0,2
TTCCCGGCGCCAATAG-1_V10B01-087_D1,0,0,0,0,0,0
AAACAGGGTCTATATT-1_V10B01-087_D1,1,0,0,0,0,1
ACAGTAATACAACTTG-1_V10B01-087_D1,3,0,0,0,0,3
CGAACGGCCGGACAAC-1_V10B01-087_D1,1,0,0,0,0,1
GCAACACACTAGAACT-1_V10B01-087_D1,0,0,0,0,1,1
ACTCCCATTCCTAAAG-1_V10B01-087_D1,3,0,2,0,0,5
ACCTGCGTGTCATGTT-1_V10B01-087_D1,2,0,1,0,0,3
TACTTTCCGCACGCCA-1_V10B01-087_D1,4,0,0,0,0,4
AGGTCAGGTGAGAGTG-1_V10B01-087_D1,1,0,0,0,0,1
TCCTCCTAAGACATTC-1_V10B01-087_D1,1,0,0,0,0,1
ATGTGAAAGCCTAATG-1_V10B01-087_D1,0,0,0,0,0,0
AGTCGGCTCAACTTTA-1_V10B01-087_D1,2,0,0,0,0,2
CGATCTGTTGGAGGAC-1_V10B01-087_D1,1,0,0,0,0,1
ACGGGAGTGTCGGCCC-1_V10B01-087_D1,3,0,0,0,0,3
TTAACTTCAGGTAGGA-1_V10B01-087_D1,8,0,0,0,0,8
CCACGGAGCCATAAGA-1_V10B01-087_D1,1,0,0,0,0,1
CTTCTATGTTGAAGTA-1_V10B01-087_D1,2,0,0,0,3,5
CACCGTTGCGCGATAT-1_V10B01-087_D1,1,0,0,0,0,1
TCTAGCAATCTCCGCC-1_V10B01-087_D1,1,0,0,0,0,1
AGTTTGGCCAGACCTA-1_V10B01-087_D1,5,0,0,0,0,5
TTGTAAGGACCTAAGT-1_V10B01-087_D1,2,0,0,0,1,3
AAATTTGCGGGTGTGG-1_V10B01-087_D1,0,0,0,0,0,0
AAGTTCGGCCAACAGG-1_V10B01-087_D1,2,0,0,0,1,3
CCGCTTACCTCACTCT-1_V10B01-087_D1,1,0,0,0,0,1
ATCACGTGCTAATTAA-1_V10B01-087_D1,0,0,0,0,0,0
GGTGAAGTACAGGGAT-1_V10B01-087_D1,0,0,0,0,0,0
GCTGTATTACTGGCCC-1_V10B01-087_D1,0,0,0,0,0,0
AACGGCCATCTCCGGT-1_V10B01-087_D1,3,0,0,0,0,3
TAAGTAACATCTTGAC-1_V10B01-087_D1,1,0,1,0,0,2
TTCTTGAGCCGCGCTA-1_V10B01-087_D1,1,0,0,0,0,1
AGTGCGTAGCTCGTAA-1_V10B01-087_D1,1,0,0,0,1,2
GGGATGGTCGTAACCG-1_V10B01-087_D1,0,0,0,0,0,0
GTCTGGGCGGTCGAGA-1_V10B01-087_D1,0,0,0,0,1,1
CGGAACGTAAACATAG-1_V10B01-087_D1,2,0,0,0,0,2
TGCGACACCCTAGTGC-1_V10B01-087_D1,2,0,0,0,0,2
CAAACGAGTATCGCAG-1_V10B01-087_D1,1,0,1,0,1,3
TCAGTAGGGACTATAA-1_V10B01-087_D1,3,0,2,0,0,5
GCGGTTCCCTATCATG-1_V10B01-087_D1,2,0,0,0,0,2
GTGACTTCAGTAGTGC-1_V10B01-087_D1,3,0,0,0,3,6
CGTCACGTCCATTGGT-1_V10B01-087_D1,3,0,1,0,0,4
ATAAGTTACCGCGACG-1_V10B01-087_D1,1,0,0,0,2,3
CTGAATCCGAGACCTC-1_V10B01-087_D1,0,0,0,0,1,1
TACGACGCTTGCTGCG-1_V10B01-087_D1,3,0,0,0,0,3
GAATTCACCCGGGTGT-1_V10B01-087_D1,3,0,0,0,0,3
TGAGTAAATTAGCGTA-1_V10B01-087_D1,0,0,0,0,1,1
GGCGCGTTCGAGTTTA-1_V10B01-087_D1,3,0,0,0,0,3
ATAAACGGACCCGTAA-1_V10B01-087_D1,1,0,0,0,0,1
ATAATAGCTGTTGAAT-1_V10B01-087_D1,0,1,1,0,0,2
TACCGGCTCACTGCCC-1_V10B01-087_D1,1,0,0,0,0,1
GTTACCTACAACTTGC-1_V10B01-087_D1,3,0,0,0,0,3
AAATACCTATAAGCAT-1_V10B01-087_D1,2,0,0,0,0,2
ATGTGGACATCTTGAT-1_V10B01-087_D1,1,0,0,0,0,1
CACATATTAGCAGGAT-1_V10B01-087_D1,1,0,0,0,1,2
TCGCAAAGATGCATTT-1_V10B01-087_D1,1,0,0,0,2,3
TCGTGTACTATGGATG-1_V10B01-087_D1,2,0,0,0,2,4
TCACAGGGAATCGCAA-1_V10B01-087_D1,2,0,0,0,1,3
TCCGCTGTCATCCCGG-1_V10B01-087_D1,1,0,1,0,0,2
ACTGAATGGCGAAAGT-1_V10B01-087_D1,2,0,0,0,0,2
TTCAGCCCTGGTCCAC-1_V10B01-087_D1,2,0,0,0,3,5
GGTTAGCTATATGTCT-1_V10B01-087_D1,2,0,0,0,0,2
TGGGCCCATACTAATT-1_V10B01-087_D1,1,0,0,0,1,2
TTAGTTATTCGTGGCA-1_V10B01-087_D1,0,0,0,0,3,3
ATACGTCCACTCCTGT-1_V10B01-087_D1,1,0,0,0,1,2
TCTGAACTCGTACCCG-1_V10B01-087_D1,0,0,0,0,1,1
GTGATCACTAACGCCT-1_V10B01-087_D1,0,0,0,0,2,2
TTGACAGGAGCTCCCG-1_V10B01-087_D1,0,0,0,0,1,1
CGTGGCCGAATATCTA-1_V10B01-087_D1,0,0,0,0,0,0
TCAAGGTTACTACACC-1_V10B01-087_D1,0,0,0,0,0,0
TATGACCTTGCGCTGG-1_V10B01-087_D1,2,0,0,0,0,2
ATATACATGTATGGTA-1_V10B01-087_D1,6,0,0,0,0,6
TGTGTGACCATGAATC-1_V10B01-087_D1,1,0,0,0,0,1
CCCACTCCACGGTATC-1_V10B01-087_D1,2,0,0,0,0,2
GGGCAGACGTCACTGC-1_V10B01-087_D1,3,0,0,1,0,4
TCAAAGAGCTATCTGT-1_V10B01-087_D1,2,0,1,0,0,3
AGATGCATCCTGTGTC-1_V10B01-087_D1,2,0,0,0,0,2
GTGAAGTCACGACTCG-1_V10B01-087_D1,5,1,0,0,0,6
TGATTCAGGTCCCGCG-1_V10B01-087_D1,0,0,0,0,0,0
CGCCACAGGTCGCGAT-1_V10B01-087_D1,3,0,0,0,0,3
TTGAATCGTTGTATAA-1_V10B01-087_D1,2,0,0,0,0,2
TGGCCAATTTGGTACT-1_V10B01-087_D1,3,2,0,0,0,5
CGACCCTTAACGCCGG-1_V10B01-087_D1,3,0,0,0,0,3
TCGGCGTACTGCACAA-1_V10B01-087_D1,3,1,0,0,0,4
GAGTAAGGCCACGGGA-1_V10B01-087_D1,1,1,1,0,0,3
ATCAGCTCGTCCACTA-1_V10B01-087_D1,3,3,0,0,0,6
AGGATCACGCGATCTG-1_V10B01-087_D1,1,0,0,0,0,1
AAATGGCCCGTGCCCT-1_V10B01-087_D1,4,1,0,0,0,5
CAGTACCAGTTTACGT-1_V10B01-087_D1,2,1,1,0,0,4
GGTCGTAAGCTCGCAC-1_V10B01-087_D1,4,4,0,0,0,8
CGTTCATGGTGCGCGT-1_V10B01-087_D1,3,0,0,0,0,3
GACTACAAAGCGGTGG-1_V10B01-087_D1,2,0,0,0,0,2
CAGCTGGCGTAACCGT-1_V10B01-087_D1,3,0,0,0,0,3
ACTCGTAACCCGTCCT-1_V10B01-087_D1,5,0,0,0,0,5
CATATGTCAGGCTACG-1_V10B01-087_D1,3,1,1,0,0,5
GCCCGACTTCTTCCCG-1_V10B01-087_D1,2,5,0,0,0,7
CTGGCATCCGAATGAG-1_V10B01-087_D1,2,1,0,0,0,3
AAGTGCGTTAGAATCT-1_V10B01-087_D1,3,2,0,1,0,6
AGAAGTGATTCGTGAT-1_V10B01-087_D1,0,0,0,0,0,0
TACCTTAAGATTTCCC-1_V10B01-087_D1,2,1,0,0,0,3
AATGACAGCAATGTCT-1_V10B01-087_D1,2,0,0,0,0,2
TCAACGCAGGAAATAA-1_V10B01-087_D1,3,3,0,1,0,7
TATTCCTCCGCCCACT-1_V10B01-087_D1,5,1,0,0,0,6
ATCAAACGAAGGTTTG-1_V10B01-087_D1,5,0,0,0,0,5
TTGATTAGCTGTTTCT-1_V10B01-087_D1,1,0,0,0,0,1
CTGCTGAGGCCACGAA-1_V10B01-087_D1,5,0,1,0,0,6
CCGTGTTAAATTCCAT-1_V10B01-087_D1,3,0,0,0,0,3
CACGTCGGCAACCTCT-1_V10B01-087_D1,2,0,0,0,0,2
GTATTCTGAGAAACGA-1_V10B01-087_D1,5,1,0,0,0,6
CGGTGCGCGTTGGTCC-1_V10B01-087_D1,2,2,0,0,0,4
GTGATTCGCCGCTCAA-1_V10B01-087_D1,3,0,0,0,0,3
GCCCGCGCGTAAACGG-1_V10B01-087_D1,2,1,0,1,0,4
AACGTACTGTGGGTAC-1_V10B01-087_D1,2,2,0,0,0,4
GAGTATGCCCGCCTTG-1_V10B01-087_D1,3,1,0,0,0,4
TGATTCTGTCGCCGGT-1_V10B01-087_D1,2,0,0,0,1,3
GGGCGGCAAATGAATT-1_V10B01-087_D1,5,1,1,0,0,7
TTCCAATCTGGCTATC-1_V10B01-087_D1,5,0,0,0,0,5
GGAACCGTGTAAATTG-1_V10B01-087_D1,4,1,0,0,0,5
TTGGTCACACTCGTAA-1_V10B01-087_D1,0,1,0,0,0,1
CGAACCCGCATGCGTC-1_V10B01-087_D1,2,2,0,0,0,4
GGGCGTCACCACGTAA-1_V10B01-087_D1,4,0,0,0,0,4
TACCAGAAGTAGGTTC-1_V10B01-087_D1,4,3,0,1,0,8
TTGGATATCGTCTACG-1_V10B01-087_D1,4,0,0,0,0,4
TAGATATGGACTGGAA-1_V10B01-087_D1,5,2,0,0,1,8
GCGACGATAGTTGTAC-1_V10B01-087_D1,1,0,0,0,0,1
CTGGATTTACACTTGA-1_V10B01-087_D1,3,2,1,0,0,6
GTTATATTATCTCCCT-1_V10B01-087_D1,2,1,0,0,0,3
TATTCCACTCAGCTCG-1_V10B01-087_D1,3,1,0,0,0,4
CTGTTACCCAATCTAG-1_V10B01-087_D1,4,2,1,0,0,7
ACGCGAAGTCAGACGA-1_V10B01-087_D1,1,2,0,0,0,3
GATAGGTAACGTTGAC-1_V10B01-087_D1,3,1,0,0,1,5
TGTTCGTATTGCGGTG-1_V10B01-087_D1,5,2,0,0,0,7
GGTCAGTGGGTCCCAC-1_V10B01-087_D1,3,2,0,0,0,5
AATTCTAGAGTTAGGC-1_V10B01-087_D1,0,2,1,1,0,4
GTTTACGTTCCATCTG-1_V10B01-087_D1,0,0,0,0,0,0
AGACCCACCGCTGATC-1_V10B01-087_D1,4,0,0,0,0,4
TCTAGCATGCCCAGAA-1_V10B01-087_D1,8,0,0,0,0,8
CCCGCAGCGCGAACTA-1_V10B01-087_D1,2,3,1,0,0,6
CTCTATTTGGCTGCAG-1_V10B01-087_D1,5,0,0,0,0,5
TTCTGCCGCGCCTAGA-1_V10B01-087_D1,3,0,0,2,0,5
ACTCCCTAGAATAGTA-1_V10B01-087_D1,3,0,0,0,0,3
CCGAACCTTCCCGGCC-1_V10B01-087_D1,6,0,0,0,0,6
TCAGACGCTATAGAAG-1_V10B01-087_D1,2,0,0,0,0,2
CAGGCGCCATGCTAGG-1_V10B01-087_D1,3,0,0,1,0,4
CACTCGAGCTGAACAA-1_V10B01-087_D1,2,0,0,0,0,2
ACAAGGAAATCCGCCC-1_V10B01-087_D1,3,1,0,0,0,4
ACCACGTGCAGCTATA-1_V10B01-087_D1,1,0,0,0,0,1
ACGGCGACGATGGGAA-1_V10B01-087_D1,2,0,0,0,0,2
TTACTAAAGGACTTTA-1_V10B01-087_D1,1,0,0,0,0,1
GGCTGAAATAGCAAAG-1_V10B01-087_D1,1,2,1,0,2,6
TTAGACGAGTCACCTC-1_V10B01-087_D1,0,0,0,0,0,0
GTAGTCGCGGGAATCA-1_V10B01-087_D1,1,0,0,0,1,2
GCAAACCCTACATTAT-1_V10B01-087_D1,1,0,0,0,0,1
GTTAAAGTAGGACTGG-1_V10B01-087_D1,3,0,0,0,1,4
ACCCTCCCTTGCTATT-1_V10B01-087_D1,0,0,0,0,1,1
CATGTCTCATTTATGG-1_V10B01-087_D1,4,3,0,0,0,7
AATAGAATCTGTTTCA-1_V10B01-087_D1,2,0,0,0,0,2
TCTCATGAGATAGGGT-1_V10B01-087_D1,1,0,0,0,1,2
ATGACTATGCGACATT-1_V10B01-087_D1,0,0,0,0,0,0
CCTAACCCAAACAAGT-1_V10B01-087_D1,4,0,0,0,0,4
AGTCAAGATGACACTT-1_V10B01-087_D1,2,0,0,0,1,3
CGGGAGCTTCAGTGTA-1_V10B01-087_D1,0,0,0,0,0,0
CCACAGTACCCATCCT-1_V10B01-087_D1,0,0,0,0,0,0
GAGCGCGCACGAGTAG-1_V10B01-087_D1,1,0,0,0,0,1
ACCAGTGCGGGAGACG-1_V10B01-087_D1,3,0,0,0,0,3
TCCTTACGACGGTCCG-1_V10B01-087_D1,0,0,0,0,0,0
TAGTCGATCACGGGTT-1_V10B01-087_D1,2,0,0,0,0,2
AGACGAAGTGCCGGTC-1_V10B01-087_D1,1,0,0,0,0,1
CGCTGGTGACTACCCT-1_V10B01-087_D1,1,0,0,0,0,1
AGGCATTGTCGTAGGG-1_V10B01-087_D1,1,0,0,0,1,2
TGGTAGAATATATGGG-1_V10B01-087_D1,2,0,0,0,2,4
TTCTTATCCGCTGGGT-1_V10B01-087_D1,0,0,0,0,1,1
AGTTTGGCACGGGTTG-1_V10B01-087_D1,0,0,0,0,5,5
GCATCGGCCGTGTAGG-1_V10B01-087_D1,0,0,0,0,0,0
ATGCGAGTCCCACCAC-1_V10B01-087_D1,0,0,0,0,0,0
TCGGCGAACCCAAACC-1_V10B01-087_D1,0,0,0,0,3,3
AGAGTAAACTTCACTA-1_V10B01-087_D1,0,0,0,0,0,0
AAGCCGAAGCGGTTTA-1_V10B01-087_D1,0,0,0,0,1,1
CCCGAGTTTCTCCGTA-1_V10B01-087_D1,0,0,0,0,0,0
AATATCGAATCAATGC-1_V10B01-087_D1,1,0,0,0,0,1
CGTTAAACTAGTTAGG-1_V10B01-087_D1,0,0,0,0,0,0
TTAGAGGGATATACAG-1_V10B01-087_D1,0,1,0,0,0,1
TTGTACACCTCGAACA-1_V10B01-087_D1,5,4,0,0,0,9
GTGGGTACTGAGCGTA-1_V10B01-087_D1,2,0,0,0,0,2
CTTAAGCAGCGAGCCG-1_V10B01-087_D1,4,1,0,0,0,5
GCATTGACTTGCGGAA-1_V10B01-087_D1,1,0,0,0,0,1
CCATAACCTGTGCAGT-1_V10B01-087_D1,1,1,0,0,0,2
GGGCTACTATTTCGTG-1_V10B01-087_D1,7,1,0,0,0,8
GGCGAGCGAAACGGCA-1_V10B01-087_D1,3,0,0,0,0,3
GGAGACCATCTACATA-1_V10B01-087_D1,4,1,0,0,0,5
AGACCAAACCACACCT-1_V10B01-087_D1,5,2,1,0,0,8
CGACGCATCCGTACCT-1_V10B01-087_D1,2,1,1,0,0,4
CCTAGGTAAAGGTAGC-1_V10B01-087_D1,2,1,0,0,0,3
AGCGGCGGTTAGCGGT-1_V10B01-087_D1,2,2,0,0,0,4
CTGGACGCAGTCCGGC-1_V10B01-087_D1,1,2,0,0,0,3
AGCCTAATACCCACGT-1_V10B01-087_D1,2,1,0,0,0,3
AATCTGGCTTTCTAGT-1_V10B01-087_D1,2,3,1,0,0,6
CACCCTTGGTGAGACC-1_V10B01-087_D1,1,2,0,0,0,3
GGATCTTGACTCAACC-1_V10B01-087_D1,3,2,0,0,0,5
ACGAGGATACCACTCT-1_V10B01-087_D1,5,0,0,0,0,5
GAGTTGATGGCAATTT-1_V10B01-087_D1,2,1,0,0,0,3
GTGGCAAACAGCGGCA-1_V10B01-087_D1,1,1,0,0,0,2
GATGTAACGAACCACC-1_V10B01-087_D1,3,3,0,0,0,6
AGCCGTGGCTAAATGT-1_V10B01-087_D1,2,3,0,0,0,5
CTCCCTCCTTTCGATC-1_V10B01-087_D1,3,2,0,0,0,5
TTGGAAGAATACAGTC-1_V10B01-087_D1,2,2,0,0,0,4
AGTTAAGTCAACCGCT-1_V10B01-087_D1,2,0,0,0,0,2
CTCATGGTAATTTGCG-1_V10B01-087_D1,2,0,0,0,0,2
AAAGTAGCATTGCTCA-1_V10B01-087_D1,2,0,0,0,0,2
TTGTGGTAGGAGGGAT-1_V10B01-087_D1,2,2,0,0,0,4
AGTCGTGGGCATTACG-1_V10B01-087_D1,0,3,0,0,0,3
ACCTAAGTACCTTTCA-1_V10B01-087_D1,1,1,0,0,0,2
GTAGAGGGAGACAAGT-1_V10B01-087_D1,4,2,0,0,0,6
GATCCTCGACACTGGC-1_V10B01-087_D1,5,1,0,0,0,6
CCTACATTCACAGACG-1_V10B01-087_D1,1,1,0,0,0,2
TTGACCGTGTTAATGA-1_V10B01-087_D1,3,2,0,0,0,5
TCTGTTACCCAGCATA-1_V10B01-087_D1,1,0,0,0,0,1
CTAACTGGTCCGGTTC-1_V10B01-087_D1,4,3,1,0,0,8
AGCGACAGGAACGGTC-1_V10B01-087_D1,2,1,0,0,0,3
TAATAGAACAGAGTTA-1_V10B01-087_D1,1,2,0,0,0,3
ACAGGTGGAGGTGAGG-1_V10B01-087_D1,2,1,1,0,0,4
TGCGAGAATATTACCC-1_V10B01-087_D1,2,2,0,0,0,4
TTGCGTCGGCCAACCG-1_V10B01-087_D1,3,1,0,0,0,4
AGGCTTCCCGAAGAAG-1_V10B01-087_D1,3,0,1,0,0,4
GCGGACCGCGTTGTGG-1_V10B01-087_D1,2,1,0,0,1,4
GTAATCTGATTCTTCG-1_V10B01-087_D1,2,3,0,0,0,5
CCGCGGAATGCGTCAC-1_V10B01-087_D1,4,0,0,0,0,4
TTCCACACAGATTTGA-1_V10B01-087_D1,6,3,0,0,0,9
CTTCTATTAATGCTAG-1_V10B01-087_D1,2,0,0,0,0,2
CATTTGAGTGGTACGT-1_V10B01-087_D1,1,0,0,0,0,1
TCACAGCAAACTCGAA-1_V10B01-087_D1,3,2,0,0,0,5
CAGACGAACCTGATAC-1_V10B01-087_D1,3,3,0,0,0,6
TAGCTAGAAGGCATGA-1_V10B01-087_D1,0,0,0,0,0,0
ATCCAGAGCAACAACC-1_V10B01-087_D1,0,0,0,0,0,0
TCCGGTTCGTCCGGTC-1_V10B01-087_D1,2,2,0,0,0,4
CGCGCATGTTTGATTG-1_V10B01-087_D1,4,2,0,0,0,6
TGGCGATCAAGTTATG-1_V10B01-087_D1,0,1,0,0,0,1
CCCTTTGACAGGTCTT-1_V10B01-087_D1,4,1,0,0,0,5
CAGAGACGGTCACCCA-1_V10B01-087_D1,4,5,0,0,0,9
TAGCTCGCCTGATAAC-1_V10B01-087_D1,2,1,1,0,0,4
TTGTGTTTCCCGAAAG-1_V10B01-087_D1,1,1,0,0,0,2
TATACACAGACGCCTT-1_V10B01-087_D1,3,0,0,0,0,3
ACATTAGTTTATATCC-1_V10B01-087_D1,4,1,0,1,0,6
CCATCGCAGTTAAACT-1_V10B01-087_D1,4,2,0,0,0,6
AATTAGCGCTGCAGCG-1_V10B01-087_D1,0,2,0,0,0,2
TCCGCTTATCCCATTA-1_V10B01-087_D1,3,1,0,0,0,4
GTTTGGGCTTGTGAGC-1_V10B01-087_D1,2,1,0,0,0,3
CTTGTCAACATTCGAG-1_V10B01-087_D1,2,4,0,0,0,6
GGACCAACAGGATAAC-1_V10B01-087_D1,2,2,1,0,0,5
AAGCTAGATCGAGTAA-1_V10B01-087_D1,1,1,0,0,0,2
TACCGTGCCTCGGACC-1_V10B01-087_D1,2,1,1,0,0,4
GTAGCCAAACATGGGA-1_V10B01-087_D1,1,2,0,0,0,3
TGCCAGTACGTGGAGA-1_V10B01-087_D1,4,1,0,0,0,5
ATAAGGTGGAGAACAT-1_V10B01-087_D1,1,3,0,0,0,4
CTTTAATATTGGTCGA-1_V10B01-087_D1,0,1,0,0,0,1
TGGTTCAACGGGTAAT-1_V10B01-087_D1,4,3,0,0,0,7
GCTGCTACTGCGTAGC-1_V10B01-087_D1,1,1,0,0,0,2
CTGCACAACTACATAT-1_V10B01-087_D1,2,1,0,0,1,4
ATATTCCACATAGTGA-1_V10B01-087_D1,1,3,0,0,0,4
TGGCAAACTAAATTAC-1_V10B01-087_D1,3,1,0,0,0,4
ACCGCAATAACTGCCT-1_V10B01-087_D1,4,1,0,0,0,5
TCGCACCAGGAGGCAG-1_V10B01-087_D1,1,0,0,0,0,1
ACTTCAGGCTGATCCC-1_V10B01-087_D1,6,0,0,0,0,6
ACAAATCGCACCGAAT-1_V10B01-087_D1,1,3,0,1,0,5
TCTGATGTATTCTGTC-1_V10B01-087_D1,3,6,0,0,0,9
CTTTACCGAATAGTAG-1_V10B01-087_D1,0,1,0,0,1,2
GCAGATCCATAAGACT-1_V10B01-087_D1,2,1,0,0,0,3
TTCCTCGGACTAACCA-1_V10B01-087_D1,0,1,0,0,0,1
TTATCCGGGATCTATA-1_V10B01-087_D1,2,2,0,1,0,5
CTGGAAGACACGGTGG-1_V10B01-087_D1,1,0,0,0,0,1
GTTCGTCTAAAGAACT-1_V10B01-087_D1,3,1,0,0,0,4
GTCTATTGGTTCCGGT-1_V10B01-087_D1,11,1,0,0,0,12
CTAGGCGCCCTATCAG-1_V10B01-087_D1,2,1,0,0,0,3
AACGGACGTACGTATA-1_V10B01-087_D1,1,1,0,0,0,2
AACACACGCTCGCCGC-1_V10B01-087_D1,3,2,1,0,0,6
GCTACTATAGTAGAGT-1_V10B01-087_D1,4,0,0,0,1,5
AGCATATCAATATGCT-1_V10B01-087_D1,3,1,0,0,0,4
CGAACAGTATGGGCGT-1_V10B01-087_D1,4,0,0,0,0,4
ACAATTGTGTCTCTTT-1_V10B01-087_D1,2,0,0,0,0,2
GATCGCTACCCGATTT-1_V10B01-087_D1,2,0,0,0,0,2
ATTGCGATCAGTAACT-1_V10B01-087_D1,1,0,1,0,0,2
CAGCAGTCCAGACTAT-1_V10B01-087_D1,2,0,0,0,0,2
AGAGGCTTCGGAAACC-1_V10B01-087_D1,2,0,1,0,0,3
AAACAAGTATCTCCCA-1_V10B01-087_D1,0,0,0,0,1,1
GGCAGCAAACCTATGC-1_V10B01-087_D1,0,0,0,0,1,1
ACTAGTTGCGATCGTC-1_V10B01-087_D1,0,0,0,0,0,0
TTGGACCATCTGGCAA-1_V10B01-087_D1,2,0,0,0,1,3
CCCTCCTCGCTCGTAT-1_V10B01-087_D1,0,0,0,0,3,3
GAGCGCAAATACTCCG-1_V10B01-087_D1,0,0,0,0,0,0
ATTACATGTCAGTCTT-1_V10B01-087_D1,0,0,0,0,3,3
TTGGGACGTAAGAGTT-1_V10B01-087_D1,0,0,0,0,1,1
CTTCGGCCAATTGTTT-1_V10B01-087_D1,0,0,0,0,2,2
AGACCGCTCCGCGGTT-1_V10B01-087_D1,0,0,0,0,4,4
GACCGCGTCTGACGTG-1_V10B01-087_D1,0,0,0,0,0,0
CCAAATAACAAGATTC-1_V10B01-087_D1,0,0,0,0,3,3
CTCCCAATGAGTCGCG-1_V10B01-087_D1,10,0,0,0,1,11
CCTCAACGATCGCTGT-1_V10B01-087_D1,2,1,0,0,0,3
CGGTACGGCAAACCCA-1_V10B01-087_D1,1,1,0,0,0,2
CAGATGTTTGTCCCAA-1_V10B01-087_D1,2,0,0,0,0,2
GTTTGTTAGCCAAGTA-1_V10B01-087_D1,3,1,0,0,0,4
ACGTGACAAAGTAAGT-1_V10B01-087_D1,0,0,0,0,0,0
TTGTCACCGCGGTATC-1_V10B01-087_D1,0,2,0,0,0,2
GATCTAACCGTATTCA-1_V10B01-087_D1,2,0,0,0,0,2
ATGGAAATTTAAGGAG-1_V10B01-087_D1,2,4,1,1,0,8
ATTGATCACCACATTT-1_V10B01-087_D1,0,0,0,0,0,0
ACTGCTCGGAAGGATG-1_V10B01-087_D1,2,1,0,0,0,3
TCTAAAGAACAGTCTC-1_V10B01-087_D1,3,0,0,0,0,3
CTGGGTTGAGTTAAAG-1_V10B01-087_D1,2,1,0,0,0,3
CCCAGTAAACTTGGGA-1_V10B01-087_D1,1,1,1,0,0,3
AGATTCACAACCGATA-1_V10B01-087_D1,2,3,0,0,1,6
AGAAGGTACACTTCAC-1_V10B01-087_D1,2,1,0,0,0,3
GCAGGAACTTAGATCT-1_V10B01-087_D1,0,2,0,0,0,2
AATCTAGGTTTACTTG-1_V10B01-087_D1,2,2,1,0,0,5
CCCGGTGTATCGGAAT-1_V10B01-087_D1,1,0,0,0,0,1
TTATCCTCAAGGAATA-1_V10B01-087_D1,2,2,1,0,0,5
AGCATCATTTCGAAAG-1_V10B01-087_D1,4,2,1,0,0,7
CGCGAGTCTGCCGGGT-1_V10B01-087_D1,1,0,0,0,0,1
TGCGTCATGACTGAGC-1_V10B01-087_D1,2,0,0,0,0,2
GTATGAAATTTCACTC-1_V10B01-087_D1,0,0,0,0,0,0
TTGGTTGCGGTGCGCG-1_V10B01-087_D1,1,1,1,0,0,3
ACAGAACTGAGAACAA-1_V10B01-087_D1,1,4,0,0,0,5
CTACTATCATAGGTTT-1_V10B01-087_D1,3,1,0,0,0,4
CCTCTATCGATTAGCA-1_V10B01-087_D1,3,0,0,0,0,3
CCGTATCTCGTCGTAG-1_V10B01-087_D1,1,2,0,0,0,3
TCACGATGTCCGTGGA-1_V10B01-087_D1,0,0,0,0,0,0
TCAACAAAGATAATTC-1_V10B01-087_D1,1,1,0,0,0,2
ATGACGCGTTCTATCC-1_V10B01-087_D1,3,0,0,0,0,3
ATTTGCGCGAGTAGCT-1_V10B01-087_D1,3,1,0,0,0,4
TTCTTGGACGATCTGC-1_V10B01-087_D1,3,1,0,0,0,4
AGACGACGATGCCGCT-1_V10B01-087_D1,2,0,1,1,0,4
GGTCTCTGAATGGACT-1_V10B01-087_D1,0,1,0,0,0,1
GCTCAATCCGTTTATT-1_V10B01-087_D1,3,1,0,0,0,4
CCAGAAAGCAACTCAT-1_V10B01-087_D1,1,1,0,0,0,2
CACCGTTAGGGATCAC-1_V10B01-087_D1,1,2,0,0,0,3
AATAACACTAGAACAA-1_V10B01-087_D1,2,3,0,1,0,6
CACCCGGTTTGTGACT-1_V10B01-087_D1,1,1,0,0,0,2
CCACCAACTTTACTGT-1_V10B01-087_D1,1,0,1,0,0,2
AACTCTCAGTGTGCTC-1_V10B01-087_D1,1,1,0,0,0,2
AAACCGTTCGTCCAGG-1_V10B01-087_D1,1,0,0,0,0,1
CAGCGATTCCCTTCAA-1_V10B01-087_D1,1,0,0,0,0,1
GCTAGCTTGAATAGCT-1_V10B01-087_D1,1,0,1,0,0,2
TTGCGGCATCAGAAAG-1_V10B01-087_D1,0,0,0,0,0,0
AATAGAACAGAGTGGC-1_V10B01-087_D1,2,1,0,0,0,3
GCCATCGAGCTGCGTG-1_V10B01-087_D1,3,1,0,0,0,4
ACACTGATCAAGGTGT-1_V10B01-087_D1,5,2,0,0,0,7
ACCAACGCTTATTTAT-1_V10B01-087_D1,4,2,0,0,0,6
GACATCGATTTATAAC-1_V10B01-087_D1,1,3,0,0,0,4
CAGACACCGATCGCTG-1_V10B01-087_D1,6,1,1,0,0,8
CCAAGAAAGTGGGCGA-1_V10B01-087_D1,1,0,0,0,0,1
GGTAGACCGTTGGGCG-1_V10B01-087_D1,4,3,0,0,0,7
TCGTTAGGAGTCCCTA-1_V10B01-087_D1,3,1,0,0,0,4
ACGGCCAACATGGACT-1_V10B01-087_D1,2,0,0,0,0,2
GTGAGTGGTACAACGC-1_V10B01-087_D1,1,0,0,0,0,1
GAGACTTCGCGACCGA-1_V10B01-087_D1,1,0,0,0,0,1
GAAGTCAGTTGCACTA-1_V10B01-087_D1,0,1,0,0,0,1
GTTTGGTAGGGTCAAC-1_V10B01-087_D1,1,1,1,0,0,3
ACGGCACTTGCTTGGG-1_V10B01-087_D1,2,1,0,0,0,3
CCTCTGTACTATTCTA-1_V10B01-087_D1,0,1,0,0,0,1
CTATTCATGTGTCCCA-1_V10B01-087_D1,4,1,1,0,0,6
GCCCGATCTGTGGTCG-1_V10B01-087_D1,2,1,0,0,0,3
TTAGAAGAACATGACT-1_V10B01-087_D1,1,0,0,0,0,1
AGGATAAAGTCGGGAT-1_V10B01-087_D1,2,1,0,0,0,3
CGGCAAACATCGTGCG-1_V10B01-087_D1,4,0,0,0,0,4
CTAGTTACAACCCGGT-1_V10B01-087_D1,1,1,1,0,0,3
TTCGACAGAGCCCGTG-1_V10B01-087_D1,6,0,0,0,0,6
AAGCATACTCTCCTGA-1_V10B01-087_D1,2,2,0,0,0,4
GACGACGATCCGCGTT-1_V10B01-087_D1,2,2,2,0,0,6
GGTAGAAGACCGCCTG-1_V10B01-087_D1,5,0,0,0,0,5
GAGATGGGAGTCGACA-1_V10B01-087_D1,2,2,1,0,0,5
AACGATAATGCCGTAG-1_V10B01-087_D1,1,1,1,0,0,3
TGGTCCCACGCTACGG-1_V10B01-087_D1,4,1,0,0,0,5
CTGCTTGGCGATAGCT-1_V10B01-087_D1,3,1,0,0,0,4
ATCGGAGACAGACGGC-1_V10B01-087_D1,2,1,0,0,0,3
TAGCGTCCGGTGTGGT-1_V10B01-087_D1,2,2,0,0,0,4
GTTGAGTCCCGCCGGT-1_V10B01-087_D1,2,1,1,0,0,4
AAATAGGGTGCTATTG-1_V10B01-087_D1,6,1,1,0,0,8
AAGTGTTTGGAGACGG-1_V10B01-087_D1,2,0,0,0,0,2
AGCACTACCTCACCAG-1_V10B01-087_D1,1,1,0,0,0,2
TGCCTTGGCCAGGCAA-1_V10B01-087_D1,0,0,0,0,0,0
TCGTCTTAGGCGTTAA-1_V10B01-087_D1,4,1,0,0,0,5
TTCTGACCGGGCTCAA-1_V10B01-087_D1,3,0,0,0,0,3
CAGAACTTAGCCCTCT-1_V10B01-087_D1,1,2,0,0,0,3
AGCTCCTTCGCACATC-1_V10B01-087_D1,2,1,0,0,0,3
ACAGGCTTGCCCGACT-1_V10B01-087_D1,1,2,0,0,0,3
GCTATACGTCTCGGAC-1_V10B01-087_D1,3,0,0,0,0,3
GAGCCAGCTACCTGTG-1_V10B01-087_D1,0,2,1,0,0,3
TGCTAAGTGTCTATTT-1_V10B01-087_D1,2,1,0,0,0,3
GTCCTACGAATAGTCT-1_V10B01-087_D1,3,0,0,0,2,5
CAGTGTCGGCTGGCCC-1_V10B01-087_D1,2,1,0,0,0,3
CTATCGACGAAATACA-1_V10B01-087_D1,1,1,0,1,0,3
CATCATTACCCTGAGG-1_V10B01-087_D1,3,1,0,0,0,4
TAAGTTGCGACGTAGG-1_V10B01-087_D1,0,2,0,0,0,2
AGTGCACGCTTAAGAA-1_V10B01-087_D1,4,0,0,0,0,4
TGTGCCGGTGCCGGAA-1_V10B01-087_D1,2,0,0,0,0,2
AGGAGGCCTTCGCGCG-1_V10B01-087_D1,2,1,0,0,0,3
TCCGCGGCCCAATGAA-1_V10B01-087_D1,2,1,0,0,0,3
TCCGTTAAGCTAATAT-1_V10B01-087_D1,3,2,0,0,0,5
AAATCTAGCCCTGCTA-1_V10B01-087_D1,3,1,0,0,1,5
CGCAGGCGATCCAAAC-1_V10B01-087_D1,6,0,0,1,0,7
CCATATGGAAACTATA-1_V10B01-087_D1,3,1,0,0,0,4
CACCGTATCCCATCCG-1_V10B01-087_D1,1,0,0,0,1,2
GGTCAAGACTACTTCG-1_V10B01-087_D1,4,0,1,0,0,5
CCCGTTTCGCAGATGT-1_V10B01-087_D1,0,0,0,0,0,0
GTTATAATACGGTGAA-1_V10B01-087_D1,4,0,0,0,1,5
ACTTGTGGATGGAACG-1_V10B01-087_D1,2,0,1,0,2,5
GTTCGCTGAGACGTCT-1_V10B01-087_D1,2,1,0,0,0,3
GACACTGGAACCCGAT-1_V10B01-087_D1,0,0,0,0,0,0
CCCAGGTCTGAAGGCT-1_V10B01-087_D1,2,0,0,0,0,2
TCTCGAGGAGGTTCGC-1_V10B01-087_D1,1,0,0,0,3,4
ACTATCTGCCCGCGTA-1_V10B01-087_D1,1,0,1,0,1,3
CCTAAATTGTATCCTA-1_V10B01-087_D1,0,0,0,0,5,5
TGTGCCAGAGGCAAAG-1_V10B01-087_D1,3,2,0,0,0,5
TGGCTTATGTATAATG-1_V10B01-087_D1,2,0,0,0,0,2
GCAAGCTGGAAACCGC-1_V10B01-087_D1,2,1,0,0,0,3
GATATCAAGCAGGAGC-1_V10B01-087_D1,3,2,0,0,0,5
CACCAATCATCCGTCT-1_V10B01-087_D1,1,1,0,0,0,2
CCACATGGCTCTTTAT-1_V10B01-087_D1,0,1,0,0,0,1
GTCCTACTCTACGGGC-1_V10B01-087_D1,1,2,0,0,0,3
CTCGAGACATACGATA-1_V10B01-087_D1,2,1,0,0,0,3
TATCAGTGGCGTAGTC-1_V10B01-087_D1,3,1,0,0,0,4
TGACAGGACAAGTCCA-1_V10B01-087_D1,0,2,1,0,0,3
TATTAACACCAAAGCA-1_V10B01-087_D1,2,1,0,0,0,3
TAGGCGATGAGGTCTC-1_V10B01-087_D1,2,0,0,0,0,2
CCGCCGGAACTTCTCG-1_V10B01-087_D1,1,1,0,1,0,3
GCCATTAGCCTCAAAC-1_V10B01-087_D1,1,0,1,0,0,2
GTTAGGCTACCCGTTT-1_V10B01-087_D1,1,1,0,0,0,2
GGGTATTCTAGCAAAC-1_V10B01-087_D1,2,3,2,0,0,7
GCCCTAGCCGTCGCGA-1_V10B01-087_D1,2,0,0,0,0,2
CAGATCCTGGTTTGAA-1_V10B01-087_D1,1,1,0,0,0,2
CTTCAGTGGTCGCCTA-1_V10B01-087_D1,2,0,0,1,0,3
GGGCAACCGCACGTGC-1_V10B01-087_D1,1,2,2,0,0,5
GACCCAATTATGATAC-1_V10B01-087_D1,1,1,0,0,0,2
GAAGCTCGGACCCGTC-1_V10B01-087_D1,3,0,0,0,0,3
CGTCGGGTCTAAGCGC-1_V10B01-087_D1,0,0,0,0,0,0
GAGGCCCGACTCCGCA-1_V10B01-087_D1,0,0,0,0,0,0
TTGCCATAGCCCGCTC-1_V10B01-087_D1,0,1,0,0,0,1
TAACATACACGCGATC-1_V10B01-087_D1,2,1,1,0,0,4
CCGACGGGCATGAGGT-1_V10B01-087_D1,3,1,2,0,0,6
AATGTGCCCGAGGTGT-1_V10B01-087_D1,1,0,0,0,0,1
AGCTGTAACCTCAATC-1_V10B01-087_D1,2,0,1,0,0,3
CGAGTGAAGGTACCAG-1_V10B01-087_D1,1,0,0,0,0,1
AGTCTCACAAGACTAC-1_V10B01-087_D1,1,1,1,0,0,3
AAATTGATAGTCCTTT-1_V10B01-087_D1,5,0,0,0,0,5
TAAGTCGCCGAGTATC-1_V10B01-087_D1,0,0,0,0,0,0
GCGGAGAAACTTCGCA-1_V10B01-087_D1,4,1,0,0,0,5
GGCAAAGGCGCCAATA-1_V10B01-087_D1,2,0,1,0,0,3
ATTTCCGGGTTCTGCG-1_V10B01-087_D1,2,0,0,0,1,3
TAAACCCAGGAGGGCA-1_V10B01-087_D1,1,0,0,0,0,1
TTCGGGCGCTAGTCTT-1_V10B01-087_D1,2,2,0,0,0,4
GTGGAGTCGGCGGTTG-1_V10B01-087_D1,2,0,1,0,0,3
GCACGCCTACTTAGAT-1_V10B01-087_D1,2,0,0,0,0,2
CAATATTCTTGACCTA-1_V10B01-087_D1,1,2,0,0,0,3
CGTTTGTGTAGAGGGT-1_V10B01-087_D1,2,1,0,0,0,3
CATAGCGTTGCCCACC-1_V10B01-087_D1,3,0,0,0,0,3
TGATACATTTAGCCGT-1_V10B01-087_D1,3,0,0,0,0,3
TTCCGGCCTTGAGGCT-1_V10B01-087_D1,1,0,0,0,0,1
CCTATACCGTCCTGTC-1_V10B01-087_D1,1,0,0,0,0,1
TCGTTGCTATCCGGTC-1_V10B01-087_D1,5,1,1,0,0,7
TGGCGACTGCTCCAAA-1_V10B01-087_D1,1,0,0,1,0,2
CAGAGGCGATGCATGA-1_V10B01-087_D1,0,0,0,0,0,0
TCACAGGAGAATAAGA-1_V10B01-087_D1,2,0,0,0,0,2
GGGTTAACATTTGAGT-1_V10B01-087_D1,1,0,1,0,0,2
GCGGGCGAGCCTTACC-1_V10B01-087_D1,1,3,1,0,0,5
TGCCAATGGGTACTCT-1_V10B01-087_D1,2,1,2,0,0,5
AGGGACTCTACGCGAC-1_V10B01-087_D1,1,2,0,0,0,3
GACGCCGTAAAGGCTA-1_V10B01-087_D1,2,1,0,0,0,3
AAAGGCTCTCGCGCCG-1_V10B01-087_D1,3,0,0,0,0,3
CTGGCTGGTTGTCAGT-1_V10B01-087_D1,0,0,0,0,0,0
ACATCCCGGCCATACG-1_V10B01-087_D1,2,0,0,0,0,2
CTCTTGTCCCGCTTGG-1_V10B01-087_D1,5,1,0,0,0,6
TACGCCTCCATTCCGA-1_V10B01-087_D1,1,1,0,0,0,2
CGGAGCAATTTAATCG-1_V10B01-087_D1,4,1,1,0,0,6
AACTAGGCTTGGGTGT-1_V10B01-087_D1,1,2,0,0,0,3
GCGTCGCCAGGGTGAT-1_V10B01-087_D1,2,1,2,0,0,5
GTTGGTCATGCTATCC-1_V10B01-087_D1,1,0,0,0,0,1
GCTGGCGGCGCATGCT-1_V10B01-087_D1,3,0,0,0,0,3
TGAGCGGAAAGTGTTC-1_V10B01-087_D1,2,0,1,0,0,3
CTTTCTGTGCGGGCTT-1_V10B01-087_D1,1,1,1,0,0,3
ATCTAATATCCTACGG-1_V10B01-087_D1,3,0,0,0,0,3
AACCTTTAAATACGGT-1_V10B01-087_D1,3,0,0,0,0,3
TTCACTCGAGCACCTA-1_V10B01-087_D1,3,1,1,0,0,5
CTGCACTCCAGTACAG-1_V10B01-087_D1,1,0,1,0,0,2
CCATTTCTACCTATTA-1_V10B01-087_D1,1,1,1,0,0,3
CAAGCGGCACATAATT-1_V10B01-087_D1,2,1,0,0,0,3
GTTAACATCACTTAAA-1_V10B01-087_D1,2,1,1,0,0,4
ATATAAATGTAGCTGC-1_V10B01-087_D1,3,2,1,0,0,6
GCCTCTATACATAGCA-1_V10B01-087_D1,3,2,0,0,0,5
GTGTCGTATAGCGTTC-1_V10B01-087_D1,2,1,0,0,0,3
ATACGTACTTAGCCAC-1_V10B01-087_D1,0,1,1,0,0,2
GCTATCATACTCATGG-1_V10B01-087_D1,4,0,1,0,0,5
TATCCAATTGGTTATC-1_V10B01-087_D1,0,0,0,0,0,0
TCTCCCTGGGCAGCGT-1_V10B01-087_D1,1,0,0,0,0,1
CCTATAATGAGTGCCC-1_V10B01-087_D1,2,0,0,0,0,2
CAATGCGAGAAGTATC-1_V10B01-087_D1,2,0,0,0,0,2
TACCAATAAAGTACCA-1_V10B01-087_D1,1,1,0,0,0,2
GCTAGGCACCACGGAG-1_V10B01-087_D1,3,1,0,0,0,4
GGTGGACTGCTCTGGC-1_V10B01-087_D1,4,0,0,0,0,4
TATTCCGAGCTGTTAT-1_V10B01-087_D1,1,1,0,0,0,2
TTGAGAAGTTTAGCAT-1_V10B01-087_D1,5,1,0,0,0,6
GTCCGGACCTGAAATT-1_V10B01-087_D1,3,1,1,0,0,5
CTGTGGTCGGGAGATA-1_V10B01-087_D1,3,1,1,0,0,5
CATGTAAGAGACATTT-1_V10B01-087_D1,2,2,0,0,0,4
CACGTTTCGTACACAC-1_V10B01-087_D1,0,0,0,0,0,0
CATCCTCTCAAAGATC-1_V10B01-087_D1,0,5,0,0,0,5
GATTAACCGAAAGCCC-1_V10B01-087_D1,1,0,0,1,0,2
AACGCTGTTGCTGAAA-1_V10B01-087_D1,1,0,0,0,0,1
TTCAGCTGGCGTGCCC-1_V10B01-087_D1,3,0,0,0,0,3
TAGAGGTTCTACTTGT-1_V10B01-087_D1,1,2,0,0,0,3
GTATCAAACGTTAGCT-1_V10B01-087_D1,2,1,0,1,0,4
AATCATGTAAAGACTC-1_V10B01-087_D1,0,0,1,1,0,2
AGTCACTAGCTCTCGA-1_V10B01-087_D1,2,1,2,0,0,5
GCGAAACGATCGGGAG-1_V10B01-087_D1,1,2,0,0,0,3
CATGGATTGTCTTCCG-1_V10B01-087_D1,3,1,0,0,0,4
ATTGGATTACAGCGTA-1_V10B01-087_D1,5,2,0,1,0,8
CACACACGCTAACGAG-1_V10B01-087_D1,2,0,0,1,0,3
CTATGGGAAGCGGAAT-1_V10B01-087_D1,1,3,1,0,0,5
TGCCTAATTGAAGATT-1_V10B01-087_D1,3,2,0,0,1,6
TGGCAATGGGACGGCG-1_V10B01-087_D1,5,1,0,0,1,7
ACCTCCGCCCTCGCTG-1_V10B01-087_D1,3,4,1,0,0,8
CGGCAATAAGATCGCC-1_V10B01-087_D1,1,1,0,0,0,2
CCTTGACCACTTTATT-1_V10B01-087_D1,2,2,0,2,2,8
TCATTTAGAAGTGTGA-1_V10B01-087_D1,9,1,0,0,0,10
CAGAATAACACACGGA-1_V10B01-087_D1,0,0,0,0,0,0
TCTGAGCAATTGACTG-1_V10B01-087_D1,1,0,0,1,0,2
CACAGTTCGCTTCCCA-1_V10B01-087_D1,0,0,0,0,0,0
CATACACAAAGTCAGC-1_V10B01-087_D1,3,1,0,0,0,4
TGCCGTTCTTAATCGG-1_V10B01-087_D1,3,1,0,0,0,4
TCGAGTCTACGATTCG-1_V10B01-087_D1,2,0,0,1,0,3
ACTTCCAGTGGAAGCT-1_V10B01-087_D1,6,0,0,0,0,6
CAATTGGGCCGCACTC-1_V10B01-087_D1,2,1,0,0,0,3
AAATCGCGGAAGGAGT-1_V10B01-087_D1,2,1,0,0,0,3
ATATCAATTCCAGCCT-1_V10B01-087_D1,2,3,0,0,0,5
CTTTGTCGAATGCTCC-1_V10B01-087_D1,0,0,2,0,0,2
TGAGGCATGTACTGTG-1_V10B01-087_D1,1,0,0,0,0,1
TTCGCCGCTCGCGCTA-1_V10B01-087_D1,1,0,0,0,0,1
GACTCCTTCCAATTGA-1_V10B01-087_D1,2,0,1,1,0,4
ACCGAAGAGTCTGGTT-1_V10B01-087_D1,2,1,1,0,0,4
TGGCATGAAGTTTGGG-1_V10B01-087_D1,4,2,0,0,0,6
ACGAGGTTTACAACGT-1_V10B01-087_D1,2,2,0,0,0,4
AACCCATCCCATGATC-1_V10B01-087_D1,3,1,0,0,0,4
TCGACAACTGAACCCG-1_V10B01-087_D1,6,0,0,0,0,6
TATCTTGCAATACAAC-1_V10B01-087_D1,4,1,1,0,0,6
TATTATGTTTGCCTGC-1_V10B01-087_D1,6,1,0,0,0,7
GTCAAAGAAGTGGTGT-1_V10B01-087_D1,5,0,0,0,0,5
GGGACAGAGTTACTCC-1_V10B01-087_D1,1,1,0,0,0,2
AGCAACCGAAAGTAAT-1_V10B01-087_D1,3,3,0,0,0,6
CTCTCTAACTGCCTAG-1_V10B01-087_D1,2,0,0,0,0,2
ATACGGAACGTCGTTT-1_V10B01-087_D1,1,1,0,0,0,2
TCGGTCCCGACAATAG-1_V10B01-087_D1,1,1,0,0,0,2
CGCGCAAATGTCCAGA-1_V10B01-087_D1,2,4,1,0,0,7
TCTAATACTGCCTCAG-1_V10B01-087_D1,2,0,0,0,0,2
CTCGGTTGTCGGCCCT-1_V10B01-087_D1,2,0,0,0,0,2
GGTAACCGGGAGGATA-1_V10B01-087_D1,1,0,0,0,0,1
CAGGCGCACGGTGGTC-1_V10B01-087_D1,2,1,0,0,0,3
TCATCGATGGTCCCAA-1_V10B01-087_D1,2,0,1,0,0,3
CAAAGATTATTGGGCC-1_V10B01-087_D1,3,0,0,0,0,3
ACAATGAATACGGAGA-1_V10B01-087_D1,1,0,0,0,0,1
GCTCCTGACATACTGG-1_V10B01-087_D1,1,0,0,0,0,1
GATGACAAGTAGGGCA-1_V10B01-087_D1,4,0,1,0,0,5
TACGCCGAGGGTACCC-1_V10B01-087_D1,4,1,0,0,0,5
AAGCGTCCCTCATCGA-1_V10B01-087_D1,3,0,0,0,0,3
CACTCCTATGTAAGAT-1_V10B01-087_D1,4,1,1,0,0,6
TCGAGCCAGGCAGGCC-1_V10B01-087_D1,3,2,0,0,0,5
TCGTCAAGTACGCGCA-1_V10B01-087_D1,1,0,0,0,0,1
CCCGTAGCTGGGAAGA-1_V10B01-087_D1,2,1,0,0,0,3
ACCCTATGCCATATCG-1_V10B01-087_D1,4,0,1,0,0,5
GTGGTATAGTCTGCCG-1_V10B01-087_D1,3,0,0,0,0,3
CCGGTTTGTAATTGTG-1_V10B01-087_D1,1,3,1,0,0,5
GTCGCCGTTGTGTGTT-1_V10B01-087_D1,0,1,0,0,0,1
TACTGAACAGATTTAG-1_V10B01-087_D1,2,0,1,0,0,3
TATTAACCTGACCGCG-1_V10B01-087_D1,1,2,0,1,0,4
CTGTAGCCATCTCACT-1_V10B01-087_D1,3,1,0,0,0,4
TACTATGGTTCCTCAG-1_V10B01-087_D1,3,1,0,0,0,4
GAGTCAGACCAGAATC-1_V10B01-087_D1,5,0,0,0,0,5
TAAGGCATAACATCAA-1_V10B01-087_D1,2,0,0,0,0,2
CTTCCGCTCCGTGAAG-1_V10B01-087_D1,2,0,0,0,0,2
GGGCTATGATCGATGG-1_V10B01-087_D1,3,0,0,0,0,3
GGTCGGTCGTCCACAG-1_V10B01-087_D1,1,0,0,0,0,1
GGGACCCGTATATCTT-1_V10B01-087_D1,2,1,0,1,0,4
GAAAGCAGTGCACTTT-1_V10B01-087_D1,2,0,0,0,0,2
AGCGCATAATGAATCG-1_V10B01-087_D1,1,1,0,1,0,3
GCTGCTAAGTAGTCGA-1_V10B01-087_D1,5,0,1,0,0,6
AATAGTCCGTCCCGAC-1_V10B01-087_D1,0,0,2,0,0,2
AGCAGCCAGATGAATA-1_V10B01-087_D1,0,2,0,1,0,3
CCTCGCGCTGTGCGAT-1_V10B01-087_D1,2,0,0,0,0,2
TTGTGTATGCCACCAA-1_V10B01-087_D1,0,0,1,0,0,1
TGCTCGGCGAAACCCA-1_V10B01-087_D1,3,0,0,0,0,3
CGATTAAATATCTCCT-1_V10B01-087_D1,1,0,0,0,0,1
TGCCGTGGATCGTCCT-1_V10B01-087_D1,2,0,1,0,0,3
GTGGACGCATTTGTCC-1_V10B01-087_D1,2,0,0,0,0,2
ACCCGGAAACTCCCAG-1_V10B01-087_D1,3,0,0,0,0,3
CCGCATGTGGTACGAT-1_V10B01-087_D1,1,0,0,0,0,1
GCAAACCTTGGCCATA-1_V10B01-087_D1,5,0,0,0,0,5
ATTCACTGATGTTGGA-1_V10B01-087_D1,3,0,0,0,0,3
ACTCCCTAATGCTAAA-1_V10B01-087_D1,2,1,0,0,0,3
TCCTAAATTGGGAAGC-1_V10B01-087_D1,1,0,1,1,0,3
GAACAGATTACTAAAT-1_V10B01-087_D1,3,0,0,0,0,3
ATACAGGCCCTCCAAT-1_V10B01-087_D1,4,0,2,0,0,6
CGATTCGCCTGGCTGC-1_V10B01-087_D1,1,0,0,0,0,1
TCCGCCTGTCTACAAG-1_V10B01-087_D1,5,0,0,0,0,5
CACATCTCACCGACGA-1_V10B01-087_D1,1,0,0,0,0,1
CGTCGTCCTTCGCGAA-1_V10B01-087_D1,2,1,0,0,0,3
CGTTGAATACCGCGCT-1_V10B01-087_D1,4,4,0,0,0,8
ACCAATATGCAAGTTA-1_V10B01-087_D1,2,1,0,1,0,4
ACGGATGGTGCGGATA-1_V10B01-087_D1,3,1,0,0,0,4
CACCCTAACAAGATCT-1_V10B01-087_D1,1,0,0,0,0,1
AAGCTCTTTCATGGTG-1_V10B01-087_D1,2,2,0,0,0,4
CATGGGTATGCCTTAT-1_V10B01-087_D1,4,1,0,0,0,5
GCGCGTCATTGGTACA-1_V10B01-087_D1,1,0,0,0,0,1
TCTGAAGCACGTGGTC-1_V10B01-087_D1,2,1,0,0,0,3
AAGTTCACTCCAAGCT-1_V10B01-087_D1,2,1,0,0,0,3
TTGGACCTATAACAGT-1_V10B01-087_D1,1,3,0,0,0,4
ATCAGCCTCATGCTGC-1_V10B01-087_D1,0,0,0,0,0,0
AGTACTCTTATGCCCA-1_V10B01-087_D1,5,0,0,0,0,5
GCGCTTAAATAATTGG-1_V10B01-087_D1,3,1,0,0,0,4
TTGTGAACCTAATCCG-1_V10B01-087_D1,7,0,0,0,0,7
AGTCGTCGACCACCAA-1_V10B01-087_D1,4,1,1,0,0,6
TCCTTTAAATCCGCTT-1_V10B01-087_D1,3,0,0,0,0,3
ACTGAAACGCCGTTAG-1_V10B01-087_D1,3,1,0,0,0,4
GCACACACTGGTAGCC-1_V10B01-087_D1,1,2,0,0,0,3
TAAGGGCCTGTCCGAT-1_V10B01-087_D1,2,1,0,0,0,3
GCTAGAGTAGAGATGT-1_V10B01-087_D1,2,0,0,0,0,2
CACAGGGCCATATAGT-1_V10B01-087_D1,2,1,0,0,0,3
CCATGCCCTAGATTTC-1_V10B01-087_D1,2,0,1,0,0,3
TCGCGTAGCAGTGTCC-1_V10B01-087_D1,0,1,0,0,0,1
GACGAGGCTAATAAAC-1_V10B01-087_D1,3,0,0,0,0,3
CTACACTCGCAGATGG-1_V10B01-087_D1,2,0,0,0,0,2
ACGCATACGTTTACTA-1_V10B01-087_D1,2,3,1,0,0,6
GGAGCAACATTTCAAG-1_V10B01-087_D1,1,2,2,1,0,6
CGAGAGGGTAGCCGCG-1_V10B01-087_D1,1,1,0,0,0,2
TCGTGTTCGACCACAA-1_V10B01-087_D1,1,1,0,0,0,2
TCTACCCAATAGAGAG-1_V10B01-087_D1,4,0,1,0,0,5
ATAAACGTTGCACCAC-1_V10B01-087_D1,4,2,0,2,0,8
TCAACTGCAGAGTCAG-1_V10B01-087_D1,2,6,0,1,0,9
GTAACATCTAAGATAA-1_V10B01-087_D1,0,0,0,0,0,0
ATTTGGAGATTGCGGT-1_V10B01-087_D1,2,2,0,0,0,4
AAGGGTTTGATTTCAG-1_V10B01-087_D1,1,2,1,0,0,4
CCGGCCGCGAGCATAT-1_V10B01-087_D1,2,0,1,0,0,3
GAGTTCTGTGGGTGCT-1_V10B01-087_D1,1,0,0,0,0,1
AAACGAAGATGGAGTA-1_V10B01-087_D1,0,0,0,0,0,0
AATTACGAGACCCATC-1_V10B01-087_D1,0,0,0,0,0,0
CCTTTGAATTATGGCT-1_V10B01-087_D1,1,2,2,0,0,5
CATGGTATTAGTTTGT-1_V10B01-087_D1,2,0,0,1,0,3
AACGAAAGTCGTCCCA-1_V10B01-087_D1,3,0,0,0,0,3
ACATAAGTCGTGGTGA-1_V10B01-087_D1,3,0,0,0,0,3
GCACAACCTCGGGCGT-1_V10B01-087_D1,2,0,0,0,0,2
ATGCACGCGCTGTTCA-1_V10B01-087_D1,3,2,0,0,0,5
CGATGTTGTTATCTAC-1_V10B01-087_D1,0,0,0,0,0,0
GTCTCCTGCCAGTATG-1_V10B01-087_D1,3,1,3,0,0,7
GATGCCTTCTGCGGCA-1_V10B01-087_D1,0,1,0,0,0,1
ACCGGTCAGGTACACC-1_V10B01-087_D1,2,1,1,0,0,4
GTGGAGCGTTTACCGA-1_V10B01-087_D1,3,1,1,0,0,5
AGGCGGTTTGTCCCGC-1_V10B01-087_D1,0,3,0,0,0,3
TCCCTGGCGTATTAAC-1_V10B01-087_D1,1,0,0,0,0,1
AAACACCAATAACTGC-1_V10B01-087_D1,5,1,0,0,0,6
TGGACGCAATCCAGCC-1_V10B01-087_D1,1,2,0,0,0,3
GGAACCTTGACTCTGC-1_V10B01-087_D1,1,1,0,1,0,3
GTATCTCAGTCTTGAC-1_V10B01-087_D1,2,1,1,0,0,4
GCTGAATCTTCCAATC-1_V10B01-087_D1,0,3,0,0,0,3
AGATGCAAGACGTGCA-1_V10B01-087_D1,3,0,1,0,0,4
TTAAGGCCCGTACTTT-1_V10B01-087_D1,4,0,2,0,0,6
AGTATGCTGGAGACCA-1_V10B01-087_D1,0,0,0,0,0,0
GCGGCAAAGTATTGCC-1_V10B01-087_D1,4,0,0,0,0,4
GCGCAAATATATTCAA-1_V10B01-087_D1,1,0,0,0,0,1
GAAGAAACGATATTGT-1_V10B01-087_D1,4,0,0,0,0,4
GGACCTCTAGGCCGCC-1_V10B01-087_D1,3,1,0,0,0,4
AACAGCTGTGTGGCAA-1_V10B01-087_D1,1,0,0,0,0,1
TCGAATATCCCGCAGG-1_V10B01-087_D1,4,1,0,0,0,5
GCGACCCAACCATCTG-1_V10B01-087_D1,0,0,0,0,0,0
AGAGAAGGAGTACAAT-1_V10B01-087_D1,3,0,0,0,0,3
GGCTCCTCCACCTGTT-1_V10B01-087_D1,0,2,1,0,0,3
TCAGTGTATACGTCAT-1_V10B01-087_D1,2,0,0,0,0,2
ATTATTATGTCCGTCA-1_V10B01-087_D1,3,1,1,1,0,6
TTAGGTCATAACCGAC-1_V10B01-087_D1,1,1,0,0,0,2
AAGATGGCACCGGACC-1_V10B01-087_D1,1,1,1,0,0,3
CTACAAGAAATAACCC-1_V10B01-087_D1,0,2,0,0,0,2
ACTATTTCCGGGCCCA-1_V10B01-087_D1,3,1,0,0,0,4
TTGTTTCACATCCAGG-1_V10B01-087_D1,5,2,0,0,0,7
CGCTGTGTGGATGTTG-1_V10B01-087_D1,1,1,0,0,0,2
TCAACATAGCGCCCTA-1_V10B01-087_D1,2,3,1,0,0,6
GGCCGTTTGGGTTTCA-1_V10B01-087_D1,3,1,0,0,0,4
TACTCTTTCGTCTTCA-1_V10B01-087_D1,2,2,1,1,0,6
TTCGCGCGCCATACGA-1_V10B01-087_D1,2,0,0,0,0,2
CGGAAAGAATCAAACG-1_V10B01-087_D1,3,0,2,0,0,5
AGGCAGGGAGCGTACT-1_V10B01-087_D1,2,0,0,0,0,2
CCTTTAAGGGAGCACT-1_V10B01-087_D1,1,0,0,0,0,1
CGCCCAGCACGCCTAG-1_V10B01-087_D1,1,1,1,0,0,3
AGTATTTGGCACGACC-1_V10B01-087_D1,0,1,1,0,0,2
TATCCGCACCGTCGGG-1_V10B01-087_D1,2,0,0,1,0,3
ACCCGTGTCATCAGTA-1_V10B01-087_D1,2,0,0,0,0,2
CAACTGCTCATCCGAT-1_V10B01-087_D1,5,1,0,0,0,6
CCGGAGCGTACTTTCT-1_V10B01-087_D1,2,0,0,0,0,2
TACCGTAGGTTAACTA-1_V10B01-087_D1,0,0,0,0,0,0
TGAGGAGTGCCAGCTT-1_V10B01-087_D1,0,0,2,0,0,2
CCAGTCTTGTCATAGA-1_V10B01-087_D1,3,0,0,0,0,3
GGGCAGAGCAATCGTT-1_V10B01-087_D1,2,0,0,0,0,2
TACCAAATAGCCCAGA-1_V10B01-087_D1,5,0,1,0,0,6
TACCTACTCCCAGTAT-1_V10B01-087_D1,4,1,0,0,0,5
TGTGAGACTAGCCCAA-1_V10B01-087_D1,2,0,0,0,0,2
ATACCTAACCAAGAAA-1_V10B01-087_D1,4,0,1,0,0,5
GTCGGGAAGCAGAAAC-1_V10B01-087_D1,6,2,0,0,0,8
AATTAACGGATTTCCA-1_V10B01-087_D1,1,0,0,0,0,1
GAACCCTCTGTGTTCT-1_V10B01-087_D1,3,0,0,1,0,4
ATATAAAGCGCTCGTG-1_V10B01-087_D1,3,2,0,0,0,5
CCTGGTCGAATGTGGG-1_V10B01-087_D1,5,1,1,0,0,7
CTAGGTTCGGACGTGA-1_V10B01-087_D1,5,0,0,0,0,5
TCGGGAGACAGCGTAC-1_V10B01-087_D1,3,0,1,0,0,4
CATAAGAAGCTTGGCT-1_V10B01-087_D1,3,1,0,0,0,4
AAGCACCCTGCGTATC-1_V10B01-087_D1,3,1,1,1,0,6
AGTTTGCACCTGCCTC-1_V10B01-087_D1,3,1,1,1,0,6
GACTGCAAATCGAGCT-1_V10B01-087_D1,2,0,2,0,0,4
GTGTATATCAGCGGGC-1_V10B01-087_D1,3,1,1,0,0,5
CTTCAACTCCACTTGG-1_V10B01-087_D1,0,0,0,0,0,0
ACTTACGCATCCACGC-1_V10B01-087_D1,3,0,0,0,0,3
CATGAGATGCACTCTC-1_V10B01-087_D1,2,0,3,0,0,5
GAGCACCTGTGTCCAG-1_V10B01-087_D1,4,0,0,0,0,4
CGCGACCGCGACAGAT-1_V10B01-087_D1,3,2,1,0,0,6
GTCCCGCGACGTTATG-1_V10B01-087_D1,2,0,2,0,0,4
GCAGTGTGGCTATAGG-1_V10B01-087_D1,5,1,0,0,0,6
ATACTGCCTTACACCG-1_V10B01-087_D1,2,1,1,0,0,4
TACAGAAACGGTGGGC-1_V10B01-087_D1,3,2,1,0,0,6
GGCGCGGAGATCTTTC-1_V10B01-087_D1,4,0,0,0,0,4
CGTTAATGTCCCGACG-1_V10B01-087_D1,1,0,1,0,0,2
GCTAACTGAAGTCTGA-1_V10B01-087_D1,3,2,0,0,0,5
AGTGATAACCTGCGCG-1_V10B01-087_D1,2,0,1,0,0,3
TATGATCTTCTCTTTA-1_V10B01-087_D1,4,0,2,1,0,7
TGTACCTACACGAGGG-1_V10B01-087_D1,0,2,0,0,0,2
ATATCGTTCCTCGAAC-1_V10B01-087_D1,1,1,0,0,0,2
CGGCGCCATCAATCCC-1_V10B01-087_D1,2,1,3,0,0,6
CCTGTTTGAAGACACG-1_V10B01-087_D1,2,1,0,3,0,6
GCCACTCAGAGCGCGA-1_V10B01-087_D1,3,0,1,0,0,4
TCGGCTTGTATCGACG-1_V10B01-087_D1,2,1,0,1,0,4
TAGATGGTTCCTTACT-1_V10B01-087_D1,3,1,0,0,0,4
ATCGTTAGCTAGCGGA-1_V10B01-087_D1,4,0,0,0,0,4
ACAGCGACATTCTCAT-1_V10B01-087_D1,1,1,1,0,1,4
ATTCAACCATTTAAGG-1_V10B01-087_D1,1,1,0,0,0,2
CACTCTTCTGCTAGCC-1_V10B01-087_D1,4,0,1,0,0,5
CTAACTGATAATCGCC-1_V10B01-087_D1,4,0,0,0,0,4
TGATGTCAATTAAGTG-1_V10B01-087_D1,2,0,1,0,0,3
CGCCGTTCAGCATAGT-1_V10B01-087_D1,2,1,0,0,0,3
ATACTACCCGTACCAC-1_V10B01-087_D1,0,1,0,0,0,1
CCACTGTTTGGATTAA-1_V10B01-087_D1,2,0,0,0,0,2
CACTACGGGAGCTGCC-1_V10B01-087_D1,1,0,0,2,0,3
GACCAAACGTTGACTG-1_V10B01-087_D1,1,1,0,0,0,2
ATTCCCGAAGGTACAG-1_V10B01-087_D1,2,1,0,0,0,3
CTAACAGCACAATAAC-1_V10B01-087_D1,4,1,1,0,0,6
TTGTGCGGAAGCGGAT-1_V10B01-087_D1,3,0,0,0,0,3
GGGCACTATTGACCAT-1_V10B01-087_D1,1,1,0,0,0,2
CCATAGAGGCTGCCAG-1_V10B01-087_D1,3,2,0,0,0,5
CCGAAGCATTGACCAA-1_V10B01-087_D1,0,0,0,0,0,0
TACTGAGGGAAGAAAG-1_V10B01-087_D1,1,1,0,0,0,2
TATGTAGAAACCCGGC-1_V10B01-087_D1,2,1,1,0,0,4
TGGTTAACTTACATTT-1_V10B01-087_D1,0,0,0,1,0,1
AGAACCCTCAATTGGG-1_V10B01-087_D1,3,1,0,0,0,4
CCTATATCGTGTCACG-1_V10B01-087_D1,1,1,1,0,0,3
ACGGCTGGATGTAGAA-1_V10B01-087_D1,7,1,0,0,0,8
CTCGCATTGCATAGCC-1_V10B01-087_D1,1,1,0,0,0,2
ACTTTGGTCGTGCTCC-1_V10B01-087_D1,3,0,0,0,0,3
GCTGGTTTAGGCCATA-1_V10B01-087_D1,10,1,0,0,0,11
TGTCGTTATCACATAT-1_V10B01-087_D1,2,0,0,0,0,2
ACACATGATCAAATCT-1_V10B01-087_D1,0,0,0,0,0,0
TATCCATCTCGGTTAG-1_V10B01-087_D1,1,2,1,0,0,4
CTCGTCGAGGGCTCAT-1_V10B01-087_D1,1,0,0,0,0,1
ATCAATGCCGTGGCTG-1_V10B01-087_D1,4,3,0,0,0,7
GAAACATAGGAAACAG-1_V10B01-087_D1,2,2,0,1,0,5
TAATAGGTCACCAGAA-1_V10B01-087_D1,3,2,1,0,0,6
CACCAGTCAGCATGCA-1_V10B01-087_D1,4,0,0,0,0,4
GAGCGCTGTTAGGTAA-1_V10B01-087_D1,1,0,0,0,0,1
CCCTATGTAGAGCAGA-1_V10B01-087_D1,0,0,0,0,0,0
GATCGCTATATCTCAG-1_V10B01-087_D1,3,1,1,0,0,5
AAGGGACTATGCATTC-1_V10B01-087_D1,2,1,0,0,0,3
CTCGGGTTCTCTGGCC-1_V10B01-087_D1,2,0,0,0,0,2
TATATATCGAGAAATG-1_V10B01-087_D1,1,0,0,0,0,1
ACCCGAGCGAAATTAC-1_V10B01-087_D1,3,1,0,0,0,4
TTGTTTCATTAGTCTA-1_V10B01-087_D1,0,1,0,0,0,1
ATGGGACCTGCTGAAC-1_V10B01-087_D1,2,0,0,0,0,2
TGCGACGGCCGAACGT-1_V10B01-087_D1,1,1,0,0,0,2
AGCTAACAAGCAATGT-1_V10B01-087_D1,1,0,1,0,0,2
CGTGTCTCGTTACGAC-1_V10B01-087_D1,3,0,0,1,0,4
CTAAATCCGGTGTACA-1_V10B01-087_D1,3,1,0,0,0,4
GAATAGTGCTCGATTA-1_V10B01-087_D1,0,0,1,0,0,1
AACAATACATTGTCGA-1_V10B01-087_D1,2,0,0,0,0,2
CACATCGTGCACGCGC-1_V10B01-087_D1,3,0,0,0,0,3
ACCGTGACCACGTGGG-1_V10B01-087_D1,3,0,0,0,0,3
CCCAATGAGATTTGCA-1_V10B01-087_D1,1,1,0,0,0,2
TCAGCAGTAGGCCCTG-1_V10B01-087_D1,1,1,0,0,0,2
CTACTCAAGGTATAGT-1_V10B01-087_D1,2,1,0,0,0,3
TAGTAGCTTATACCAG-1_V10B01-087_D1,2,1,1,0,0,4
ACGTTCGTTCAGGAAA-1_V10B01-087_D1,3,0,1,0,0,4
TTAGAATAAGGGTCGG-1_V10B01-087_D1,13,0,0,0,0,13
TTCTAGAAAGTCTTAT-1_V10B01-087_D1,2,1,1,0,0,4
CCTTCAGTTAAAGTGA-1_V10B01-087_D1,2,1,1,0,0,4
TAGCTAGTGATGATGG-1_V10B01-087_D1,4,1,1,0,0,6
AGCCCGGTAGCCTGTA-1_V10B01-087_D1,0,0,1,0,0,1
TACCTCAGTTGTCTGT-1_V10B01-087_D1,0,1,0,0,0,1
GACGGGTTGGCCCGTA-1_V10B01-087_D1,0,1,1,0,0,2
GAAACCTATACAAATG-1_V10B01-087_D1,5,0,1,0,0,6
TCCACCTCTAGCCTTT-1_V10B01-087_D1,2,0,1,0,0,3
AAGACCCAACTGAACA-1_V10B01-087_D1,1,0,0,0,0,1
CATACACGGTTCCCAC-1_V10B01-087_D1,3,0,0,0,0,3
ACTACGCGTTAGAATT-1_V10B01-087_D1,2,3,0,0,0,5
CTTGGCCAAGCTGGGA-1_V10B01-087_D1,0,2,0,0,0,2
TTACCCTAGGGATTGG-1_V10B01-087_D1,3,2,1,0,0,6
TTCGCACTGTACGACA-1_V10B01-087_D1,2,1,0,0,0,3
TAGGTGTTCCACAGAT-1_V10B01-087_D1,6,0,1,1,0,8
GAAGCCTGCACATTCC-1_V10B01-087_D1,2,1,0,0,0,3
GGCTTTCAATAAGGGT-1_V10B01-087_D1,2,0,0,0,1,3
TCCAGGGTATATACGA-1_V10B01-087_D1,4,1,0,0,0,5
CTCGCCGAATGTAGGG-1_V10B01-087_D1,1,0,0,0,0,1
AGGAAGCTGTCCGCCG-1_V10B01-087_D1,2,0,0,0,0,2
GTCTCAAGGCCCGGCT-1_V10B01-087_D1,5,1,0,1,0,7
ACCGACACATCTCCCA-1_V10B01-087_D1,3,0,0,0,0,3
TATACGCGTCATCACT-1_V10B01-087_D1,4,2,0,0,0,6
ATCTGGGCTGTTCTTG-1_V10B01-087_D1,2,2,2,0,0,6
TCAAATTTGAGACTCA-1_V10B01-087_D1,2,1,0,0,0,3
GTTAAGGGTGCGATGT-1_V10B01-087_D1,3,1,0,0,0,4
AGCAAAGGCCGCTAGT-1_V10B01-087_D1,2,0,0,0,0,2
TTATAGGTAATTGTCT-1_V10B01-087_D1,1,0,0,0,0,1
TTGTGCAGCCACGTCA-1_V10B01-087_D1,1,1,0,0,0,2
ACGGACTCTCAAAGCG-1_V10B01-087_D1,2,0,0,0,0,2
ATGCTCTGGCGCGGTA-1_V10B01-087_D1,4,0,0,0,0,4
ATAATCTTGGAGAACC-1_V10B01-087_D1,1,2,0,0,0,3
CTCATTGCTCTAACAA-1_V10B01-087_D1,3,2,0,0,0,5
TAGGTGACGATAACCT-1_V10B01-087_D1,1,0,0,0,0,1
CGGATCCTCAAGGACT-1_V10B01-087_D1,1,1,0,0,0,2
GGGCGTGGTTTCCCAG-1_V10B01-087_D1,2,1,1,0,0,4
TGGCTATGTGACATAC-1_V10B01-087_D1,0,1,1,0,0,2
CTTAGTGTAGTAGCAT-1_V10B01-087_D1,5,0,3,1,0,9
GGATTGCTGTGACTCC-1_V10B01-087_D1,1,1,0,0,0,2
ACTTCCATGCGGGACA-1_V10B01-087_D1,2,1,0,0,0,3
ACTCAAGTGCAAGGCT-1_V10B01-087_D1,5,0,0,0,0,5
ACAAGGATGCTTTAGG-1_V10B01-087_D1,1,0,0,0,0,1
TTGAACGACGTGCTGA-1_V10B01-087_D1,4,0,1,0,0,5
ATTCATCGTTGAGGCA-1_V10B01-087_D1,4,1,0,0,0,5
TGCAACCCATCTGCGG-1_V10B01-087_D1,1,0,1,0,0,2
AGTGCTAAACACAGCA-1_V10B01-087_D1,3,1,0,0,0,4
AACTCCAGAGCGTGTT-1_V10B01-087_D1,1,1,2,0,0,4
TCTCCACAAGTTGAAT-1_V10B01-087_D1,4,2,1,0,0,7
CTTTGCATCGCTCTTG-1_V10B01-087_D1,2,1,0,0,0,3
TCACAAACCGAGGTAC-1_V10B01-087_D1,1,0,0,0,0,1
CCGTAGGAAATCCCTG-1_V10B01-087_D1,1,1,1,0,0,3
AAACATTTCCCGGATT-1_V10B01-087_D1,4,1,0,1,0,6
GCCTCCGACAATTCAC-1_V10B01-087_D1,2,2,1,0,0,5
TCTGCATACCTTGCTT-1_V10B01-087_D1,1,0,0,0,0,1
ACCCATTTGTCCCTCT-1_V10B01-087_D1,3,0,2,0,0,5
CTGCAGAGAATCAGAG-1_V10B01-087_D1,5,0,0,0,0,5
GGAAACTAAATGGGCC-1_V10B01-087_D1,1,0,0,0,0,1
CAACCTACCGAGCAGT-1_V10B01-087_D1,1,0,0,0,0,1
CCGTAGGGTTGTTTAC-1_V10B01-087_D1,2,0,2,0,0,4
GGTTTGTGACCTGAGG-1_V10B01-087_D1,0,2,0,0,0,2
TAACCTAGGGAGTCCA-1_V10B01-087_D1,1,3,1,0,0,5
TTCCATCGACAGCGTG-1_V10B01-087_D1,3,0,0,0,0,3
ATCTCCCACGGAATAT-1_V10B01-087_D1,0,0,0,0,0,0
AAACATGGTGAGAGGA-1_V10B01-087_D1,2,2,0,0,0,4
ATCATTGTACCGCATT-1_V10B01-087_D1,2,0,1,0,0,3
TCAGCTTGAGCTTTCG-1_V10B01-087_D1,4,2,1,0,0,7
CCGCGCAAGATACCCA-1_V10B01-087_D1,4,0,0,0,0,4
CTATACTTAAAGCGAG-1_V10B01-087_D1,5,1,0,0,0,6
ACCGTCCACTGGGCCC-1_V10B01-087_D1,1,0,0,0,0,1
AAGACCAAATAACTCA-1_V10B01-087_D1,2,1,0,0,0,3
TGTTTCTGAAGCGTGC-1_V10B01-087_D1,3,2,1,0,0,6
TTCTCTTACAGGTGAT-1_V10B01-087_D1,1,0,0,0,0,1
AATTCATTGTCATGCA-1_V10B01-087_D1,3,0,0,0,0,3
GCCCGAGAGTCTAAAT-1_V10B01-087_D1,2,1,0,0,0,3
ATATAGAGTATTGGTC-1_V10B01-087_D1,3,0,0,0,0,3
TTGAAGGATGGGCGCC-1_V10B01-087_D1,2,1,0,0,0,3
TAGTACCACAACTTTC-1_V10B01-087_D1,3,0,1,0,0,4
ATCCCATCCACAGCGC-1_V10B01-087_D1,1,1,0,1,0,3
CTTAGGTATAGACCAG-1_V10B01-087_D1,2,0,1,0,0,3
TGACTCCGAATCATAC-1_V10B01-087_D1,1,0,0,0,0,1
ACTACATCCCGACAAG-1_V10B01-087_D1,2,0,0,0,0,2
TTGCCGCAGACCTACA-1_V10B01-087_D1,2,0,0,0,0,2
TAAGAGGGACAGGGAC-1_V10B01-087_D1,1,0,0,0,0,1
CGAATGAAGTCATTGC-1_V10B01-087_D1,2,0,0,0,0,2
AAGGGAACGACTGGCT-1_V10B01-087_D1,2,1,0,0,0,3
CGAATCTGCTCGACGC-1_V10B01-087_D1,0,0,0,0,0,0
ATCGTGGAAAGTCTGG-1_V10B01-087_D1,0,0,0,0,0,0
CCTATGGCTCCTAGTG-1_V10B01-087_D1,0,1,1,0,0,2
CGTCGCTTGGTTATAC-1_V10B01-087_D1,4,0,0,0,0,4
TGCTTAGAGAGAATGC-1_V10B01-087_D1,0,1,0,1,0,2
GATTGCTCCAGTTGCA-1_V10B01-087_D1,5,1,0,0,0,6
CGTGCTTCTACCTAAA-1_V10B01-087_D1,0,0,0,0,0,0
ACTCCAATATCATCAT-1_V10B01-087_D1,2,1,0,0,0,3
GCCGACCCACGACTGC-1_V10B01-087_D1,1,1,0,0,0,2
GAGGGTAGTAACAAAG-1_V10B01-087_D1,2,1,0,0,0,3
GGCCGAGACTCTGGTG-1_V10B01-087_D1,1,2,0,0,0,3
TATATAGGGCTTTACG-1_V10B01-087_D1,9,0,0,0,0,9
TGCCGGATGTACGAGC-1_V10B01-087_D1,2,0,0,0,0,2
AGGTAGATCGAGATAT-1_V10B01-087_D1,4,0,0,0,0,4
GATCAACATAAAGGGA-1_V10B01-087_D1,1,0,1,0,0,2
TAACAGCGTTTGTGCT-1_V10B01-087_D1,0,0,0,0,0,0
CTATAGGCGTTGATGT-1_V10B01-087_D1,5,0,2,0,0,7
GGTTTAATTACCATCG-1_V10B01-087_D1,1,0,0,0,0,1
CTCTTCTGGAAGTTAG-1_V10B01-087_D1,1,0,0,0,0,1
ATCTGACATGGAAGGA-1_V10B01-087_D1,1,0,1,0,0,2
TACGTACTAGTGCTGA-1_V10B01-087_D1,0,1,1,0,0,2
ATGACTATCAGCTGTG-1_V10B01-087_D1,2,0,0,1,0,3
CTTTGGGATTGTTGCA-1_V10B01-087_D1,2,0,0,0,0,2
AGACTGTTACCGGGTC-1_V10B01-087_D1,3,0,1,0,0,4
TCCTAACCGTCGGGCA-1_V10B01-087_D1,4,0,0,0,0,4
ACGCAAACTAATAGAT-1_V10B01-087_D1,2,0,0,0,0,2
AAGTGAGTCGGGTTTA-1_V10B01-087_D1,0,1,1,0,0,2
TAAAGCGGTATTTCCA-1_V10B01-087_D1,1,0,0,0,0,1
CTCCTCCAGCTCACAC-1_V10B01-087_D1,6,0,1,0,1,8
CGGTCCGTCGCAAGCC-1_V10B01-087_D1,5,1,0,0,0,6
CCTATATTTGTCCTGG-1_V10B01-087_D1,0,0,0,0,0,0
TCCAATAAAGGCTACC-1_V10B01-087_D1,2,1,0,0,0,3
AAAGGCTACGGACCAT-1_V10B01-087_D1,4,1,0,0,0,5
CGTGACCAGTCCTCTG-1_V10B01-087_D1,2,2,1,0,0,5
GATCTGCTATCTAAGG-1_V10B01-087_D1,3,0,1,0,0,4
CGAATGACGCATAATG-1_V10B01-087_D1,2,1,1,0,0,4
GCTCAATGTAATACCG-1_V10B01-087_D1,4,1,1,0,0,6
CTATGCCCGAATGCAA-1_V10B01-087_D1,2,0,1,0,0,3
CACAGGGCCGTTGTCA-1_V10B01-087_D1,1,1,1,0,0,3
TCAATACGCCGTCATG-1_V10B01-087_D1,1,1,1,0,0,3
AGCGGACACTTCGTAG-1_V10B01-087_D1,3,0,1,0,0,4
ATACGTTATGCACGGA-1_V10B01-087_D1,2,0,1,0,0,3
GAGTAGATACTAGTTG-1_V10B01-087_D1,2,0,1,0,0,3
CCAGCTCGAACGCATT-1_V10B01-087_D1,3,0,1,1,0,5
TGCTTCCCAAGCAGTA-1_V10B01-087_D1,5,0,0,0,0,5
GTAGACACGCCTGACT-1_V10B01-087_D1,5,1,2,1,0,9
CTCACATTTACTAAAT-1_V10B01-087_D1,0,1,0,0,0,1
GAATGCGAATCGGTTC-1_V10B01-087_D1,1,0,0,2,0,3
TAAGGCCCGTCACCCT-1_V10B01-087_D1,2,0,1,0,0,3
GAGTATGCGCGTGCAT-1_V10B01-087_D1,3,0,0,0,0,3
ATCCACATCGACAGAA-1_V10B01-087_D1,2,2,0,0,0,4
TAGACGAAACGCCAAT-1_V10B01-087_D1,2,0,0,1,1,4
CAGCAGTCTGTGCTGC-1_V10B01-087_D1,0,0,0,0,0,0
CTCACTGTGATACTTA-1_V10B01-087_D1,8,0,1,0,0,9
TTAATTGCTTTGGGTG-1_V10B01-087_D1,3,1,2,0,0,6
GTAGTCTACGATATTG-1_V10B01-087_D1,3,1,0,0,0,4
TTGCCGCTTTCTAGTA-1_V10B01-087_D1,3,0,0,0,0,3
GAACCTTTAACGATCC-1_V10B01-087_D1,2,1,0,0,0,3
TGGACCAATCTAAGAT-1_V10B01-087_D1,0,0,0,0,0,0
CTAGTAGAAAGGGATT-1_V10B01-087_D1,1,0,1,1,0,3
AACCTCGCTTTAGCCC-1_V10B01-087_D1,7,2,0,0,0,9
GAGTGTCAACCAGAAA-1_V10B01-087_D1,3,1,1,0,0,5
GTGATCCTTGTCATGA-1_V10B01-087_D1,0,0,0,0,0,0
CTCAACTAACCCGGAT-1_V10B01-087_D1,7,0,2,0,0,9
AGTGGCGTCTGAAGGT-1_V10B01-087_D1,1,0,0,0,0,1
GGGAAGGGCTTTCTCA-1_V10B01-087_D1,3,1,0,0,0,4
AGGCCTGAGAATCTCG-1_V10B01-087_D1,4,0,0,2,0,6
AGCCACAGGTTACCCG-1_V10B01-087_D1,2,0,2,0,0,4
TGCAATCTAACACGGT-1_V10B01-087_D1,3,1,0,0,0,4
GTTTGGGTTTCGCCCG-1_V10B01-087_D1,4,2,0,0,0,6
CCTATGTCCACTCCAC-1_V10B01-087_D1,7,0,0,0,0,7
CTGCCTTTCTAGTAAA-1_V10B01-087_D1,2,0,0,0,0,2
TTAGTAAACCTGCTCT-1_V10B01-087_D1,3,3,1,0,0,7
TTGTGGTGGTACTAAG-1_V10B01-087_D1,1,0,2,0,0,3
CCTCCTGTTGTGTCGT-1_V10B01-087_D1,4,0,0,0,0,4
ACAAAGCATGACCTAG-1_V10B01-087_D1,3,3,0,0,0,6
ATAGCAACTAGGGAAG-1_V10B01-087_D1,0,2,3,0,0,5
CCGCTCTTCCGAACTA-1_V10B01-087_D1,2,2,0,0,0,4
TAGAATAGCCGATGAA-1_V10B01-087_D1,0,2,0,0,0,2
GGTCTCCGTCCAGGTT-1_V10B01-087_D1,0,2,0,0,0,2
TAATTACGTCAGTAGA-1_V10B01-087_D1,0,3,0,0,0,3
TACGTAAAGCGGAGTG-1_V10B01-087_D1,1,0,0,1,0,2
GCTACAATCGAGGATA-1_V10B01-087_D1,5,3,2,0,0,10
TCAGCCAATCCGTAAA-1_V10B01-087_D1,2,0,0,0,0,2
ATCATAGCCCTATGTA-1_V10B01-087_D1,1,0,0,1,0,2
GAGGCCTGTTGATACA-1_V10B01-087_D1,0,0,1,3,0,4
ATATACGCTCGTGACG-1_V10B01-087_D1,0,0,1,1,0,2
CCCTTTAATGGAGTTC-1_V10B01-087_D1,1,0,0,0,0,1
GGACAAGCCATGATCG-1_V10B01-087_D1,3,1,0,0,0,4
TCCAATGCGTCGCCGC-1_V10B01-087_D1,1,1,1,0,0,3
AAAGAATGACCTTAGA-1_V10B01-087_D1,5,0,0,0,0,5
CCTATTATTCCGGCCG-1_V10B01-087_D1,1,0,0,0,0,1
CAGTAAGGGACGTCTC-1_V10B01-087_D1,3,0,1,0,0,4
GGGATGGACCCGCGTC-1_V10B01-087_D1,1,1,0,0,0,2
GACGCATACCCGTCGG-1_V10B01-087_D1,4,1,0,1,0,6
GGGCAGGATTTCTGTG-1_V10B01-087_D1,0,0,1,0,0,1
TATCTGAGCCGATATT-1_V10B01-087_D1,0,0,0,0,0,0
AATGTATGGCACTGTA-1_V10B01-087_D1,1,1,0,0,0,2
GCCTTTGTCAGTGGAC-1_V10B01-087_D1,1,1,0,0,0,2
AACCATAGGGTTGAAC-1_V10B01-087_D1,5,0,0,0,0,5
AAACTTAATTGCACGC-1_V10B01-087_D1,6,0,0,0,0,6
TAGGCGGCTGCAAAGA-1_V10B01-087_D1,0,1,0,0,0,1
TCCATCAATACTAATC-1_V10B01-087_D1,0,1,0,0,0,1
ACCTCGAACTTATGCT-1_V10B01-087_D1,1,2,1,0,0,4
ACAAACCATGCGTCCT-1_V10B01-087_D1,3,0,0,0,0,3
ACACCGGTCTGACCGC-1_V10B01-087_D1,6,0,0,0,0,6
ATGGCAGCATTACGAT-1_V10B01-087_D1,4,0,0,0,0,4
CTGGTGAATGGGCCTA-1_V10B01-087_D1,1,0,0,0,0,1
CACAGAGACGAGGACG-1_V10B01-087_D1,1,1,1,0,0,3
GCACAAACCCTAGATG-1_V10B01-087_D1,3,1,0,0,0,4
ACTATGTCCAGCTGCC-1_V10B01-087_D1,2,1,1,0,0,4
AAGCCGCCGTGAAATC-1_V10B01-087_D1,4,0,0,0,0,4
ATGGGTGTATACCTCC-1_V10B01-087_D1,2,0,0,0,0,2
TAAGCGCGAATCAAAT-1_V10B01-087_D1,1,0,0,0,0,1
AGCCCGGCATTAGAGG-1_V10B01-087_D1,4,2,0,0,0,6
GTGATCAAGCGTGCAC-1_V10B01-087_D1,2,0,0,0,0,2
CTGCCTTTAATACCTT-1_V10B01-087_D1,2,0,0,0,0,2
TACCTCCACACCAATG-1_V10B01-087_D1,1,0,0,0,0,1
GAGCATCAACAACTTG-1_V10B01-087_D1,2,0,0,0,0,2
CATACGAACTAGCTGG-1_V10B01-087_D1,2,2,0,0,0,4
GGGAACGGTTTCAGAT-1_V10B01-087_D1,3,1,0,0,0,4
AGGGTGCCGTTCTTTA-1_V10B01-087_D1,8,0,0,0,0,8
ACGACTGGTCATACTC-1_V10B01-087_D1,5,1,0,0,0,6
GGATCTTACTGCCCTT-1_V10B01-087_D1,0,2,0,0,0,2
TACTCCTCTAGTTGAC-1_V10B01-087_D1,7,0,1,0,0,8
GTAGCTCCGGGAGGCT-1_V10B01-087_D1,4,0,0,0,0,4
GGACTCGTGAGTGGTC-1_V10B01-087_D1,5,0,1,0,0,6
GTAGTTCGAAGGCGAA-1_V10B01-087_D1,2,0,1,1,0,4
CTCAAACCACTGCCCG-1_V10B01-087_D1,1,2,0,0,0,3
GAGGGAGTCAGATCGC-1_V10B01-087_D1,1,1,1,0,0,3
GCGTCCCTAAGACATA-1_V10B01-087_D1,4,1,1,0,0,6
TCTCTTACCGCGAACC-1_V10B01-087_D1,0,2,2,0,0,4
GGCTACTATACACTCC-1_V10B01-087_D1,4,0,1,0,0,5
CGTTGCCCGCGTGGGA-1_V10B01-087_D1,4,0,0,0,0,4
TATAGAGTCGCTTGAA-1_V10B01-087_D1,2,2,1,0,0,5
ATGTTGTAGTCTGTTT-1_V10B01-087_D1,0,1,1,0,0,2
AGTATACACAGCGACA-1_V10B01-087_D1,4,1,0,0,0,5
TGTGGTTGCTAAAGCT-1_V10B01-087_D1,1,0,0,0,0,1
TGATTCCCGGTTACCT-1_V10B01-087_D1,3,2,1,1,0,7
CACTGACGATTGTGGA-1_V10B01-087_D1,4,0,2,0,0,6
AACATTGTGACTCGAG-1_V10B01-087_D1,1,0,0,0,0,1
GTCCAATATTTAGCCT-1_V10B01-087_D1,2,1,1,0,0,4
GCTCTTTCCGCTAGTG-1_V10B01-087_D1,3,3,0,1,0,7
GGGTCAGGAGCTAGAT-1_V10B01-087_D1,3,0,0,0,0,3
AGGTGGTGACCTTCGC-1_V10B01-087_D1,2,2,0,0,0,4
CCCGGGTCGTTCAGGG-1_V10B01-087_D1,2,0,2,1,0,5
AGCCAAGCTTTGTGTC-1_V10B01-087_D1,7,0,0,1,0,8
TGTGGCGGGCTTCTGG-1_V10B01-087_D1,3,1,1,0,0,5
CGAGGGTATCCAGGTG-1_V10B01-087_D1,4,1,0,0,0,5
CGTTCAGACCCGCGAA-1_V10B01-087_D1,7,1,3,0,0,11
TCATATGAGCTTTGTT-1_V10B01-087_D1,3,0,0,0,0,3
AGTTGACGGTCCTTGC-1_V10B01-087_D1,5,2,0,0,0,7
ATAATTAGCTAAGTAG-1_V10B01-087_D1,1,0,1,0,0,2
GGTCTTGAGCGCTCTT-1_V10B01-087_D1,2,0,1,0,0,3
CGTTGTCGGCAATTGA-1_V10B01-087_D1,5,1,2,1,0,9
TCTTGCTCCCGATACT-1_V10B01-087_D1,4,1,2,0,0,7
AGCAGAAGGAGAAAGA-1_V10B01-087_D1,3,1,1,1,0,6
GAAGCCACTGATTATG-1_V10B01-087_D1,1,2,0,1,0,4
TGCTCTTGAGAGTTTG-1_V10B01-087_D1,3,3,0,0,0,6
GACATCCGTCGAACTG-1_V10B01-087_D1,2,1,0,0,0,3
AGATATAATACGACTA-1_V10B01-087_D1,2,1,2,0,0,5
TCGCTACTGGCTTTGA-1_V10B01-087_D1,1,2,1,0,0,4
GTGACAGCTTCCCACT-1_V10B01-087_D1,3,0,0,0,0,3
GTGACGCAGGTTTCAT-1_V10B01-087_D1,2,2,2,0,0,6
GGGAAGACGGTCTGTC-1_V10B01-087_D1,2,0,1,0,0,3
CGTCGCATGTGAGCCA-1_V10B01-087_D1,2,2,0,1,0,5
AGAAGGTTGTAGGTCG-1_V10B01-087_D1,3,1,1,0,0,5
GGCCGGCGTCTGCTAT-1_V10B01-087_D1,1,4,1,0,0,6
TTGACCAGGAACAACT-1_V10B01-087_D1,3,2,2,0,0,7
AGTCGTATAAAGCAGA-1_V10B01-087_D1,3,3,1,1,0,8
GGCGTAGGGAAAGCTG-1_V10B01-087_D1,2,0,1,1,0,4
AAACCTAAGCAGCCGG-1_V10B01-087_D1,5,3,0,0,0,8
ATTGCCTTTATGTTTG-1_V10B01-087_D1,3,2,2,0,0,7
CAGGCAGTCTTACCAG-1_V10B01-087_D1,2,2,0,0,0,4
AGCTAAGTACGCAGGC-1_V10B01-087_D1,7,2,0,1,0,10
AAATCCGATACACGCC-1_V10B01-087_D1,2,3,1,0,0,6
CGAGAGCTTTCACTAC-1_V10B01-087_D1,2,4,0,2,0,8
CGCCCAGCGTTTCACG-1_V10B01-087_D1,1,2,0,2,0,5
TTAAGTATTGTTATCC-1_V10B01-087_D1,3,0,1,0,0,4
AAACGGGCGTACGGGT-1_V10B01-087_D1,4,1,2,1,0,8
GTATCCTTTGGTAACC-1_V10B01-087_D1,8,0,0,0,0,8
CATAGTCAAATACATA-1_V10B01-087_D1,0,1,3,0,0,4
TCTATGCTATAACGAC-1_V10B01-087_D1,2,0,2,0,0,4
ACGTTCTGTACAAGTC-1_V10B01-087_D1,3,2,2,0,0,7
CGCGAAGTGGCATACT-1_V10B01-087_D1,5,1,1,1,0,8
ACCAACCGCACTCCAC-1_V10B01-087_D1,4,0,4,1,0,9
GTCATGCGCGAGGGCT-1_V10B01-087_D1,1,0,2,0,0,3
TAGGCTAAAGTGGCAC-1_V10B01-087_D1,2,1,0,1,0,4
TGGCTACACTCTACCT-1_V10B01-087_D1,2,1,1,0,1,5
TGTCCACGGCTCAACT-1_V10B01-087_D1,4,2,1,1,0,8
AATTGCAGCAATCGAC-1_V10B01-087_D1,3,0,1,0,0,4
GTCAACCAGGCCTATA-1_V10B01-087_D1,6,1,0,1,0,8
ATCTTATCGCACACCC-1_V10B01-087_D1,1,1,0,0,0,2
GTCTATTGCATGCTCG-1_V10B01-087_D1,5,1,0,1,0,7
GCACGTGGTTTACTTA-1_V10B01-087_D1,1,1,0,2,0,4
ATTCGCGCCTTGAGAG-1_V10B01-087_D1,1,1,0,1,0,3
AGCGATGCGCCTAATA-1_V10B01-087_D1,1,1,1,3,0,6
TCTATAGGTGGGTAAT-1_V10B01-087_D1,0,0,0,0,0,0
TGTAAGACTGATAAGA-1_V10B01-087_D1,1,2,0,0,0,3
GTCACTCATGAGCGAT-1_V10B01-087_D1,4,0,1,0,0,5
CGGTTTACTGAACATT-1_V10B01-087_D1,1,1,0,0,0,2
GAGATCGATCTTACTC-1_V10B01-087_D1,3,1,2,0,0,6
TCTTTCATCCGTCCTT-1_V10B01-087_D1,3,0,0,1,0,4
TCGGATCTGGATGACC-1_V10B01-087_D1,3,0,1,0,1,5
GTCCTAGGATACCTTA-1_V10B01-087_D1,1,0,0,0,0,1
TGTACCCGACCCTAAT-1_V10B01-087_D1,4,0,0,0,0,4
AGGTTCTCCTTTCCGG-1_V10B01-087_D1,1,0,0,0,0,1
AATTGCGTGGATTACA-1_V10B01-087_D1,3,0,0,0,0,3
CGATAGCGATACAGTG-1_V10B01-087_D1,4,0,0,0,0,4
CGCCCTAATTGTTCAA-1_V10B01-087_D1,2,0,0,0,0,2
ATTATGAGACCCAATT-1_V10B01-087_D1,2,0,1,0,0,3
CCTCCTAGCTAGAGTC-1_V10B01-087_D1,1,1,0,0,0,2
CGAAGGGTTTCAGATT-1_V10B01-087_D1,4,0,1,0,0,5
CACAAGCTAAGAAAGG-1_V10B01-087_D1,3,1,1,0,0,5
CACCGGTAGAGACATT-1_V10B01-087_D1,1,0,0,0,0,1
ACTCATGGCAGCCTTC-1_V10B01-087_D1,2,0,0,0,0,2
CATCCAATATAGTTTG-1_V10B01-087_D1,1,0,0,0,0,1
CAGATATGAAGATGAC-1_V10B01-087_D1,2,1,0,0,0,3
GCAAAGGGCGTTAGCC-1_V10B01-087_D1,3,1,0,0,0,4
CTGTTGTTCAGTCGTA-1_V10B01-087_D1,3,0,0,0,0,3
AAAGGCCCTATAATAC-1_V10B01-087_D1,0,0,0,1,0,1
AACATTGAAGTTGATC-1_V10B01-087_D1,6,1,0,0,0,7
GCTAGCGATAGGTCTT-1_V10B01-087_D1,1,1,0,0,0,2
ATTGCCTATTAGACCG-1_V10B01-087_D1,2,1,1,0,0,4
GGGCGTTTACATTCAT-1_V10B01-087_D1,2,1,0,0,0,3
CCTCTACAAGGATTGG-1_V10B01-087_D1,1,0,0,0,0,1
AGTGACTGTGACACAA-1_V10B01-087_D1,0,0,0,0,0,0
AGCCCTCCCTGGTGGC-1_V10B01-087_D1,1,1,1,0,0,3
CGGTTGAGTATCCTTC-1_V10B01-087_D1,0,0,0,0,0,0
CATTATCCCATTAACG-1_V10B01-087_D1,2,1,0,0,0,3
AATGTGCTAATCTGAG-1_V10B01-087_D1,0,1,0,0,0,1
CTTAGTTGAGGAATCG-1_V10B01-087_D1,1,1,1,0,0,3
CTTCTGGGCGTACCTA-1_V10B01-087_D1,1,0,0,0,0,1
AGTCAAATGATGTGAT-1_V10B01-087_D1,5,0,1,0,0,6
TGAACAAGCAGGGACT-1_V10B01-087_D1,5,1,0,0,0,6
AATACCGGAGGGCTGT-1_V10B01-087_D1,1,1,0,1,0,3
GTTTGGTGATCGGTGC-1_V10B01-087_D1,7,0,4,0,0,11
GACTGCTGGTGAGAAA-1_V10B01-087_D1,5,1,0,0,0,6
CGATCCTCGCAACATA-1_V10B01-087_D1,2,0,2,0,0,4
CCAACCTTATGTAACT-1_V10B01-087_D1,5,0,1,0,0,6
CGTGGTACCCAAAGGC-1_V10B01-087_D1,2,1,1,0,0,4
AACCCGACAACCCGTG-1_V10B01-087_D1,4,2,1,0,0,7
TATGTAAAGTGCTTAA-1_V10B01-087_D1,0,1,1,0,0,2
GCAAGTGTAAAGCATG-1_V10B01-087_D1,3,1,0,0,0,4
GTAACTGCCCAAGGAG-1_V10B01-087_D1,5,0,0,0,0,5
GGTGCATAAATGATTA-1_V10B01-087_D1,5,2,1,0,0,8
TAGTCCCGGAGACCAC-1_V10B01-087_D1,3,0,0,0,0,3
CGGCCAGAGCGACCAT-1_V10B01-087_D1,4,3,1,0,0,8
TGAATGAGTGTTTCCC-1_V10B01-087_D1,4,0,0,0,0,4
TTCACTTCCTAGAACG-1_V10B01-087_D1,3,2,0,0,0,5
CGCTTAGTATTGATAC-1_V10B01-087_D1,4,3,0,1,0,8
AACGCGACCTTGGGCG-1_V10B01-087_D1,1,3,1,0,0,5
GTGCACCAGCTTCAAC-1_V10B01-087_D1,2,0,0,0,0,2
TTCTATTAAACGCAGC-1_V10B01-087_D1,4,3,1,1,0,9
TGGCAAGCACAAGTCG-1_V10B01-087_D1,2,1,1,0,0,4
ATCTGCTGTTATCGCC-1_V10B01-087_D1,4,0,0,0,0,4
AATTCCAAGCATGTAC-1_V10B01-087_D1,4,0,0,0,0,4
AAACGGTTGCGAACTG-1_V10B01-087_D1,4,1,0,0,0,5
GAAGGAGTCGAGTGCG-1_V10B01-087_D1,2,1,2,0,0,5
GGCAAGCCCATAGTGG-1_V10B01-087_D1,3,2,0,0,0,5
TGACCAAATCTTAAAC-1_V10B01-087_D1,1,1,1,0,0,3
TTCGGTACTGTAGAGG-1_V10B01-087_D1,2,2,0,0,0,4
ATGTACGATGACGTCG-1_V10B01-087_D1,1,1,0,1,0,3
ATCTAGCTTGTGAGGG-1_V10B01-087_D1,5,0,0,0,0,5
AGCGGGTCTGACACTC-1_V10B01-087_D1,3,3,2,0,0,8
GAGGTACGCGTGTCCC-1_V10B01-087_D1,2,1,0,0,0,3
GCACTGCCTACCTTTA-1_V10B01-087_D1,6,2,2,0,0,10
GGAGCGAGGCCTACTT-1_V10B01-087_D1,1,2,0,0,0,3
AAACTCGGTTCGCAAT-1_V10B01-087_D1,2,2,2,2,0,8
GGCGCTTCATTCCCTG-1_V10B01-087_D1,1,1,2,0,0,4
TGCTCGGTGGGTCACC-1_V10B01-087_D1,0,0,0,0,0,0
AAGCGCAGGGCTTTGA-1_V10B01-087_D1,2,1,2,0,0,5
GACCTTCCACGTCTAC-1_V10B01-087_D1,1,3,0,3,0,7
GTTAGCCCATGACATC-1_V10B01-087_D1,1,1,1,2,0,5
AATTCGATTCGAGGAT-1_V10B01-087_D1,0,2,2,0,0,4
AGTCTTTAAAGTGTCC-1_V10B01-087_D1,1,0,0,0,0,1
GACTAGGCCGTTAGGT-1_V10B01-087_D1,3,1,0,2,0,6
TCCAAGCCTAGACACA-1_V10B01-087_D1,0,2,1,3,1,7
GATTGGGAAAGGTTGT-1_V10B01-087_D1,2,2,3,1,0,8
GATGAGGAACCTTCGG-1_V10B01-087_D1,2,2,0,0,0,4
TGAATACCGACGCGTA-1_V10B01-087_D1,1,0,1,0,0,2
AATCGTGAGCCGAGCA-1_V10B01-087_D1,0,2,2,0,0,4
GCGAAGAATCTGACGG-1_V10B01-087_D1,1,3,1,1,0,6
GAACAACTGGGATGAA-1_V10B01-087_D1,1,3,0,0,0,4
TCGCCGACATATTCGC-1_V10B01-087_D1,4,3,2,0,0,9
CGTAGAGAGTAATTAT-1_V10B01-087_D1,1,4,0,0,0,5
CGATAGTCGTACTGCA-1_V10B01-087_D1,3,1,3,1,0,8
CGCATGCCGAATGCGT-1_V10B01-087_D1,2,2,0,0,1,5
CTCTAGCCCTCGGAAA-1_V10B01-087_D1,3,0,0,0,0,3
TCCAACTCAGCTATCT-1_V10B01-087_D1,2,1,0,0,0,3
GTCTAGTGAGCCGCTT-1_V10B01-087_D1,1,2,1,1,0,5
TACCGAATAATTGTAA-1_V10B01-087_D1,3,0,0,2,0,5
ATATAACACGGGCGCA-1_V10B01-087_D1,3,2,0,0,0,5
GCATGCTAATAACGAT-1_V10B01-087_D1,3,4,1,2,0,10
TCCGGGCTTGACGGGA-1_V10B01-087_D1,2,1,0,1,0,4
ATTATTCAGAGTCACT-1_V10B01-087_D1,4,0,0,0,1,5
TAGCAGTATGACTAAA-1_V10B01-087_D1,1,1,0,0,1,3
TATGAAGAATTAAGGT-1_V10B01-087_D1,3,1,0,0,0,4
CAAGGCCAGTGGTGCA-1_V10B01-087_D1,1,0,0,0,1,2
TGCGTACGGCTAATTG-1_V10B01-087_D1,3,2,0,0,0,5
CAGATAATGGGCGGGT-1_V10B01-087_D1,1,2,1,0,0,4
GAGAACGGTTCTGACT-1_V10B01-087_D1,3,3,1,0,0,7
CGCTTCGGTCTAAGAC-1_V10B01-087_D1,2,1,2,0,0,5
AGCATTACGAGGCAAG-1_V10B01-087_D1,4,0,0,0,0,4
AAGTTGTGATGTTATA-1_V10B01-087_D1,2,1,1,0,0,4
TTGCTCATAGTACGTG-1_V10B01-087_D1,0,1,0,1,0,2
TACTTAAACATGTACA-1_V10B01-087_D1,0,1,0,0,0,1
AGTGAGTCGAATTAAC-1_V10B01-087_D1,4,2,0,0,0,6
TAGGCCTATATAGTCT-1_V10B01-087_D1,0,0,0,0,0,0
ACTCGCCGTTCGATAA-1_V10B01-087_D1,0,0,0,0,0,0
GGTACGTTGCGGCCGG-1_V10B01-087_D1,0,0,0,0,0,0
TATTGCCGGGCTTGTA-1_V10B01-087_D1,1,0,0,1,0,2
GGTAAACTCTGCGCTG-1_V10B01-087_D1,0,0,0,0,0,0
TCCCTTGTCTGAAACT-1_V10B01-087_D1,0,3,0,3,0,6
CATGATCGCTTTGAGA-1_V10B01-087_D1,0,0,0,0,0,0
GGACGGGCGACCAACC-1_V10B01-087_D1,0,1,0,7,0,8
GAGAGGCCTATGTGTA-1_V10B01-087_D1,1,3,0,0,0,4
TCGTAACTCCCAAGAC-1_V10B01-087_D1,0,1,1,3,1,6
CGTATCTAGAACTAAG-1_V10B01-087_D1,0,0,0,0,0,0
GCACCTTCCCGAAGGT-1_V10B01-087_D1,1,1,1,2,1,6
TGACTCTAACTGGTAA-1_V10B01-087_D1,1,0,0,1,0,2
ATCCGGACCAGCCTGA-1_V10B01-087_D1,0,0,0,0,0,0
CGAATTCCCGGTTCAA-1_V10B01-087_D1,0,0,0,0,0,0
TAGTTTGATCGGTCGC-1_V10B01-087_D1,2,0,0,0,0,2
AGTCGAAACGATTCAG-1_V10B01-087_D1,2,0,0,0,0,2
ACGTCGGGCAACTCGG-1_V10B01-087_D1,1,0,0,0,0,1
ACTTGCTCTATCTACC-1_V10B01-087_D1,2,0,0,0,0,2
ATTACGGGCTACGGTT-1_V10B01-087_D1,2,0,0,0,0,2
GCAAACGTAAGCGACC-1_V10B01-087_D1,3,0,0,0,0,3
TTCGGACTGGGCATGG-1_V10B01-087_D1,5,0,0,0,0,5
GGGCCATTCGTGCTGG-1_V10B01-087_D1,3,1,0,0,0,4
GAGTTGTCACCAGTCT-1_V10B01-087_D1,2,1,0,0,0,3
AGTAATTTGCAAGCGT-1_V10B01-087_D1,2,0,0,0,0,2
GTGGCCGGTTTCTCGG-1_V10B01-087_D1,2,2,1,0,0,5
ATCTTAGGGCATTAAT-1_V10B01-087_D1,0,1,0,0,0,1
CTACATATCGCGGGAC-1_V10B01-087_D1,3,0,0,0,0,3
ATGGTATTTACTGATT-1_V10B01-087_D1,4,0,0,0,0,4
CCGTCAACCTCTGGCG-1_V10B01-087_D1,2,0,1,0,0,3
GCTTCGACGTTCAATC-1_V10B01-087_D1,4,2,0,1,0,7
GACCGATTAAATATGT-1_V10B01-087_D1,1,0,0,0,0,1
GTCGAATTTGGGCGCT-1_V10B01-087_D1,2,3,2,0,0,7
TCACGGCCCAAGAGAG-1_V10B01-087_D1,1,0,1,1,0,3
CTACGATCCTATCCTA-1_V10B01-087_D1,2,0,0,0,0,2
TGCAGTGGTAGGGAAC-1_V10B01-087_D1,4,0,0,0,0,4
TTGCCTAATCCAAAGT-1_V10B01-087_D1,4,0,1,0,0,5
AGCGAGACGTGAAGGC-1_V10B01-087_D1,1,0,2,0,0,3
TTCTACCTCAATCGGT-1_V10B01-087_D1,0,0,0,0,0,0
TACGCTGCTGTGTTAA-1_V10B01-087_D1,4,0,0,0,0,4
TAGTCCTGCACTAAGC-1_V10B01-087_D1,0,1,0,0,0,1
AGCACACGTTTAGACT-1_V10B01-087_D1,3,1,0,0,0,4
GTTCGACAATTGTATA-1_V10B01-087_D1,3,0,1,0,0,4
CCATGTTCATCTATAT-1_V10B01-087_D1,0,3,0,1,0,4
CCCTCGATAATACACA-1_V10B01-087_D1,2,2,0,0,0,4
ACTGCCCGCCATTCTC-1_V10B01-087_D1,1,0,1,0,0,2
CTATATCCAGCCTGGC-1_V10B01-087_D1,3,2,0,0,0,5
CGCACGTCTGTTTATG-1_V10B01-087_D1,4,1,0,0,0,5
AATCAGGTTTCATTTA-1_V10B01-087_D1,2,0,2,0,0,4
AGAGAAACACCAGAAA-1_V10B01-087_D1,5,0,0,0,0,5
ACCCGATTGGTTCCGA-1_V10B01-087_D1,1,0,0,0,0,1
TACCAGGAATCCCGTC-1_V10B01-087_D1,1,0,0,0,0,1
AAGTGCTTCTCTATTG-1_V10B01-087_D1,3,2,2,0,0,7
TGCATGTGACCCATAG-1_V10B01-087_D1,4,0,0,0,0,4
TAGATTCAAAGTGCGG-1_V10B01-087_D1,4,2,0,0,0,6
AGGGTCAGAGCACTCG-1_V10B01-087_D1,4,2,0,0,0,6
GTGAGATAACCTTATA-1_V10B01-087_D1,4,1,3,0,0,8
GTGTCAGTGTACGTGG-1_V10B01-087_D1,2,0,0,0,0,2
CTGTAGTGAGGATCGA-1_V10B01-087_D1,2,6,0,1,0,9
GATAGTGCGAGTAAGT-1_V10B01-087_D1,5,0,0,0,0,5
AGGGTTCAGACGGTCC-1_V10B01-087_D1,1,5,0,0,0,6
GGACTCGACAGCGCAT-1_V10B01-087_D1,1,2,0,0,0,3
CACTCTCAAGCATCGA-1_V10B01-087_D1,5,1,0,0,0,6
GAGCGGAATGCGGTGT-1_V10B01-087_D1,1,2,0,0,0,3
CAGTTCGAGGACCCGA-1_V10B01-087_D1,1,1,0,0,0,2
CGTAACTTCGACACTT-1_V10B01-087_D1,3,0,1,0,0,4
TGATCACCACACTGAC-1_V10B01-087_D1,3,3,0,1,0,7
CATACTTCTTTCTCCG-1_V10B01-087_D1,4,2,0,0,0,6
CAAGTAAGTGATAGAC-1_V10B01-087_D1,1,2,0,0,0,3
AGCCCGCAACAAGCAG-1_V10B01-087_D1,1,3,0,0,0,4
GCTCCATGCAAAGCAA-1_V10B01-087_D1,2,0,0,0,0,2
TCGTACCGACGTCAAG-1_V10B01-087_D1,2,0,2,2,0,6
ATTATCGGAATGTACG-1_V10B01-087_D1,0,1,2,0,0,3
ACCTACTATAAATCTA-1_V10B01-087_D1,9,0,2,1,1,13
TATCCTATCAACTGGT-1_V10B01-087_D1,0,0,0,0,0,0
GCGCGGTCTAGTAACT-1_V10B01-087_D1,5,3,1,0,0,9
CCTTCGTATAGAATCC-1_V10B01-087_D1,1,1,0,0,0,2
TGGGCGATACAATAAG-1_V10B01-087_D1,2,1,0,0,0,3
TGACATGTAACGTGAC-1_V10B01-087_D1,3,0,1,0,0,4
TTGGGAAGACGAGCCG-1_V10B01-087_D1,3,0,1,0,0,4
GGTGTAAATCGATTGT-1_V10B01-087_D1,4,0,1,0,0,5
GAACTGTGGAGAGACA-1_V10B01-087_D1,1,0,0,0,0,1
TCCACATCGTATATTG-1_V10B01-087_D1,2,2,0,0,0,4
CCTATGGTCAAAGCTG-1_V10B01-087_D1,1,1,0,0,0,2
TCCTTGTCCTTTAATT-1_V10B01-087_D1,2,0,1,1,0,4
AAGTTTATGGGCCCAA-1_V10B01-087_D1,0,0,0,0,0,0
GTCCGGGTTCACATTA-1_V10B01-087_D1,0,0,1,0,0,1
ATGTAGCGCGCGTAGG-1_V10B01-087_D1,5,3,1,1,0,10
TACGGAAGCCAAACCA-1_V10B01-087_D1,3,0,2,0,0,5
GCCCTGAGGATGGGCT-1_V10B01-087_D1,2,0,2,2,1,7
CGGGCGATGGATCACG-1_V10B01-087_D1,5,0,1,0,1,7
TGCGGACTTGACTCCG-1_V10B01-087_D1,1,1,1,0,2,5
TAATACTAGAACAGAC-1_V10B01-087_D1,2,0,0,0,0,2
TCAAATTGTTGTGCCG-1_V10B01-087_D1,3,0,3,0,0,6
GGGCAGTCAACGCCAA-1_V10B01-087_D1,3,1,0,2,0,6
TCGCTGCCAATGCTGT-1_V10B01-087_D1,2,3,1,1,0,7
TACGTGGGCCCAGGGC-1_V10B01-087_D1,1,0,0,0,0,1
GCCTACGTTCTGTGCA-1_V10B01-087_D1,0,0,0,0,0,0
TTGCGTGTGTAGGCAT-1_V10B01-087_D1,0,3,0,1,0,4
TCCTAAAGATTCAGAC-1_V10B01-087_D1,3,0,0,0,3,6
TGGGTGCACAAGCCAT-1_V10B01-087_D1,2,0,1,0,0,3
GGGAGCGACCGTAGTG-1_V10B01-087_D1,0,1,0,0,1,2
CATAGAGGAGATACTA-1_V10B01-087_D1,1,1,1,0,0,3
CTTCGATTGCGCAAGC-1_V10B01-087_D1,2,1,2,0,0,5
GTGCCTGAGACCAAAC-1_V10B01-087_D1,1,1,0,1,0,3
TCATCCTCAGCTGCTT-1_V10B01-087_D1,1,4,1,0,0,6
TGCAACTACTGGTTGA-1_V10B01-087_D1,4,1,1,2,0,8
ATGTTGATTAGAGACT-1_V10B01-087_D1,1,4,0,0,0,5
GTTTCTAGAGGCGCGG-1_V10B01-087_D1,1,1,1,2,0,5
TACAAGGGCTTCTTTA-1_V10B01-087_D1,1,0,0,3,0,4
ACAGGCACGGATCCTT-1_V10B01-087_D1,3,0,1,1,0,5
CCCAAGTCATTACACT-1_V10B01-087_D1,4,1,0,1,0,6
ACTCTGACCTAATAGA-1_V10B01-087_D1,1,1,0,0,0,2
GGATGGCTTGAAGTAT-1_V10B01-087_D1,4,1,2,0,0,7
ACCCTCCCGTCAGGGC-1_V10B01-087_D1,2,3,0,0,0,5
AGCTTCTTCTCGAGCA-1_V10B01-087_D1,2,3,1,0,0,6
TTGCGCTTGATCAATA-1_V10B01-087_D1,2,1,0,1,0,4
TGGGTGTAATAGATTT-1_V10B01-087_D1,0,1,0,0,0,1
CATGGTTTATTAATCA-1_V10B01-087_D1,2,1,0,0,0,3
TTGCCTTCTCGCCGGG-1_V10B01-087_D1,4,1,1,0,0,6
TTAAAGTAAGTCGCCA-1_V10B01-087_D1,0,1,0,1,0,2
AGTTGGCAAGGCTAGA-1_V10B01-087_D1,1,1,1,0,0,3
CCGCACTTGCAATGAC-1_V10B01-087_D1,4,0,1,0,0,5
AATGTTGTCGTGAGAC-1_V10B01-087_D1,3,0,0,0,0,3
CCAAGGTTGCCCTTTC-1_V10B01-087_D1,1,2,0,2,0,5
TGTGACTAGAGTTTGC-1_V10B01-087_D1,1,1,0,0,0,2
TTGTGATCTGTTCAGT-1_V10B01-087_D1,0,1,0,0,0,1
GGAGTTGATTCTGTGT-1_V10B01-087_D1,0,1,1,0,0,2
GTAGTGAGCAACCTCA-1_V10B01-087_D1,0,1,0,0,0,1
AAGACATACGTGGTTT-1_V10B01-087_D1,2,0,0,2,0,4
CATCCCGAGATTCATA-1_V10B01-087_D1,1,0,0,0,0,1
GGCCGCAGGAACCGCA-1_V10B01-087_D1,4,1,1,1,0,7
CCAGAAACTGATGCGA-1_V10B01-087_D1,2,1,2,0,0,5
ACCCGTAGTCTAGTTG-1_V10B01-087_D1,2,0,0,0,0,2
AGGGTCTGGACGCAGT-1_V10B01-087_D1,0,2,0,0,0,2
TTGAAACCCTCATTCC-1_V10B01-087_D1,2,1,0,2,0,5
TCAATCCCGCGCCAAA-1_V10B01-087_D1,1,2,0,2,0,5
AGGACATCGGCACACT-1_V10B01-087_D1,0,0,1,1,1,3
GACAAGACGCCCGTGC-1_V10B01-087_D1,1,2,1,0,0,4
GAGTAAATTAAGAACC-1_V10B01-087_D1,0,1,0,2,0,3
TAAGTCGGTGAGCTAG-1_V10B01-087_D1,2,2,1,1,1,7
CTTACTGACTCCTCTG-1_V10B01-087_D1,1,2,0,4,0,7
GGGCGATCCATAGGCC-1_V10B01-087_D1,0,0,0,1,0,1
CGTATTGTTTGGCGCC-1_V10B01-087_D1,3,1,1,0,0,5
CGCGTGGGCCTGTGTT-1_V10B01-087_D1,1,2,0,0,0,3
AAATCTGCCCGCGTCC-1_V10B01-087_D1,2,1,0,0,0,3
GCTGAAGGGTTCTTGG-1_V10B01-087_D1,3,1,1,0,0,5
TAATTGCGCTGATTAC-1_V10B01-087_D1,0,0,0,0,2,2
TCGCGCGTTTACATGA-1_V10B01-087_D1,3,1,0,0,0,4
TAACTGAAATACGCCT-1_V10B01-087_D1,2,0,1,0,0,3
CCTGTCGTGTATGAAG-1_V10B01-087_D1,0,1,1,0,0,2
CGGGAACGCCCTGCAT-1_V10B01-087_D1,0,3,2,0,0,5
AGTTGCGGTCCTCAAC-1_V10B01-087_D1,1,1,1,0,0,3
GGGTCCTTGGAAGAAG-1_V10B01-087_D1,3,0,0,0,0,3
CGGGAAGTACCGTGGC-1_V10B01-087_D1,2,0,0,0,0,2
ACGGTCACCGAGAACA-1_V10B01-087_D1,1,0,0,0,0,1
TAGACTCAGTTGGCCT-1_V10B01-087_D1,2,0,0,0,0,2
CCTTCCGCAACGCTGC-1_V10B01-087_D1,4,1,2,0,0,7
CAGTGTTAATCTCTCA-1_V10B01-087_D1,1,0,0,1,0,2
CAGGCCAGTACCACCT-1_V10B01-087_D1,9,0,0,0,0,9
GATCGCTGTGGTGCGT-1_V10B01-087_D1,0,0,0,0,0,0
GTATCTCGGGCGCTTT-1_V10B01-087_D1,7,0,0,0,0,7
CCGGGCTAAGAATTTC-1_V10B01-087_D1,1,1,0,0,0,2
CTTCACGCCCTGGTAC-1_V10B01-087_D1,1,1,0,1,0,3
CGGATGAATGCTGTGA-1_V10B01-087_D1,2,0,0,0,0,2
CTCTGCAGGCATTCTT-1_V10B01-087_D1,1,3,0,0,0,4
TCAAAGTCACGGCGTC-1_V10B01-087_D1,6,0,0,0,0,6
TGGGTTTCGGGCGTAC-1_V10B01-087_D1,0,0,0,0,0,0
TGCTATGGCAAAGGGA-1_V10B01-087_D1,4,0,0,0,0,4
TTCACGGTCGTCACGT-1_V10B01-087_D1,0,0,0,0,0,0
CGTAAAGCAAGAAATC-1_V10B01-087_D1,1,1,0,0,0,2
CTGATCCCTTTATGCA-1_V10B01-087_D1,4,0,0,0,0,4
GAGTATACCCTAATCA-1_V10B01-087_D1,6,0,0,1,0,7
CCACGGCAGGTGTAGG-1_V10B01-087_D1,0,2,0,0,0,2
ACGTACTTTGGCACGG-1_V10B01-087_D1,1,0,0,0,0,1
CCTGAGAATAAATGCA-1_V10B01-087_D1,3,1,0,0,0,4
TTGATGCCGCTCGTCG-1_V10B01-087_D1,3,0,0,0,0,3
GCCAGGAAAGAACACT-1_V10B01-087_D1,4,1,1,0,0,6
TCCGACCGCTAATCAA-1_V10B01-087_D1,2,3,0,1,0,6
TATATCAAAGTGATCT-1_V10B01-087_D1,3,3,1,0,0,7
CCTCGGTTTCCTTGCC-1_V10B01-087_D1,1,3,0,0,0,4
TAAATTTAGTAACACC-1_V10B01-087_D1,2,1,0,0,0,3
CTCGTTACGGCTACCA-1_V10B01-087_D1,2,3,0,0,0,5
GCCGTCGGTTTCGGGC-1_V10B01-087_D1,3,1,1,0,0,5
GTTCCGTCCGCCTGCA-1_V10B01-087_D1,2,1,2,0,0,5
CTAGGGATAGGGACAA-1_V10B01-087_D1,4,0,0,0,0,4
GTCCAGGCACGTGTGC-1_V10B01-087_D1,2,4,0,0,0,6
GAGGAATATCTCTTTG-1_V10B01-087_D1,2,1,0,0,1,4
CGTTCAAGGAAACGGA-1_V10B01-087_D1,3,1,0,1,0,5
GTGGGAACAAACCGGG-1_V10B01-087_D1,2,1,1,1,0,5
GGGCACGTAGTACTGT-1_V10B01-087_D1,2,3,1,0,0,6
ACTACAAAGAGAGGTG-1_V10B01-087_D1,3,1,0,0,1,5
GGTGTAGGTAAGTAAA-1_V10B01-087_D1,3,1,2,1,0,7
CCTGTTCAACCTCGGG-1_V10B01-087_D1,6,1,0,0,0,7
TGAGGTGTGTGGCGGA-1_V10B01-087_D1,4,1,0,1,0,6
ATTGTCTGTTTCATGT-1_V10B01-087_D1,2,0,2,0,0,4
GCCGGTCGTATCTCTC-1_V10B01-087_D1,3,1,1,1,0,6
ATATGGGATAGCAACT-1_V10B01-087_D1,4,0,1,1,0,6
GATAGAACCCGCTAGG-1_V10B01-087_D1,2,1,0,0,0,3
ATCCCATTTCCGTGGG-1_V10B01-087_D1,5,2,0,0,0,7
GATGCTACCTTCGATG-1_V10B01-087_D1,2,3,0,0,0,5
TGCAAAGTTCGTCTGT-1_V10B01-087_D1,6,0,0,0,0,6
GTTCAGTCGCCAAATG-1_V10B01-087_D1,2,0,1,0,0,3
GTCTCCGCCTCAATAC-1_V10B01-087_D1,2,1,1,1,0,5
AGTAGAAGGCGCCTCA-1_V10B01-087_D1,1,1,0,0,0,2
GTTGTAGATTTATGAG-1_V10B01-087_D1,4,0,0,1,0,5
CTATTTGCTTGGAGGA-1_V10B01-087_D1,2,0,0,0,0,2
AGCCATATAGTATGTG-1_V10B01-087_D1,3,0,1,0,0,4
TGTTCCGGCCTGAGCT-1_V10B01-087_D1,7,1,2,0,0,10
TGCCGTGGGACCCAAT-1_V10B01-087_D1,3,0,0,0,0,3
TTGCAAGAAGACTCCT-1_V10B01-087_D1,0,0,2,0,0,2
CCGCTCCAGGGCGATC-1_V10B01-087_D1,3,0,1,0,1,5
CAAACCCTCCGGCGGG-1_V10B01-087_D1,4,0,0,0,0,4
CGGACCTTTACGTCCC-1_V10B01-087_D1,1,1,1,1,0,4
ACGTAGGAGAGTCGCT-1_V10B01-087_D1,5,1,2,0,0,8
CTGCGACCTCGCCGAA-1_V10B01-087_D1,1,1,0,1,0,3
GGCCCAGCTGGTTTGC-1_V10B01-087_D1,1,2,1,0,0,4
GGATTAATCATGGACC-1_V10B01-087_D1,3,2,0,0,0,5
GAGATGGCTTTAATCA-1_V10B01-087_D1,4,2,0,1,0,7
AGTACAGAAGCTTATA-1_V10B01-087_D1,3,0,0,0,0,3
GCGGCTTTAGCAAGTT-1_V10B01-087_D1,3,0,6,1,0,10
ACCGAGTCTCCTTATT-1_V10B01-087_D1,3,1,0,7,0,11
GACCACACTTCCCTTT-1_V10B01-087_D1,0,2,3,2,0,7
TGTAGCCAATTCCGTT-1_V10B01-087_D1,2,2,0,1,0,5
CTCGTCTGTGCCTTCG-1_V10B01-087_D1,1,0,1,0,0,2
GGACTCTTTGACTAAG-1_V10B01-087_D1,4,0,0,1,0,5
TCATCGACGACCGTCG-1_V10B01-087_D1,1,0,1,0,1,3
TACTACGTGCAATGCG-1_V10B01-087_D1,3,0,0,0,0,3
CCCTACTTGAACAATG-1_V10B01-087_D1,1,1,1,0,0,3
GCAGCTGTCAACGCAT-1_V10B01-087_D1,1,1,0,0,1,3
ATCTACCATCTGCTCC-1_V10B01-087_D1,4,1,0,0,0,5
TCTCAAATCAATCGGG-1_V10B01-087_D1,4,1,2,4,1,12
ACTCCGGCCGACCACT-1_V10B01-087_D1,3,2,0,0,0,5
TACACCTCTTCGAATC-1_V10B01-087_D1,0,0,0,1,3,4
GTGGCTGTTTCTGTTC-1_V10B01-087_D1,0,1,2,1,0,4
ACGACTCTAGGGCCGA-1_V10B01-087_D1,3,1,2,0,0,6
TCGTTTACGCGACCCT-1_V10B01-087_D1,0,1,0,0,0,1
AGGATATCCGACTGCA-1_V10B01-087_D1,3,0,1,0,0,4
GACACTTCCAATTACC-1_V10B01-087_D1,3,2,0,0,0,5
ACGGTACAGTTCAATG-1_V10B01-087_D1,1,0,0,0,0,1
CTTGATGACCATCCAG-1_V10B01-087_D1,6,5,3,1,0,15
CTGGTAAAGACTTACA-1_V10B01-087_D1,1,4,3,0,0,8
CTTGCCCACCCACGCA-1_V10B01-087_D1,2,3,0,0,0,5
CATTACGCAGGAAGGG-1_V10B01-087_D1,1,5,0,5,0,11
GGACAACCATGAAGCC-1_V10B01-087_D1,2,0,0,1,0,3
GTTATCAAGCTATCGA-1_V10B01-087_D1,1,5,0,5,0,11
AGGTGCACGTCCACAT-1_V10B01-087_D1,3,2,2,1,0,8
AAAGAATGTGGACTAA-1_V10B01-087_D1,0,1,5,3,0,9
ACCAAGTCATCGGCAG-1_V10B01-087_D1,1,2,3,5,0,11
AGTAACTATAGCAGCC-1_V10B01-087_D1,0,0,4,0,0,4
GGGAAAGAATGCCAAC-1_V10B01-087_D1,4,0,1,0,0,5
AATCGGTATAGCCCTC-1_V10B01-087_D1,3,0,3,3,0,9
GGCACTGCGGTGGTTT-1_V10B01-087_D1,1,1,0,1,0,3
CGTCCTCATCGCGTGC-1_V10B01-087_D1,2,0,0,1,0,3
CTTAACTTACAGTATA-1_V10B01-087_D1,1,0,0,1,0,2
GTGAGTCGACTAATAG-1_V10B01-087_D1,2,2,0,0,0,4
TGTACTTCCGGGCATG-1_V10B01-087_D1,0,1,3,0,0,4
CACAAACCGCAGAACT-1_V10B01-087_D1,3,1,0,0,0,4
GCTTTACACAACTGGG-1_V10B01-087_D1,1,2,0,3,0,6
CACCGATGATGGGTAC-1_V10B01-087_D1,1,1,0,0,0,2
TCAATATACAGGAGGC-1_V10B01-087_D1,2,2,1,0,0,5
AACGACCTCCTAGCCG-1_V10B01-087_D1,0,3,0,5,0,8
GTTACCAAGGCGTACG-1_V10B01-087_D1,0,0,0,1,1,2
TAGCTCACTGTGTTTG-1_V10B01-087_D1,3,2,0,4,1,10
TCGGCAGGGTTAAGGG-1_V10B01-087_D1,0,1,1,4,2,8
CAGAGCGATGGATGCT-1_V10B01-087_D1,0,0,0,1,0,1
TCCGCTGGGTCGATCG-1_V10B01-087_D1,3,0,1,0,0,4
TTAGCATCCCTCACGT-1_V10B01-087_D1,4,1,0,0,0,5
AGCCTTGTCACTGATA-1_V10B01-087_D1,0,2,2,0,0,4
GTTTCTTGTTAGAGCT-1_V10B01-087_D1,3,1,0,0,0,4
TCGGAGTCCTGGTTGC-1_V10B01-087_D1,5,0,0,0,0,5
ACGGGTTGTGACCTGT-1_V10B01-087_D1,1,1,1,0,0,3
TGACAGAAATCTTGCT-1_V10B01-087_D1,0,1,1,0,0,2
TAGCCATGATTGCCTA-1_V10B01-087_D1,2,2,0,0,0,4
CGAAGCCACAGCATGG-1_V10B01-087_D1,5,0,1,0,0,6
ACCCGTAGCAGAGAAT-1_V10B01-087_D1,4,1,0,0,0,5
AGCTTGATCAGGGTAG-1_V10B01-087_D1,3,0,0,0,0,3
CTATAAGTAGGGTTTG-1_V10B01-087_D1,1,1,0,0,0,2
TATAGTTAGGTGTACT-1_V10B01-087_D1,2,0,0,0,0,2
TACGCTGATAGTTGTA-1_V10B01-087_D1,2,0,0,0,0,2
TTCTCAATTGCTACAA-1_V10B01-087_D1,2,0,0,0,0,2
GTTGCCCTAACGGGTG-1_V10B01-087_D1,3,0,1,0,0,4
GACATTTCGCCCAGCC-1_V10B01-087_D1,1,0,0,0,0,1
GTAACTACGTAGACCT-1_V10B01-087_D1,1,1,0,0,0,2
CCAGTGTACAGACCGA-1_V10B01-087_D1,0,0,0,0,0,0
GCCCGATGCCCAGTTC-1_V10B01-087_D1,1,2,2,0,0,5
CGAACCTCTTTCCTAG-1_V10B01-087_D1,3,0,0,0,0,3
CATGCACATGAGAGGC-1_V10B01-087_D1,4,1,0,0,0,5
CCAAATCAAAGGGCAA-1_V10B01-087_D1,3,0,1,1,0,5
GTAGTTTAAGCACACG-1_V10B01-087_D1,2,1,1,0,0,4
TAAGTGAATAGTCTAC-1_V10B01-087_D1,3,0,0,0,0,3
GGTCCACGTCTATTTG-1_V10B01-087_D1,5,0,0,0,0,5
CCCTCAGATCGAGAAC-1_V10B01-087_D1,3,2,0,0,0,5
ACATTCGCGCGGAATA-1_V10B01-087_D1,2,0,0,0,0,2
CTATGAACACCTTGCC-1_V10B01-087_D1,2,2,1,1,0,6
CGAATGGTAGGTCGTC-1_V10B01-087_D1,4,1,0,0,0,5
TCGACATAGCGTAGCG-1_V10B01-087_D1,4,1,3,0,0,8
GACGTTGCTCGGCGGC-1_V10B01-087_D1,1,3,3,0,0,7
CTCGAGGCAAGTTTCA-1_V10B01-087_D1,2,5,0,0,0,7
GCTGGGAGCGCGTCAA-1_V10B01-087_D1,3,1,1,0,0,5
GACGATATCACTGGGT-1_V10B01-087_D1,1,2,3,0,0,6
CAGCTCTGGGCTCACT-1_V10B01-087_D1,4,0,1,0,0,5
TAGTCTGCGGCACATT-1_V10B01-087_D1,1,0,0,0,0,1
TGGTCGATATACCTCT-1_V10B01-087_D1,1,0,0,0,0,1
TTCAGTTCAAGAGGAG-1_V10B01-087_D1,4,0,0,0,0,4
GTCTGTAGGTTGAACA-1_V10B01-087_D1,1,1,0,0,0,2
GAGAGTCTCGGGAGAG-1_V10B01-087_D1,1,0,1,0,0,2
TTGTTTGTATTACACG-1_V10B01-087_D1,0,0,0,1,1,2
GCACAGCACGGGCCGA-1_V10B01-087_D1,3,2,1,0,0,6
AAACAGTGTTCCTGGG-1_V10B01-087_D1,3,0,3,0,0,6
TGGAGAATAATCGTCC-1_V10B01-087_D1,1,1,1,0,0,3
CGCCGCGTTCTGAACG-1_V10B01-087_D1,0,1,2,0,0,3
CATGCGTTGAGAGGAG-1_V10B01-087_D1,2,0,1,1,0,4
TACGCTCCTAGAACTG-1_V10B01-087_D1,3,1,0,0,0,4
CCTTGTGAACGTGGTT-1_V10B01-087_D1,1,0,0,0,0,1
TTAAAGGCGATGCTCG-1_V10B01-087_D1,3,1,0,0,0,4
TAAAGTGCACGTCTCG-1_V10B01-087_D1,3,3,1,0,0,7
TGTCCGCAAACAATTC-1_V10B01-087_D1,4,1,0,0,0,5
AGGCCTATCATACCAA-1_V10B01-087_D1,2,0,0,0,0,2
ACTGGGATGCCAGTGC-1_V10B01-087_D1,0,0,0,0,0,0
CGATCCACCATTGTTG-1_V10B01-087_D1,1,0,0,1,0,2
GGGCATGCATGTCGAG-1_V10B01-087_D1,0,1,2,0,0,3
TCCAGGCAGGACGATC-1_V10B01-087_D1,2,0,0,0,1,3
CAATGACCCTTAATTT-1_V10B01-087_D1,4,1,1,0,0,6
ATCAAGATCCCAGGAC-1_V10B01-087_D1,1,0,1,0,0,2
CTCAGAGCTAATGTCG-1_V10B01-087_D1,2,1,0,0,0,3
CTGCGATTTCGAGATT-1_V10B01-087_D1,2,1,0,1,0,4
ATGGTATTGGGAACCG-1_V10B01-087_D1,1,3,1,0,0,5
TAGGTTCTGCTGAGAA-1_V10B01-087_D1,6,1,2,0,0,9
GCCTGTCCCGGTGCAT-1_V10B01-087_D1,2,0,2,0,0,4
GGCCTGCTCTGATGTT-1_V10B01-087_D1,1,1,1,0,0,3
TAGAGGGAGTTTATCT-1_V10B01-087_D1,1,0,2,0,0,3
CTCTACATCCTGCGTG-1_V10B01-087_D1,1,0,0,1,0,2
ACACATTTCCGTAGAC-1_V10B01-087_D1,3,1,1,0,0,5
TGGGTGTTAAGTAGAA-1_V10B01-087_D1,1,0,0,0,0,1
GAGCTCAACATGAGCG-1_V10B01-087_D1,0,0,0,0,0,0
GCACACAGCTATTACC-1_V10B01-087_D1,2,0,1,2,0,5
GCGACGGTAGTCTCCT-1_V10B01-087_D1,5,1,0,0,0,6
GTATCAAGGTACTTCC-1_V10B01-087_D1,1,3,0,0,0,4
GGAAAGGGAATTGAGC-1_V10B01-087_D1,2,1,1,1,0,5
TACACAGCCGTGGTGC-1_V10B01-087_D1,1,1,0,0,0,2
CGGTTGGGCAGGGTCC-1_V10B01-087_D1,1,0,0,1,0,2
GCACGCCGATTCCCGC-1_V10B01-087_D1,2,0,3,2,0,7
CGCTTTCCGCCAAGGT-1_V10B01-087_D1,2,2,0,4,1,9
TGCCCGATAGTTAGAA-1_V10B01-087_D1,1,1,0,6,0,8
TCAGAACGGCGGTAAT-1_V10B01-087_D1,1,2,1,3,0,7
CCACTCAGATCCGCAA-1_V10B01-087_D1,1,1,1,0,0,3
GAAGGGTCATTAAGAC-1_V10B01-087_D1,2,1,1,1,0,5
GCGGTCTTGCTTTCAC-1_V10B01-087_D1,1,0,1,0,0,2
GGAAGGACACCGTATA-1_V10B01-087_D1,1,0,0,1,1,3
CGCGGGAATTCCTTTC-1_V10B01-087_D1,0,0,1,0,1,2
TCTATCCGATTGCACA-1_V10B01-087_D1,2,0,0,2,2,6
TACTCGTTTGAATCAA-1_V10B01-087_D1,2,0,3,0,2,7
GTCTGCCGACTCGACG-1_V10B01-087_D1,3,2,1,1,3,10
TACGGGTAATAACATA-1_V10B01-087_D1,1,1,2,5,0,9
CCAGTTCGGTAACTCA-1_V10B01-087_D1,0,1,0,3,0,4
CGTGCACACCACTGTA-1_V10B01-087_D1,0,2,0,0,0,2
CTTCAGTTGGACAACG-1_V10B01-087_D1,2,1,1,0,0,4
TGATCTATCACACTCT-1_V10B01-087_D1,1,0,0,0,0,1
TAGCAGATACTTAGGG-1_V10B01-087_D1,3,0,0,0,0,3
CACCGGGCATCACAAG-1_V10B01-087_D1,5,0,1,1,0,7
AGTGGCCCGCAAATGG-1_V10B01-087_D1,2,1,0,0,0,3
CTCGCTAGGTAAGCGA-1_V10B01-087_D1,2,0,0,0,0,2
GATAGATAGTACAGTC-1_V10B01-087_D1,2,1,0,2,0,5
CGAGACTACTGCTGCT-1_V10B01-087_D1,1,3,1,1,0,6
ACATTTGAAACCTAAC-1_V10B01-087_D1,1,0,0,6,0,7
GACACAGCCGGGACTG-1_V10B01-087_D1,1,1,2,3,0,7
ACGGAACACGAGTGCC-1_V10B01-087_D1,1,1,0,4,0,6
ACGCCAGTGCGTTTGC-1_V10B01-087_D1,0,3,2,1,0,6
GCACCTAGGCGAGTCC-1_V10B01-087_D1,1,0,0,0,0,1
TCACTATCCCTTCGGT-1_V10B01-087_D1,3,2,2,3,0,10
ATTGGTTGTGCATTAC-1_V10B01-087_D1,3,1,1,2,0,7
CTGGCGATTTACATGT-1_V10B01-087_D1,1,0,0,0,1,2
TCCACCAAGACATAGG-1_V10B01-087_D1,2,1,0,1,0,4
AACGTCGCTGCACTTC-1_V10B01-087_D1,1,0,0,1,0,2
GTCTCCCGAGTCCCGT-1_V10B01-087_D1,2,1,0,0,0,3
AGCCCGCACTACAATG-1_V10B01-087_D1,1,0,0,0,0,1
GGCACGCTGCTACAGT-1_V10B01-087_D1,2,2,0,0,0,4
GCTTGAGTGACCTCTG-1_V10B01-087_D1,3,1,0,0,0,4
ATAGCCATAACAGTCA-1_V10B01-087_D1,2,0,0,3,0,5
TAGGAGGCTCGAGAAC-1_V10B01-087_D1,1,4,0,3,0,8
GTCGGGTGAAGTACCG-1_V10B01-087_D1,4,2,0,0,0,6
CACCCGCGTTTGACAC-1_V10B01-087_D1,0,2,0,3,0,5
TCTCAGGCTACTCGCT-1_V10B01-087_D1,0,1,0,3,1,5
CCCATTATTGTATCCT-1_V10B01-087_D1,0,0,0,0,0,0
ATACAGCGTCCACTGA-1_V10B01-087_D1,1,1,0,1,0,3
TCACGATTAATACGTT-1_V10B01-087_D1,0,4,0,0,0,4
CGTGAACTGACCCGAT-1_V10B01-087_D1,0,2,0,1,0,3
TCGATGTTACGGCCGT-1_V10B01-087_D1,0,1,0,0,0,1
GACCGGTGATACTCTC-1_V10B01-087_D1,5,1,1,0,0,7
TCTGTTTAGATTGTTC-1_V10B01-087_D1,3,0,0,0,0,3
GCTACTCGGACGCAGA-1_V10B01-087_D1,5,3,0,0,0,8
AAGAAAGTTTGATGGG-1_V10B01-087_D1,1,2,0,0,0,3
CGCCAGTAGTACCTTG-1_V10B01-087_D1,2,1,0,0,0,3
CTCCCTTGTATCAAGG-1_V10B01-087_D1,6,1,0,2,1,10
ACTTTATACACCACTT-1_V10B01-087_D1,5,0,0,1,0,6
AGATCTGGAGAGGATA-1_V10B01-087_D1,1,2,0,3,0,6
TCATCCATCTGATCAC-1_V10B01-087_D1,2,2,0,0,0,4
AGAACACGGCGATGGT-1_V10B01-087_D1,5,2,0,5,0,12
CCGCTCCGGATAAGCT-1_V10B01-087_D1,5,0,0,0,2,7
TGGTCGGGTACAGGGC-1_V10B01-087_D1,2,0,1,3,0,6
ACGGACGCAGCGACAA-1_V10B01-087_D1,5,0,0,0,0,5
ACATGCTTACGGCAGC-1_V10B01-087_D1,0,1,0,4,0,5
CAGGGAGATAGGCCAG-1_V10B01-087_D1,4,0,0,0,0,4
TCGCCACCCGGATTAC-1_V10B01-087_D1,2,2,1,2,0,7
TCTTGGTCAATGATAC-1_V10B01-087_D1,4,0,0,0,0,4
CATAGGGACACTTGTG-1_V10B01-087_D1,0,0,0,0,0,0
CACGAGCAAACCAGAC-1_V10B01-087_D1,2,2,0,1,0,5
GGGATATTGATCGCCA-1_V10B01-087_D1,1,0,2,4,0,7
TAATGTCGGTTCATGG-1_V10B01-087_D1,4,2,0,0,0,6
CGATTTGTCATTAATG-1_V10B01-087_D1,3,1,0,1,0,5
TTAAGATACCCAGAGA-1_V10B01-087_D1,7,1,0,0,0,8
CGACCGTTGGTATTCG-1_V10B01-087_D1,2,4,0,0,0,6
ACTACCATCCGAGGGC-1_V10B01-087_D1,3,2,1,0,0,6
TCTACGCACGATCTCC-1_V10B01-087_D1,1,0,0,1,0,2
AAGCCACTTGCAGGTA-1_V10B01-087_D1,3,2,1,0,0,6
ACGTTGTCGTTGAAAG-1_V10B01-087_D1,3,1,0,0,0,4
ACCGCTAGTCATTGGT-1_V10B01-087_D1,5,1,0,0,0,6
CATGAGTCCATCACGG-1_V10B01-087_D1,3,1,2,0,0,6
ATGTCTTGTTTGACTC-1_V10B01-087_D1,1,3,1,0,0,5
TCCCAAACATCCTCTA-1_V10B01-087_D1,0,0,1,0,0,1
CAACGCGATGAGCCAA-1_V10B01-087_D1,2,3,0,0,0,5
GACACCCAAAGACGCG-1_V10B01-087_D1,3,2,2,0,0,7
ACGTTCACTATGCCGC-1_V10B01-087_D1,1,0,1,0,0,2
ATGGACTGCTTAGTTG-1_V10B01-087_D1,3,0,1,0,0,4
CCATGGCAAACGCTCA-1_V10B01-087_D1,1,1,1,0,0,3
TTGTCTCGGCAAGATG-1_V10B01-087_D1,3,1,3,0,0,7
TTCGAACGAAACATGC-1_V10B01-087_D1,3,1,0,0,0,4
GGAAAGTCTTGATTGT-1_V10B01-087_D1,0,1,2,1,0,4
ATCATAGATCGACGAG-1_V10B01-087_D1,2,2,1,1,0,6
GATTAGAAACAAGCGT-1_V10B01-087_D1,1,1,0,0,0,2
GCTGCGAAGAATTATT-1_V10B01-087_D1,0,0,0,0,0,0
TTCCAGTGGGTTTCGT-1_V10B01-087_D1,2,1,3,0,0,6
GCTCATTGATCATATC-1_V10B01-087_D1,0,1,0,2,0,3
ATACGAGGTTTGTAAG-1_V10B01-087_D1,1,0,0,1,0,2
GTCTATACACGCATGG-1_V10B01-087_D1,1,0,1,0,0,2
GATTTGCGCTAACACC-1_V10B01-087_D1,3,1,1,0,0,5
TGGTGCCCTGCCTTAC-1_V10B01-087_D1,3,0,0,1,0,4
TCGAATCGCAGGGTAG-1_V10B01-087_D1,0,1,0,1,0,2
GGTAGGCCAATATCAC-1_V10B01-087_D1,3,2,0,1,0,6
CGTAAATAACAAAGGG-1_V10B01-087_D1,0,0,0,1,0,1
GACTCTAGAGTTCCAA-1_V10B01-087_D1,1,1,3,1,0,6
ACTTGTTACCGGATCA-1_V10B01-087_D1,5,1,0,0,0,6
GGCATTGAACATCTCA-1_V10B01-087_D1,0,0,0,2,0,2
AACCCGCTGTATTCCA-1_V10B01-087_D1,0,1,0,0,0,1
TAACAGGTTCCCTTAG-1_V10B01-087_D1,1,1,0,0,0,2
GTTCTTGTAACTCAAT-1_V10B01-087_D1,2,1,0,1,0,4
GATTCTGTTAATGAGT-1_V10B01-087_D1,1,1,0,0,0,2
GGACACCTCGGTGTTG-1_V10B01-087_D1,3,0,3,0,0,6
CGATCGAGAAGCACCA-1_V10B01-087_D1,1,0,1,2,0,4
CTGCTCTGACGGCAAA-1_V10B01-087_D1,1,1,1,0,0,3
CCCAGGAAGAATTCGA-1_V10B01-087_D1,1,1,0,0,0,2
TGTCGTGGGTATAGGC-1_V10B01-087_D1,0,1,0,1,0,2
ATATGTCTAGAGCGTG-1_V10B01-087_D1,2,0,2,0,0,4
GCGGGCAGACGGGTGA-1_V10B01-087_D1,2,0,0,0,0,2
CGAAGATCAGTTTCAT-1_V10B01-087_D1,0,0,0,1,0,1
ACGCCACTCGAAACAG-1_V10B01-087_D1,0,1,0,1,0,2
CTTAGATGTTTCATCC-1_V10B01-087_D1,1,0,0,2,0,3
GCGAATGGACTAGCGA-1_V10B01-087_D1,0,2,0,1,0,3
TAAATTGTGGGTAAAG-1_V10B01-087_D1,0,1,1,1,0,3
ATTTATACTGGTAAAG-1_V10B01-087_D1,0,3,0,3,0,6
GCGTCGTAACATGGTC-1_V10B01-087_D1,0,0,2,2,0,4
CGGTATGGGCACTCTG-1_V10B01-087_D1,1,2,1,2,0,6
CTATCACAACGCTGGA-1_V10B01-087_D1,0,2,0,5,0,7
ACCACACGGTTGATGG-1_V10B01-087_D1,1,1,0,1,0,3
TCAGCGCACGCCGTTT-1_V10B01-087_D1,2,0,0,0,0,2
AATGTTAAGACCCTGA-1_V10B01-087_D1,0,0,2,9,0,11
CTTACATAGATTTCTT-1_V10B01-087_D1,1,2,1,1,0,5
AACATAGCGTGTATCG-1_V10B01-087_D1,0,1,4,2,0,7
AGCAGTCGAAGCATGC-1_V10B01-087_D1,0,1,0,3,0,4
GTACTACGGCCTCGTT-1_V10B01-087_D1,0,1,0,2,0,3
TTGGCCAAATTGTATC-1_V10B01-087_D1,0,1,0,1,1,3
TCAGAGGACGCGTTAG-1_V10B01-087_D1,1,2,1,2,0,6
AGTAATCTAAGGGTGG-1_V10B01-087_D1,4,2,0,2,0,8
AATTATACCCAGCAAG-1_V10B01-087_D1,0,1,1,6,0,8
CCCTACCCACACCCAG-1_V10B01-087_D1,6,1,0,0,0,7
CTCTGTCCATGCACCA-1_V10B01-087_D1,0,0,0,8,0,8
TCGCCTCCTTCGGCTC-1_V10B01-087_D1,5,1,0,2,0,8
CCTGATTCGCGAAGAA-1_V10B01-087_D1,0,0,0,4,0,4
GACTTCAACGCATCAA-1_V10B01-087_D1,2,0,0,2,0,4
GCTTCCCGTAAGCTCC-1_V10B01-087_D1,0,0,0,0,0,0
AGAACTGTACTTTGTA-1_V10B01-087_D1,1,1,0,4,0,6
CCTTAAGTACGCAATT-1_V10B01-087_D1,0,0,0,0,0,0
GGCCAATTGTATAGAC-1_V10B01-087_D1,0,1,0,1,0,2
AGAATACAGGCTATCC-1_V10B01-087_D1,1,0,0,0,0,1
AATACCTGATGTGAAC-1_V10B01-087_D1,2,0,0,0,0,2
GCTTCCATGTAACCGC-1_V10B01-087_D1,0,0,0,0,0,0
TCTAACCTAGCCTGCG-1_V10B01-087_D1,0,0,0,0,0,0
GTCTTACCACGCCAAG-1_V10B01-087_D1,7,0,0,0,0,7
CGTTTCGGTTATATGC-1_V10B01-087_D1,0,0,0,1,0,1
CTGTCCTGCGCACTAC-1_V10B01-087_D1,1,0,0,1,0,2
GCCCAGCGACACAAAG-1_V10B01-087_D1,4,2,0,1,0,7
TATAGCTATTATCTCT-1_V10B01-087_D1,2,0,0,0,0,2
AAGCTATGGATTGACC-1_V10B01-087_D1,1,1,0,0,0,2
CCGAAACACGACCTCT-1_V10B01-087_D1,5,1,0,0,0,6
ATCAGAAGCTGGTTGC-1_V10B01-087_D1,0,2,0,0,0,2
TGAACCTGAATGTGAG-1_V10B01-087_D1,2,0,1,0,0,3
TCAGAGCATGTCAACG-1_V10B01-087_D1,4,0,0,0,0,4
ATACCCTCCCGGCCAA-1_V10B01-087_D1,2,0,0,0,0,2
GCCACCTTATTCGCGA-1_V10B01-087_D1,1,1,0,0,0,2
CAACGAGCTTATTATG-1_V10B01-087_D1,4,0,0,0,0,4
GATCCAACCTTTAAAC-1_V10B01-087_D1,1,0,0,0,0,1
TTGTGGAGACAGCCGG-1_V10B01-087_D1,5,3,0,1,0,9
AGATAATCACACCTAT-1_V10B01-087_D1,3,1,0,0,0,4
GGTTAGGGATGCTAAT-1_V10B01-087_D1,1,2,0,0,0,3
TCATGAAGCGCTGCAT-1_V10B01-087_D1,7,0,2,0,0,9
CCAGGCGAGATGGTCT-1_V10B01-087_D1,1,3,0,1,0,5
CGACTTGCCGGGAAAT-1_V10B01-087_D1,3,0,0,0,0,3
GTGCCAAACGTTTCGA-1_V10B01-087_D1,0,2,0,7,0,9
TGCTCAAAGGATGCAC-1_V10B01-087_D1,0,0,0,0,0,0
GCCTCAGGTACCGGTC-1_V10B01-087_D1,0,2,0,6,0,8
ACAAGTAATTGTAAGG-1_V10B01-087_D1,1,1,0,0,0,2
TTAGAGTATTGTCGAG-1_V10B01-087_D1,3,5,0,2,0,10
GTCATCCCAAACTCAC-1_V10B01-087_D1,2,1,0,1,0,4
CTCCTAGTAATCGTGA-1_V10B01-087_D1,0,0,0,4,0,4
CCCTCATCACAGAGTA-1_V10B01-087_D1,1,0,1,0,0,2
GGAAACAGAGCTTGGG-1_V10B01-087_D1,0,2,0,3,0,5
ACATCGCAATATTCGG-1_V10B01-087_D1,0,0,0,1,0,1
TTAGCCATAGGGCTCG-1_V10B01-087_D1,7,2,2,6,0,17
CGGATTCTGCCTTATG-1_V10B01-087_D1,3,2,0,3,0,8
TTGTTGGCAATGACTG-1_V10B01-087_D1,0,2,0,2,0,4
GGATCTACCGTTCGTC-1_V10B01-087_D1,1,3,0,3,0,7
GGTGGGATTAGGTCCC-1_V10B01-087_D1,0,2,1,4,0,7
AATAGGCACGACCCTT-1_V10B01-087_D1,0,0,1,2,0,3
GAGGTCCGTTCGCTGT-1_V10B01-087_D1,0,1,1,1,0,3
TGACAACTTAAAGGTG-1_V10B01-087_D1,1,4,0,0,0,5
AGCTAAGCTCCGTCCG-1_V10B01-087_D1,0,2,1,4,0,7
CTAGCCCGGGAGACGA-1_V10B01-087_D1,2,0,0,2,0,4
CCCAGATTCCCGTGAC-1_V10B01-087_D1,2,0,0,1,0,3
GCCCGTTCACACAATT-1_V10B01-087_D1,0,0,0,5,0,5
ACAAACTCCATCAGAG-1_V10B01-087_D1,1,2,1,0,0,4
GGTTCCGTACGACTAA-1_V10B01-087_D1,0,3,0,2,0,5
TTGCGGAAAGCTGCCC-1_V10B01-087_D1,0,1,0,0,0,1
GGAACTCGTGAATACG-1_V10B01-087_D1,0,0,0,3,0,3
GGTTACCGCTCCCTAC-1_V10B01-087_D1,4,1,0,0,0,5
AGCGACTTTGAAGACA-1_V10B01-087_D1,1,2,0,0,0,3
CCGTTTCCTTTCCGTG-1_V10B01-087_D1,0,0,0,0,0,0
TGGATGGCATCTTGGA-1_V10B01-087_D1,4,3,0,1,0,8
CAAGTCGTTGAAATCT-1_V10B01-087_D1,3,1,0,0,0,4
TGCAAACGTACTAGTT-1_V10B01-087_D1,2,1,0,0,0,3
GGCTGTCCTACTGCGG-1_V10B01-087_D1,1,0,0,0,0,1
TACTGCATGATTAAAT-1_V10B01-087_D1,5,0,0,0,0,5
CGGACCTCTGTAGTTA-1_V10B01-087_D1,2,0,1,1,0,4
CCCTAGCTCTAAGGTC-1_V10B01-087_D1,2,2,0,0,0,4
GTAACAGGTTAACGGC-1_V10B01-087_D1,6,0,1,0,0,7
CCCGCAAATAATCATC-1_V10B01-087_D1,0,2,0,0,0,2
AATCCCGCTCAGAGCC-1_V10B01-087_D1,2,1,0,0,0,3
AACGTCATCCGGCTTG-1_V10B01-087_D1,2,1,0,1,0,4
CTCGTGGCACTGAAAG-1_V10B01-087_D1,2,0,0,1,0,3
CTTTATCCGACGCATG-1_V10B01-087_D1,3,1,0,0,0,4
AAATGACTGATCAAAC-1_V10B01-087_D1,5,1,0,1,0,7
TTCGTGCATGTTATAG-1_V10B01-087_D1,4,0,0,0,0,4
ATCAAAGAGCCGTGGT-1_V10B01-087_D1,1,3,0,1,0,5
ATGTCATAATAAACGA-1_V10B01-087_D1,1,0,0,2,0,3
CTTAATCGACTTAGTA-1_V10B01-087_D1,3,1,2,1,0,7
CTAAAGGATGAGATAC-1_V10B01-087_D1,0,0,0,3,0,3
GTGCTATCCAGCTGGA-1_V10B01-087_D1,0,0,0,1,0,1
GACAGAGGTCTTCAGT-1_V10B01-087_D1,0,3,0,4,0,7
TCGATTTACGAAACGA-1_V10B01-087_D1,1,2,0,4,0,7
AGGCTTAAGTTGCACA-1_V10B01-087_D1,0,2,0,9,0,11
TAGGATCTTAACCGCA-1_V10B01-087_D1,0,0,1,4,0,5
GACTTTCGAGCGGTTC-1_V10B01-087_D1,0,1,0,4,0,5
CCCTGGGAGGGATCCT-1_V10B01-087_D1,0,3,0,1,0,4
TAGTAGTTGCCGGACA-1_V10B01-087_D1,0,1,0,1,0,2
GCCCTAAGTGCAGGAT-1_V10B01-087_D1,0,0,0,9,0,9
ACTTGGGCTTTCGCCA-1_V10B01-087_D1,0,0,0,1,0,1
CATGATACGGTGAAAC-1_V10B01-087_D1,0,0,0,6,0,6
TCCTGCAGCCGCCAAT-1_V10B01-087_D1,0,1,0,10,0,11
GTCCGTTAGAGGGCCT-1_V10B01-087_D1,0,1,0,1,0,2
GCTTTATTAAGTTACC-1_V10B01-087_D1,0,0,0,1,0,1
AATCGAGGTCTCAAGG-1_V10B01-087_D1,0,5,0,5,0,10
GTGCTGTTAGAACATA-1_V10B01-087_D1,0,0,0,1,0,1
GGCTTCTCGTGGGTGG-1_V10B01-087_D1,2,2,0,2,0,6
CCTACAGTTGAGGGAG-1_V10B01-087_D1,0,0,0,0,0,0
TATCCCTCGATCTGCA-1_V10B01-087_D1,0,0,0,0,0,0
CCGGTATCTGGCGACT-1_V10B01-087_D1,0,0,0,3,0,3
CTCTAACACCGGCAGC-1_V10B01-087_D1,1,1,0,3,0,5
CTTCATCACCAGGGCT-1_V10B01-087_D1,0,0,0,2,0,2
GGCTGGCAATCCCACG-1_V10B01-087_D1,0,0,0,0,0,0
CAAACCATAAGCGTAT-1_V10B01-087_D1,0,0,0,1,0,1
CATGTGGGCTCATCAC-1_V10B01-087_D1,0,1,0,4,0,5
GATTATCTTGCATTAT-1_V10B01-087_D1,0,0,0,0,0,0
TGTACTATCGCTCGTT-1_V10B01-087_D1,0,0,0,0,0,0
