key,other,microglia,oligo,astrocyte,neuron,n_cells
CTCATGGCTCACAATC-1_V10B01-087_A1,1,0,0,0,0,1
ATCTGTAATTGTACCC-1_V10B01-087_A1,0,1,0,2,0,3
TTATTAGGGAAGCATC-1_V10B01-087_A1,0,1,0,5,0,6
CTTCTTACGTCGTATA-1_V10B01-087_A1,0,0,0,0,0,0
GAAGTGCTGGATAGCT-1_V10B01-087_A1,2,1,3,0,0,6
GTGCAACAAATGTGGC-1_V10B01-087_A1,0,2,1,0,0,3
CATGCGTTAGACAGAA-1_V10B01-087_A1,1,0,0,0,0,1
ACACACTTTCTACACG-1_V10B01-087_A1,6,1,3,0,0,10
AGCCCTAAGCGAAGTT-1_V10B01-087_A1,1,1,1,2,0,5
ATTAATTCGGTCACTC-1_V10B01-087_A1,0,0,0,0,0,0
AACAGGAAATCGAATA-1_V10B01-087_A1,0,0,0,0,0,0
ACCAAGAACGCGTGTC-1_V10B01-087_A1,0,0,0,0,0,0
GATGCTACAAGCGCCT-1_V10B01-087_A1,0,2,0,1,0,3
GTTCCAGTCTGACCAT-1_V10B01-087_A1,0,2,0,6,0,8
ATGATCGGGAATAGAC-1_V10B01-087_A1,0,0,0,0,0,0
TTGGATTGGGTACCAC-1_V10B01-087_A1,1,1,2,0,0,4
TACCTCACGCTTGTAC-1_V10B01-087_A1,0,2,0,5,0,7
CATGGCAGGAAGATCG-1_V10B01-087_A1,1,0,3,0,0,4
ATGACGCCGGCTCTAA-1_V10B01-087_A1,0,3,1,4,0,8
AGCGACATCCCATTCA-1_V10B01-087_A1,2,1,1,0,0,4
AGTAATGTCTTGCCGC-1_V10B01-087_A1,1,4,2,0,0,7
TTCTTAGTGGCTCAGA-1_V10B01-087_A1,0,3,1,0,0,4
CGTCTGGAAGGGCCCG-1_V10B01-087_A1,0,5,1,0,0,6
ACGTGCGCCTCGTGCA-1_V10B01-087_A1,2,3,0,0,1,6
AGAGCGGGCTAATCAT-1_V10B01-087_A1,0,7,1,0,0,8
GCGTCGAAATGTCGGT-1_V10B01-087_A1,2,0,2,0,0,4
AACTGATATTAGGCCT-1_V10B01-087_A1,3,3,2,0,0,8
CGAGCTGGGCTTTAGG-1_V10B01-087_A1,1,1,0,1,0,3
GGGTGTTTCAGCTATG-1_V10B01-087_A1,1,1,1,0,0,3
TTAATTTCAGACGCGG-1_V10B01-087_A1,3,1,1,1,0,6
CACTGTCCAAGTGAGA-1_V10B01-087_A1,0,0,0,0,0,0
ATTACTAGCCTCTTGC-1_V10B01-087_A1,0,0,0,0,0,0
CATAGTAGCATAGTAG-1_V10B01-087_A1,0,2,0,2,0,4
CAACTCCTTGATCCCG-1_V10B01-087_A1,0,0,0,0,0,0
AAGTAGAAGACCGGGT-1_V10B01-087_A1,0,2,0,2,0,4
GCGGGAACCAGGCCCT-1_V10B01-087_A1,0,0,0,4,0,4
ATTAGATTGATAGCGG-1_V10B01-087_A1,1,3,0,1,0,5
CTCGGTCCGTAGCCTG-1_V10B01-087_A1,0,3,0,3,0,6
TGGCTTTGGGTAGACA-1_V10B01-087_A1,1,0,2,0,0,3
TATCCATATCATGCGA-1_V10B01-087_A1,1,0,1,2,0,4
GGAGTGCCGCCCTGGA-1_V10B01-087_A1,1,2,0,1,0,4
TGAGAATGCTTTACCG-1_V10B01-087_A1,2,1,1,0,1,5
TTAACCAACCCTCCCT-1_V10B01-087_A1,1,2,3,0,0,6
TGTTTCGGTACTTCTC-1_V10B01-087_A1,1,2,2,0,0,5
TTGCTGAAGGAACCAC-1_V10B01-087_A1,0,2,2,0,0,4
TATTTAGTCTAGATCG-1_V10B01-087_A1,2,0,2,0,0,4
CTCCGGCCTAATATGC-1_V10B01-087_A1,1,3,0,1,1,6
TTGTGGCCCTGACAGT-1_V10B01-087_A1,1,2,1,0,0,4
TCGCCGGTCGATCCGT-1_V10B01-087_A1,1,1,3,0,2,7
CCATAGGTTGGCGTGG-1_V10B01-087_A1,2,3,1,0,0,6
GAACGACCGAATGATA-1_V10B01-087_A1,0,2,1,0,0,3
TCCGATAATTGCCATA-1_V10B01-087_A1,0,0,1,0,0,1
CATTACGTCGGCCCGT-1_V10B01-087_A1,0,3,3,0,1,7
CAAGCACCAAATGCCT-1_V10B01-087_A1,1,1,4,0,0,6
TGCATGGATCGGATCT-1_V10B01-087_A1,1,1,0,0,0,2
GAAATCGCGCGCAACT-1_V10B01-087_A1,3,1,2,0,0,6
CTGAAAGAGATCCGAC-1_V10B01-087_A1,0,3,2,1,0,6
CACCTCGATGGTGGAC-1_V10B01-087_A1,1,1,5,1,0,8
ATTTGTTCCAGGGCTC-1_V10B01-087_A1,1,2,4,0,0,7
TGGGCCACAAGAGCGC-1_V10B01-087_A1,2,0,1,0,0,3
CCTTCTTGATCCAGTG-1_V10B01-087_A1,0,1,1,3,0,5
TTCATGGCGCAACAGG-1_V10B01-087_A1,2,1,0,0,0,3
TAACAAAGGGAGAAGC-1_V10B01-087_A1,0,0,0,0,0,0
TCTGAACCGGTCGGCT-1_V10B01-087_A1,0,0,0,0,0,0
TATAAGTGAGGATAGC-1_V10B01-087_A1,0,4,0,1,1,6
GCCCGCGCGTTTGACA-1_V10B01-087_A1,0,0,0,0,0,0
TGCTGGTTGGACAATT-1_V10B01-087_A1,0,3,0,6,1,10
GCCTAGCGATCTGACC-1_V10B01-087_A1,0,2,2,0,0,4
TATAAATCCACAAGCT-1_V10B01-087_A1,0,3,0,4,0,7
CGCTCGACATAATGAT-1_V10B01-087_A1,0,7,2,0,0,9
CCAATTGAATGTTAAT-1_V10B01-087_A1,1,2,1,0,1,5
GCTAATACCGAATGCC-1_V10B01-087_A1,0,5,0,1,0,6
TTCAACGACCCGACCG-1_V10B01-087_A1,1,3,4,0,0,8
TTCCTCGAGGGTGTCT-1_V10B01-087_A1,0,6,1,0,1,8
CAACGACCCGTTTACA-1_V10B01-087_A1,0,2,3,0,0,5
CTTGTACTTGTTGACT-1_V10B01-087_A1,0,5,2,0,1,8
TCTCTAATAGCTGGTA-1_V10B01-087_A1,0,3,2,0,0,5
ATTATGCCATAGGGAG-1_V10B01-087_A1,0,1,4,0,0,5
GACAACGCAGCTTACG-1_V10B01-087_A1,0,3,1,1,0,5
AGATGACTCGCCCACG-1_V10B01-087_A1,0,3,1,0,0,4
GTGCGGGTCTCCAAAT-1_V10B01-087_A1,0,5,2,0,0,7
GTACGAGATTGCGACA-1_V10B01-087_A1,1,3,5,0,0,9
GTATAGGACTCAGTAG-1_V10B01-087_A1,0,9,1,0,0,10
TTGCACGGAGCAGCAC-1_V10B01-087_A1,0,3,2,0,1,6
CACAGCTAGGGAGTGA-1_V10B01-087_A1,3,9,1,0,0,13
ATACTAGCATGACCCT-1_V10B01-087_A1,1,4,0,0,0,5
CCAAGACTTCTGCGAA-1_V10B01-087_A1,1,8,0,0,0,9
ACATAATAAGGCGGTG-1_V10B01-087_A1,0,2,1,0,0,3
TAATACACAGTAGTAT-1_V10B01-087_A1,0,6,1,0,1,8
TCTTGGTAACACCAAA-1_V10B01-087_A1,0,2,5,2,2,11
AACTGGGTCCCGACGT-1_V10B01-087_A1,0,4,2,2,0,8
ATCACTTCATCCTCGC-1_V10B01-087_A1,3,1,1,0,0,5
TGGAAGGATAAAGATG-1_V10B01-087_A1,0,1,2,0,0,3
CATGATGCACAATTCT-1_V10B01-087_A1,3,3,1,1,0,8
TGCCTGATCAAACGAT-1_V10B01-087_A1,0,3,1,2,0,6
ATAGGGATATCCTTGA-1_V10B01-087_A1,0,0,3,0,1,4
CACCTAATCAGTTTAC-1_V10B01-087_A1,3,2,3,0,1,9
TGTGACTACGCCAGTC-1_V10B01-087_A1,0,3,4,1,1,9
CCCGACCATAGTCCGC-1_V10B01-087_A1,1,0,2,2,0,5
CGCGCCCGACTTAATA-1_V10B01-087_A1,1,2,1,0,0,4
TGCCACCTGGCGAAAC-1_V10B01-087_A1,3,0,0,0,0,3
CTGCCAAGGTTGGAAG-1_V10B01-087_A1,3,0,0,0,0,3
TAAATGAATCCGTTTC-1_V10B01-087_A1,0,0,0,0,0,0
GTCACTCTCCAAATCT-1_V10B01-087_A1,0,1,0,0,2,3
CGCAATTACTTTCGGT-1_V10B01-087_A1,0,4,1,0,2,7
CTGTTCATCTCACGGG-1_V10B01-087_A1,0,0,0,0,0,0
TTCTTGTAACCTAATG-1_V10B01-087_A1,0,3,0,2,1,6
GCTTGATGATAATCAG-1_V10B01-087_A1,0,2,0,2,1,5
TTGGCTCGCATGAGAC-1_V10B01-087_A1,1,0,0,0,0,1
GCCCAGTTGGTATGCC-1_V10B01-087_A1,1,2,0,3,1,7
ATTCCTCCGCCAGTGC-1_V10B01-087_A1,3,1,0,0,0,4
TCGTCCGCTGGCGTCT-1_V10B01-087_A1,0,0,2,1,0,3
GGAGAAGTCATTGGCA-1_V10B01-087_A1,0,0,0,0,2,2
TTGTTAGCAAATTCGA-1_V10B01-087_A1,0,2,2,0,0,4
TCTAGCATCTTCGATG-1_V10B01-087_A1,4,1,1,0,1,7
TTCTAGGCCAATTGTG-1_V10B01-087_A1,0,2,4,0,0,6
TCACGGTCATCGCACA-1_V10B01-087_A1,0,0,0,1,0,1
ATGAAGCCAAGGAGCC-1_V10B01-087_A1,1,1,3,0,1,6
AATGACTGTCAGCCGG-1_V10B01-087_A1,2,0,0,0,0,2
CCAAACAGAACCCTCG-1_V10B01-087_A1,0,1,0,0,0,1
TATCGATGATTAAACG-1_V10B01-087_A1,0,0,1,0,0,1
GAACACACATCAACCA-1_V10B01-087_A1,2,0,2,0,3,7
CCCGTCAGCGTCTGAC-1_V10B01-087_A1,1,0,0,0,0,1
AGCATCGTCGATAATT-1_V10B01-087_A1,2,2,3,0,0,7
GACTAAGATCATGCAC-1_V10B01-087_A1,0,0,3,1,0,4
TAGGGTGTTTCAAGAG-1_V10B01-087_A1,1,1,1,0,0,3
TGGTTCGTAGCAAAGG-1_V10B01-087_A1,1,2,2,1,0,6
CTGTTCACTGCCTGTG-1_V10B01-087_A1,0,2,0,0,0,2
ATGTGCATCCGACGCA-1_V10B01-087_A1,0,2,1,0,0,3
TTGTCGTTCAGTTACC-1_V10B01-087_A1,1,2,6,0,1,10
CGGGATCAATGTAAGA-1_V10B01-087_A1,0,0,1,2,0,3
TTATCTGTATCATAAC-1_V10B01-087_A1,1,1,1,0,0,3
ATCGACTCTTTCCGTT-1_V10B01-087_A1,3,1,1,0,0,5
CTCATTTGATGGGCGG-1_V10B01-087_A1,3,1,1,0,0,5
GTAAGCGGGCAGTCAG-1_V10B01-087_A1,0,0,1,1,0,2
TCTATCGGTCGCAACA-1_V10B01-087_A1,2,0,0,0,0,2
AACGCGGTCTCCAGCC-1_V10B01-087_A1,2,1,3,2,1,9
ATTAATACTACGCGGG-1_V10B01-087_A1,1,0,3,2,0,6
CTTTAACTTTCAAAGG-1_V10B01-087_A1,6,0,2,3,1,12
CGTACCTGATAGGCCT-1_V10B01-087_A1,2,0,2,1,0,5
GAATGTTGGGTAATCT-1_V10B01-087_A1,0,0,0,1,0,1
TGCGGAGTAAAGGTGC-1_V10B01-087_A1,1,1,1,0,1,4
CCTGAATATTTACATA-1_V10B01-087_A1,1,0,1,2,0,4
TTGCTCCCATACCGGA-1_V10B01-087_A1,0,4,4,2,0,10
CCTCTAATCTGCCAAG-1_V10B01-087_A1,1,0,1,1,0,3
AGGTTGAGGCACGCTT-1_V10B01-087_A1,3,1,0,1,0,5
TCCCGTCAGTCCCGCA-1_V10B01-087_A1,2,1,1,0,0,4
TCCGATGACTGAGCTC-1_V10B01-087_A1,1,0,4,3,0,8
CAGCCTCCTGCAGAGG-1_V10B01-087_A1,0,2,3,2,0,7
CTTAGCCTTCCACATG-1_V10B01-087_A1,1,0,2,1,0,4
ATTAATGAACCAGTCG-1_V10B01-087_A1,3,0,2,0,0,5
CCCGGTGGAAGAACCT-1_V10B01-087_A1,0,1,0,0,0,1
GATTCCTATACGGCGC-1_V10B01-087_A1,1,2,0,0,2,5
TTACCCTAACAGTCCT-1_V10B01-087_A1,0,0,0,0,0,0
ACCCACCTACATGCTC-1_V10B01-087_A1,0,1,0,0,0,1
AAAGGGCAGCTTGAAT-1_V10B01-087_A1,0,1,0,0,0,1
CACACAGGGATAGATT-1_V10B01-087_A1,0,0,1,0,1,2
AGAGCGTACAAGCTCG-1_V10B01-087_A1,1,7,0,0,0,8
TCTTACGGCATCCGAC-1_V10B01-087_A1,1,3,0,0,1,5
GCCTATTCCGATATAG-1_V10B01-087_A1,0,3,1,0,2,6
GAAAGTGACTAACTGC-1_V10B01-087_A1,0,2,0,0,0,2
CCGGAATGGTTTCAGT-1_V10B01-087_A1,0,2,0,0,2,4
AGTATAATACTAGGCA-1_V10B01-087_A1,1,0,0,0,0,1
TAACTATCGAAGGTCC-1_V10B01-087_A1,0,0,0,0,1,1
ATGAGGAGTGTTAATC-1_V10B01-087_A1,0,0,0,0,0,0
TGTGTCGCGAGTTGCA-1_V10B01-087_A1,0,0,0,0,1,1
ATCCAACGCAGTCATA-1_V10B01-087_A1,0,0,3,0,0,3
AAGGCGCGTAAAGCTT-1_V10B01-087_A1,1,1,0,0,1,3
AGTCGGCCCAAACGAC-1_V10B01-087_A1,2,4,4,0,1,11
AACGTCAGACTAGTGG-1_V10B01-087_A1,0,0,1,0,1,2
ACTACCAGCTCTCTGG-1_V10B01-087_A1,0,0,0,0,0,0
GCAAGTGCACAGAGAA-1_V10B01-087_A1,0,0,1,0,0,1
ACACCTTAAGTAGGGC-1_V10B01-087_A1,5,0,1,0,0,6
TTCGACGGGAAGGGCG-1_V10B01-087_A1,2,0,1,0,1,4
TTCGCACTCGCGTGCT-1_V10B01-087_A1,3,0,1,0,0,4
TATTTGTTACCCTTTA-1_V10B01-087_A1,2,1,3,0,0,6
CGCTGTGACGCCGCAC-1_V10B01-087_A1,1,0,3,2,0,6
GTTGCACGGAGTTTCG-1_V10B01-087_A1,0,2,0,0,0,2
GTTTCCTGGAGGGTGA-1_V10B01-087_A1,0,1,0,0,1,2
ACACCCAGCATGCAGC-1_V10B01-087_A1,0,1,2,2,0,5
TCAACCATGTTCGGGC-1_V10B01-087_A1,1,0,1,1,0,3
TTACAACTACGCATCC-1_V10B01-087_A1,2,1,1,0,0,4
TCCGATGGTGCGACAT-1_V10B01-087_A1,1,0,1,0,0,2
GGGCGTACATTTATAT-1_V10B01-087_A1,1,1,0,0,0,2
AGCGACCAACGATATT-1_V10B01-087_A1,0,1,1,1,0,3
ACACAAAGACGGGTGG-1_V10B01-087_A1,0,4,4,0,0,8
ATCGCACGCCGGGAGA-1_V10B01-087_A1,3,0,2,0,0,5
GCTCTAAACCCTGACG-1_V10B01-087_A1,1,0,0,0,0,1
AATGCAACCGGGTACC-1_V10B01-087_A1,2,0,0,1,0,3
TCAAACAACCGCGTCG-1_V10B01-087_A1,0,2,2,1,0,5
TATGCTCCCTACTTAC-1_V10B01-087_A1,1,2,1,0,0,4
AAAGGGATGTAGCAAG-1_V10B01-087_A1,1,2,5,0,0,8
ACGATCATACATAGAG-1_V10B01-087_A1,0,1,2,0,0,3
TTGTTCAGTGTGCTAC-1_V10B01-087_A1,2,0,0,0,0,2
ATGCATGATCCAGGAT-1_V10B01-087_A1,2,0,0,1,0,3
AGTCTTCTCCTCAAAT-1_V10B01-087_A1,1,1,0,0,0,2
GATTCCCTTGTCGCAG-1_V10B01-087_A1,1,1,0,3,0,5
CTCGCACCTATATAGT-1_V10B01-087_A1,0,4,2,0,0,6
ACTCAATAAAGGCACG-1_V10B01-087_A1,1,3,1,0,0,5
AACCGAGCTTGGTCAT-1_V10B01-087_A1,1,1,2,0,0,4
TAAGGCAACATAAGAT-1_V10B01-087_A1,2,1,0,0,0,3
CACGCACAGCGCAGCT-1_V10B01-087_A1,2,1,1,1,0,5
GGTTTACAATCTCAAT-1_V10B01-087_A1,3,1,2,3,0,9
TGCAGGATCGGCAAAG-1_V10B01-087_A1,1,0,1,0,0,2
ATAACGGAGTCCAACG-1_V10B01-087_A1,2,1,2,2,0,7
AACGATATGTCAACTG-1_V10B01-087_A1,0,2,4,0,0,6
GACAACGACCATTGAA-1_V10B01-087_A1,2,3,0,0,0,5
TTGACCATGTTCTCCG-1_V10B01-087_A1,3,0,0,0,0,3
AGTACGGGCACCTGGC-1_V10B01-087_A1,2,2,0,1,0,5
CGCCATCCGATTATGA-1_V10B01-087_A1,2,0,3,0,0,5
AAGGTATCCTAATATA-1_V10B01-087_A1,1,1,1,1,0,4
TGTTGTCAAGAAGTCT-1_V10B01-087_A1,2,0,1,0,0,3
CAGTGAATAAATGACT-1_V10B01-087_A1,0,0,0,1,0,1
GACTGCGGCACGTGTA-1_V10B01-087_A1,0,0,0,0,0,0
TTATCGCCTGCGAAGC-1_V10B01-087_A1,0,0,0,0,1,1
TGGAATTAGACGCTTT-1_V10B01-087_A1,4,0,0,0,0,4
TCGTCACACTGTTAGC-1_V10B01-087_A1,5,1,0,0,0,6
TTATGTTTGCGATAGA-1_V10B01-087_A1,1,0,0,0,0,1
GGTGCTGATCACAAAG-1_V10B01-087_A1,3,0,2,0,0,5
CATAGCCGCCCGGGAT-1_V10B01-087_A1,0,0,1,0,0,1
GGTTAGTTACGGCGCC-1_V10B01-087_A1,2,0,0,0,1,3
ATTCCCACATAAACAA-1_V10B01-087_A1,2,0,1,0,0,3
ATTCAGTAGCAGGGTC-1_V10B01-087_A1,0,0,2,0,0,2
CAGTTCCGCGGGTCGA-1_V10B01-087_A1,0,1,1,0,3,5
AAGAGATGAATCGGTA-1_V10B01-087_A1,2,0,0,0,1,3
CGCAATTCTACAATAA-1_V10B01-087_A1,3,1,0,0,1,5
TAACGCTTTGAGAGCG-1_V10B01-087_A1,3,1,1,0,0,5
AGGCTATGGTTAGCTT-1_V10B01-087_A1,1,1,0,0,0,2
GAGGAATGGAGAGGTT-1_V10B01-087_A1,0,0,2,0,1,3
TCCTCTACGAGATGGC-1_V10B01-087_A1,0,1,1,0,2,4
TTGATTATGCAGATGA-1_V10B01-087_A1,2,0,0,0,1,3
TCAGTACTGACCCGCG-1_V10B01-087_A1,4,0,0,0,1,5
TTATGACAAACTGGAT-1_V10B01-087_A1,2,0,2,0,0,4
GTAAGTAGGGTATACC-1_V10B01-087_A1,0,1,0,0,2,3
CGCAAACACGAGTTAC-1_V10B01-087_A1,3,0,2,0,0,5
TGGCCGTATATTGACC-1_V10B01-087_A1,0,0,0,0,0,0
ACTGTAGCACTTTGGA-1_V10B01-087_A1,1,0,0,0,1,2
GCTCTATGTTACGTGC-1_V10B01-087_A1,1,0,0,0,0,1
TGCGCGATTAACGGAG-1_V10B01-087_A1,1,2,1,1,0,5
GAATCGACATGGTCAC-1_V10B01-087_A1,3,0,0,0,0,3
GACTAAGTAGGCTCAC-1_V10B01-087_A1,2,0,1,0,0,3
ATCTTGACCTGCAACG-1_V10B01-087_A1,2,0,0,0,1,3
ATGCACTACCGCATTG-1_V10B01-087_A1,2,0,0,0,0,2
CAGATACTAACATAGT-1_V10B01-087_A1,1,0,1,0,0,2
GATCGACACTATCTGA-1_V10B01-087_A1,0,1,1,0,2,4
ATAGAGTACTGGGACA-1_V10B01-087_A1,2,0,2,0,0,4
CCTACTGCTTACACTT-1_V10B01-087_A1,0,0,0,0,0,0
CCTGCTATTTGAGAAG-1_V10B01-087_A1,6,2,0,1,0,9
CGCGTTCATGAAATAC-1_V10B01-087_A1,0,1,0,0,0,1
CATTATGCTTGTTGTG-1_V10B01-087_A1,1,0,0,1,0,2
CCAGGGACGTGGCCTC-1_V10B01-087_A1,1,2,0,0,1,4
TATGGATGTGCTACGC-1_V10B01-087_A1,1,1,1,0,0,3
GTACTAAGATTTGGAG-1_V10B01-087_A1,3,1,0,0,0,4
AGACCCGCCCTCCTCG-1_V10B01-087_A1,3,0,0,0,1,4
CGCATTAGCTAATAGG-1_V10B01-087_A1,3,2,3,2,1,11
GCTCTCGGGTACCGAA-1_V10B01-087_A1,3,1,2,0,0,6
CACCGCCAGAAGGTTT-1_V10B01-087_A1,0,1,0,1,0,2
TCCCAAAGACGAAGGA-1_V10B01-087_A1,3,0,0,0,0,3
ATGGATTGACCAAACG-1_V10B01-087_A1,4,0,0,0,0,4
GTCATGGACATGACTA-1_V10B01-087_A1,1,0,1,0,0,2
CTACTGCCACCTGACC-1_V10B01-087_A1,0,0,0,0,0,0
TTATATTTGGCAATCC-1_V10B01-087_A1,1,1,0,1,0,3
AGCACCAGTACTCACG-1_V10B01-087_A1,1,1,2,0,0,4
CATGGTCTAGATACCG-1_V10B01-087_A1,1,0,2,0,1,4
TCTACCGTCCACAAGC-1_V10B01-087_A1,2,1,2,0,0,5
CTAGTTGGGCCCGGTA-1_V10B01-087_A1,1,2,0,1,0,4
TCCCGCGTACTCCTGG-1_V10B01-087_A1,4,1,1,1,0,7
CAGAGCATGAGCTTGC-1_V10B01-087_A1,1,1,5,0,0,7
ACACGGGAACTTAGGG-1_V10B01-087_A1,2,0,1,0,1,4
GGCTCTGCTCCAACGC-1_V10B01-087_A1,0,1,1,1,0,3
AGAACGTGGTACATTC-1_V10B01-087_A1,0,0,3,1,1,5
CAATAAACCTTGGCCC-1_V10B01-087_A1,0,1,3,0,1,5
ACTTCGCCATACGCAC-1_V10B01-087_A1,1,2,2,0,0,5
ATCTGGTTAAGACTGT-1_V10B01-087_A1,1,2,1,0,0,4
TCGTAAGACGACATTG-1_V10B01-087_A1,1,1,0,1,0,3
GTGTACCTTGGCTACG-1_V10B01-087_A1,0,3,3,1,0,7
GCCCGTAATACCTTCT-1_V10B01-087_A1,0,0,0,0,0,0
CGGTCAAGTGGGAACC-1_V10B01-087_A1,1,0,3,0,1,5
TTGTAAGGCCAGTTGG-1_V10B01-087_A1,4,0,0,1,0,5
GGAGCACCAAGAACTA-1_V10B01-087_A1,3,1,0,1,0,5
TAATAGTGACGACCAG-1_V10B01-087_A1,0,1,2,0,1,4
CTAAATCCTATTCCGG-1_V10B01-087_A1,0,0,0,0,0,0
CGAGTTCTGTCCCACC-1_V10B01-087_A1,2,1,1,0,0,4
GAGTCGACAGACCCTC-1_V10B01-087_A1,0,0,0,0,0,0
AGGGTGGATAGTGCAT-1_V10B01-087_A1,0,0,0,0,0,0
TGATAGCGGGATTCTA-1_V10B01-087_A1,0,0,1,0,0,1
GTCAGTTTGGTAGTCG-1_V10B01-087_A1,1,0,0,0,0,1
GCATTCGAAATGAACA-1_V10B01-087_A1,3,0,0,0,0,3
AAAGACTGGGCGCTTT-1_V10B01-087_A1,2,1,1,0,1,5
TAACAATATTTGTTGC-1_V10B01-087_A1,0,0,0,0,0,0
CCAGCTTCCGCCCGCA-1_V10B01-087_A1,1,1,0,0,0,2
GATATGGATTACGCGG-1_V10B01-087_A1,0,2,1,0,1,4
AGAGCAGTTATGAGAC-1_V10B01-087_A1,2,0,2,0,1,5
TCACATCTTATCTGAT-1_V10B01-087_A1,1,1,0,0,0,2
TATGAAGACAGGTGCG-1_V10B01-087_A1,2,0,0,0,1,3
TACCTGCTGCACTGTG-1_V10B01-087_A1,0,0,0,0,1,1
TAGGTCCAAGTAAGGA-1_V10B01-087_A1,1,0,0,0,1,2
GAAACTCGTGCGATGC-1_V10B01-087_A1,1,1,2,0,0,4
AACAATTACTCTACGC-1_V10B01-087_A1,1,0,0,0,1,2
CCGCACGTGACCTCGG-1_V10B01-087_A1,0,0,0,0,1,1
AACTTGCCCGTATGCA-1_V10B01-087_A1,3,1,0,0,0,4
GGGTATGTATGCACTT-1_V10B01-087_A1,0,1,0,0,0,1
TTCGTACTCCAGAACG-1_V10B01-087_A1,1,0,2,0,2,5
GAATTTCTCGCTGCAG-1_V10B01-087_A1,2,0,0,0,0,2
AACAGGATGGGCCGCG-1_V10B01-087_A1,1,2,2,0,0,5
GACGTGTAGGGATTAT-1_V10B01-087_A1,0,1,1,0,0,2
TAGGTGAGCCCTACTC-1_V10B01-087_A1,1,0,0,0,0,1
CTAATTCGCACGCGCT-1_V10B01-087_A1,1,0,1,0,1,3
GAAGCTTGCTGACCGC-1_V10B01-087_A1,1,3,0,0,0,4
GGTTAGGCTTGGAGAA-1_V10B01-087_A1,2,0,0,0,0,2
ACAAGGACAAGAGGTT-1_V10B01-087_A1,2,0,0,0,1,3
AGGCCACCCGTTATGA-1_V10B01-087_A1,1,0,1,0,1,3
GTGGGCTTAGACACAC-1_V10B01-087_A1,0,3,2,0,0,5
CGTGTCCCATTCGCGA-1_V10B01-087_A1,3,0,1,0,0,4
TGGAGTGATGCGATGA-1_V10B01-087_A1,1,0,0,0,0,1
AACAACTGGTAGTTGC-1_V10B01-087_A1,2,0,0,0,0,2
CCTGGCTAGACCCGCC-1_V10B01-087_A1,1,0,1,0,0,2
CGCAATTAGGGTAATA-1_V10B01-087_A1,1,0,0,0,0,1
TCGAAATTTAGGACCA-1_V10B01-087_A1,0,2,2,0,0,4
AGACTAGCCTTCCAGA-1_V10B01-087_A1,0,3,0,0,0,3
TTGATCTAACTTTGTC-1_V10B01-087_A1,1,2,1,0,0,4
AAGGAGCGGTTGGTGC-1_V10B01-087_A1,2,0,0,0,0,2
ACTTGGGACCCGGTGG-1_V10B01-087_A1,1,2,1,0,0,4
TGATCTCCGGCGCCAG-1_V10B01-087_A1,0,2,1,0,0,3
CAGTTCAAATTGACAC-1_V10B01-087_A1,1,0,0,1,0,2
GTCCGGCTGAATTGCG-1_V10B01-087_A1,0,0,4,1,1,6
CTGGAAATGGATGCTT-1_V10B01-087_A1,0,3,4,0,0,7
TGATCGGTTTGACCCT-1_V10B01-087_A1,0,0,5,0,0,5
TAGAGTCTAAGCGAAC-1_V10B01-087_A1,0,0,3,0,0,3
GAGACTGATGGGTAGA-1_V10B01-087_A1,3,3,0,0,0,6
TAGCTAAGTCCGGGAG-1_V10B01-087_A1,0,0,1,0,0,1
GGGCGATATGTGTGAA-1_V10B01-087_A1,1,0,0,1,0,2
CTCGAGGTCGAACAGT-1_V10B01-087_A1,3,1,2,0,1,7
GATCCCTTTATACTGC-1_V10B01-087_A1,1,0,0,1,0,2
GTCATGCACCTCCGTT-1_V10B01-087_A1,3,0,3,0,0,6
ACTTTCCTATAGCTTC-1_V10B01-087_A1,0,0,0,0,0,0
TCGCTCGATATATTCC-1_V10B01-087_A1,0,0,2,1,0,3
ATAGGTTGGGCAGATG-1_V10B01-087_A1,1,1,1,0,0,3
CAATTAAGGGTGATGA-1_V10B01-087_A1,1,1,0,0,0,2
ACCGACTGAGTCCCAC-1_V10B01-087_A1,0,2,3,1,0,6
CCTGTCACCCGGGCTC-1_V10B01-087_A1,0,1,4,0,1,6
GATCGGTGGCCATAAC-1_V10B01-087_A1,1,0,1,0,0,2
CCTATGGGTTACCGTC-1_V10B01-087_A1,3,0,3,0,0,6
TTGGGACACTGCCCGC-1_V10B01-087_A1,1,0,1,0,0,2
CGAGGCTAAATATGGC-1_V10B01-087_A1,5,1,0,0,0,6
TCAGGGTGTAACGTAA-1_V10B01-087_A1,3,0,0,1,1,5
CGAGAGATGTGAACCT-1_V10B01-087_A1,2,1,0,0,0,3
TCGCTGGGCGGATTGT-1_V10B01-087_A1,4,0,0,0,0,4
AGATCTCAGGTGTGAT-1_V10B01-087_A1,3,2,2,0,0,7
TGGCCAAACTGAAGTA-1_V10B01-087_A1,1,1,6,0,0,8
GCTTCCGTCCCTAGAC-1_V10B01-087_A1,0,4,1,0,0,5
CAGCAGCCCGTTCCTT-1_V10B01-087_A1,2,0,2,0,0,4
TGTATAACAGATCCTG-1_V10B01-087_A1,1,0,1,0,0,2
CGCGGGAATTAGGCAG-1_V10B01-087_A1,4,1,1,0,0,6
TGCATGTGGTAATCTA-1_V10B01-087_A1,0,3,1,0,1,5
ACAATTTGAGCAGTGG-1_V10B01-087_A1,4,0,3,0,0,7
GAGCTAAGGGCATATC-1_V10B01-087_A1,2,0,3,0,0,5
CCAGATAGTTGAGTGA-1_V10B01-087_A1,2,1,0,0,1,4
CCACAATGTACGTCTT-1_V10B01-087_A1,1,2,2,0,0,5
CAATGGATCTCTACCA-1_V10B01-087_A1,0,4,1,0,0,5
TGTGGCAAAGCGTATG-1_V10B01-087_A1,0,0,2,0,0,2
TCCGTTTAGCCTTGAA-1_V10B01-087_A1,1,0,3,0,0,4
GGTGATGAAGGAAGTG-1_V10B01-087_A1,0,0,0,0,0,0
GCAACCCAAGTTGTTT-1_V10B01-087_A1,1,0,0,0,1,2
ATGAAGTGGACCCAGC-1_V10B01-087_A1,1,0,0,0,0,1
GAGAATCTCACGATCA-1_V10B01-087_A1,2,0,0,0,0,2
TATATCATTGATCAGT-1_V10B01-087_A1,2,0,0,0,0,2
AACTTTACGGGAGCTT-1_V10B01-087_A1,3,0,1,0,3,7
TTCTTGTGTCCATCAG-1_V10B01-087_A1,0,1,0,0,1,2
ACAATTTAGGAGGCTC-1_V10B01-087_A1,2,0,1,0,2,5
ATACTTGTTCTCGAGC-1_V10B01-087_A1,2,0,0,0,0,2
CACGGGATTGAGGGTT-1_V10B01-087_A1,1,0,0,0,1,2
GTTAATGTCTATCTTA-1_V10B01-087_A1,2,0,0,0,1,3
GCGTTATATTTGGAAC-1_V10B01-087_A1,0,1,0,0,0,1
CGTCAAGGCTATAAAT-1_V10B01-087_A1,3,0,0,0,0,3
TTAGCTCTGTAATCCG-1_V10B01-087_A1,1,1,0,0,1,3
AATGGTCCACCGTTCA-1_V10B01-087_A1,6,0,0,0,1,7
GTCATTGCATTGACCC-1_V10B01-087_A1,3,0,1,0,0,4
TGTCCGTGGCGCCTTT-1_V10B01-087_A1,3,0,2,0,0,5
TCAACTAACGTATAAC-1_V10B01-087_A1,0,1,1,0,0,2
TCCTCTCCAGTTGTCC-1_V10B01-087_A1,0,0,0,0,0,0
TGTGTTCGTATCCAAG-1_V10B01-087_A1,0,0,0,0,1,1
CCGCGTAGGTAAGGGC-1_V10B01-087_A1,1,0,0,0,2,3
CTGCGGGTGAAATGTT-1_V10B01-087_A1,0,0,0,0,0,0
TATCTACAGAGGTAAT-1_V10B01-087_A1,3,0,0,0,1,4
CTACTCTAGGCCCGGC-1_V10B01-087_A1,0,0,0,0,1,1
ACAAGCAGTGCCTAGC-1_V10B01-087_A1,1,1,0,0,1,3
TACAAGTCTCGTGCAT-1_V10B01-087_A1,3,0,0,0,0,3
TCGGAATGCGCTCTGA-1_V10B01-087_A1,4,1,3,0,1,9
TCGCGTCCAGAAGGTC-1_V10B01-087_A1,1,0,1,0,1,3
TATGGCCCGGCCTCGC-1_V10B01-087_A1,0,0,1,0,2,3
GCTGGCATATTCACCT-1_V10B01-087_A1,1,0,0,0,0,1
GTCAGAATAGTCTATG-1_V10B01-087_A1,0,2,1,0,0,3
GGCGTCCTATCCGCTG-1_V10B01-087_A1,1,0,0,0,0,1
CGGAGTTTGAGAGACA-1_V10B01-087_A1,2,0,1,0,0,3
AGCACTTAAGGACGCC-1_V10B01-087_A1,1,0,1,0,0,2
TCCACAATGGTTTACG-1_V10B01-087_A1,0,0,1,0,1,2
CCAACGATGCACTGAT-1_V10B01-087_A1,3,2,1,0,0,6
ATTTACAGTTTACTGG-1_V10B01-087_A1,1,2,3,0,1,7
CCCTGAAATGAGTTGA-1_V10B01-087_A1,0,0,0,0,0,0
CAAACGGTCGCACTTT-1_V10B01-087_A1,0,0,1,0,1,2
TGATTCGTCTATCACT-1_V10B01-087_A1,1,2,2,0,1,6
TCAGGTTCTTTGAGAA-1_V10B01-087_A1,1,3,0,0,0,4
CACGCAGCGAGGCTTT-1_V10B01-087_A1,1,0,0,0,2,3
TTAAGCGCCTGACCCA-1_V10B01-087_A1,1,0,0,0,0,1
CTTACACGGTATTCCA-1_V10B01-087_A1,0,0,0,0,1,1
AAGGCTGTGCTCATCG-1_V10B01-087_A1,3,0,0,0,0,3
GACCAGAGCCCTGTAG-1_V10B01-087_A1,0,1,1,0,0,2
TCCCAGGCTTAGCTAA-1_V10B01-087_A1,0,0,1,0,0,1
ATTGAAGATCTTAGTG-1_V10B01-087_A1,3,0,3,0,3,9
AGTTCCTACAGAATTA-1_V10B01-087_A1,3,0,0,0,0,3
GGGCTGGTTAGTCGCG-1_V10B01-087_A1,1,0,0,0,0,1
GAAATGGCGGTGTTAG-1_V10B01-087_A1,2,0,0,0,0,2
TACGAACACGACTTCA-1_V10B01-087_A1,0,0,0,0,0,0
ACCACAAGTTTCTATC-1_V10B01-087_A1,2,1,0,0,0,3
ATATTTAACCCTCAAG-1_V10B01-087_A1,0,0,0,1,0,1
GATCATTCCAAACATT-1_V10B01-087_A1,3,0,1,0,0,4
TCCAGGCGAGTACGGT-1_V10B01-087_A1,1,1,2,0,0,4
GTTTGACCAAATCCTA-1_V10B01-087_A1,2,2,0,0,0,4
CACAGCACCCACGGCA-1_V10B01-087_A1,3,1,4,0,0,8
TGCAAGAATGACGTAA-1_V10B01-087_A1,1,0,2,0,0,3
GCGAAGCCATACCCGT-1_V10B01-087_A1,1,2,1,0,0,4
TCCTTTCTTACGCTTA-1_V10B01-087_A1,1,1,2,0,0,4
GCTGCTCTCCGGACAC-1_V10B01-087_A1,0,2,1,0,0,3
ACTGTCTTCTTTAGAA-1_V10B01-087_A1,0,3,3,0,1,7
TCAAACTTAGATTGTT-1_V10B01-087_A1,1,1,2,0,0,4
CTATGTCACTAGCCCA-1_V10B01-087_A1,2,1,1,1,1,6
TGCGCAAAGCATTTGG-1_V10B01-087_A1,1,4,2,0,0,7
TTAATGTAGACCAGGT-1_V10B01-087_A1,1,0,2,0,0,3
GGCGGTAGGATCATTG-1_V10B01-087_A1,0,0,0,0,0,0
GGCAATAGTCAATGAG-1_V10B01-087_A1,2,0,4,0,0,6
ACACGAGACTCCTTCT-1_V10B01-087_A1,2,2,0,3,0,7
GACACAAGGGAAGAAA-1_V10B01-087_A1,3,1,1,1,1,7
TCAGCAAATGCATCTC-1_V10B01-087_A1,4,0,4,0,0,8
GAGATCTGTCACTCCG-1_V10B01-087_A1,4,0,0,0,0,4
ATGCCGGTCTTGCATA-1_V10B01-087_A1,2,0,0,0,0,2
TTGGGCGGCGGTTGCC-1_V10B01-087_A1,1,0,3,1,0,5
TTGTTGTGTGTCAAGA-1_V10B01-087_A1,3,4,1,0,0,8
ACTGTACGATACACAT-1_V10B01-087_A1,5,1,1,0,0,7
TCCACTTTATCTAGGT-1_V10B01-087_A1,0,3,0,1,0,4
GGTCTGAGAATCTGGA-1_V10B01-087_A1,1,2,2,0,0,5
TAGAAAGGTGGCGCTA-1_V10B01-087_A1,3,2,1,0,0,6
TATGTCTCATTGTGCC-1_V10B01-087_A1,0,2,0,0,0,2
GGATTTCACTTCTATA-1_V10B01-087_A1,1,4,0,0,0,5
TGAGTGGTCCGTGACG-1_V10B01-087_A1,3,3,1,2,0,9
CGCTTTCTTGCATTCG-1_V10B01-087_A1,0,3,0,0,0,3
ACCCAACGCCCGTGGC-1_V10B01-087_A1,1,3,0,0,0,4
GAACGTCTCATGGTCG-1_V10B01-087_A1,2,3,0,1,1,7
AGGGTTCCCTTTGGTT-1_V10B01-087_A1,0,1,1,0,2,4
GTAGCTTCCTCTTGTT-1_V10B01-087_A1,2,3,2,3,1,11
GCATGAGGGACGCGGC-1_V10B01-087_A1,4,3,0,0,1,8
CTACCCTAAGGTCATA-1_V10B01-087_A1,2,5,0,0,0,7
TCACCGCTCGGCACTC-1_V10B01-087_A1,3,0,0,0,0,3
GGCTCGCGTTGAGGTA-1_V10B01-087_A1,2,0,0,0,0,2
CCATACTCGCCTCTCC-1_V10B01-087_A1,0,1,0,0,1,2
ACGATACCTATCCTGA-1_V10B01-087_A1,3,0,0,0,0,3
CTCACCAGTACAAGTG-1_V10B01-087_A1,3,0,1,0,0,4
CGAAGACGGTGAGTGC-1_V10B01-087_A1,1,1,0,0,1,3
AAATTAATAAGCGCGA-1_V10B01-087_A1,2,0,0,0,0,2
GGGCCCTTATCTATAC-1_V10B01-087_A1,2,0,0,0,2,4
CTGCCCACGAAGCGTT-1_V10B01-087_A1,2,0,1,0,2,5
GGACAAGTTGCAGTGA-1_V10B01-087_A1,5,1,0,0,2,8
GTCCGAGAGCAATCAT-1_V10B01-087_A1,1,0,0,0,0,1
ATGGCAGCCGAGAAAC-1_V10B01-087_A1,2,0,1,0,1,4
CCTCGGATGCTACCTG-1_V10B01-087_A1,1,0,0,0,2,3
ATACGGTGAAGATGCA-1_V10B01-087_A1,3,1,0,0,3,7
ACATCAGCTGGGACGC-1_V10B01-087_A1,1,0,2,0,1,4
GGTTGTGTAGCCTGGC-1_V10B01-087_A1,0,0,0,0,3,3
CCTGCGTTCTACGCTT-1_V10B01-087_A1,1,1,1,0,0,3
GAACGTTAGGAAGACG-1_V10B01-087_A1,2,0,0,0,0,2
CTGATAGTGTATCTCA-1_V10B01-087_A1,2,1,3,0,0,6
TTCTGCGAGCGCCCTT-1_V10B01-087_A1,1,1,1,0,0,3
CTTTGGCGCTTTATAC-1_V10B01-087_A1,1,0,2,0,0,3
TCCGAACTTGGCTTAC-1_V10B01-087_A1,2,1,0,0,0,3
TAGATTCCTGGTTATT-1_V10B01-087_A1,1,0,0,0,0,1
CCGACAAAGGGAGTGC-1_V10B01-087_A1,2,0,0,0,0,2
CCATGGCCCTTGTACC-1_V10B01-087_A1,2,0,1,0,0,3
GAAATATCACCATCAG-1_V10B01-087_A1,0,0,0,0,1,1
ACGAAATGGGCGGCAC-1_V10B01-087_A1,2,0,1,0,0,3
GTGAGCGTGCTGCACT-1_V10B01-087_A1,1,1,0,0,1,3
CCGCGGGTACGAAGAA-1_V10B01-087_A1,1,0,0,0,0,1
TCCCTGGCTCGCTGGA-1_V10B01-087_A1,3,1,2,0,0,6
CAGCTTAGTAGGTAGC-1_V10B01-087_A1,1,0,0,0,1,2
CACGAAAGTTAGTCCC-1_V10B01-087_A1,3,1,2,0,0,6
ACCTAATCGACTTCCT-1_V10B01-087_A1,1,1,1,0,0,3
AAGTAGTGACGCGAGG-1_V10B01-087_A1,2,0,0,0,1,3
TCCGATTACATTGCCG-1_V10B01-087_A1,0,1,1,0,0,2
CCTCCGACAATTCAAG-1_V10B01-087_A1,0,3,0,0,0,3
GTTCACAGGAGTCTAG-1_V10B01-087_A1,0,2,0,0,0,2
CGAAGTTGCTCTGTGT-1_V10B01-087_A1,0,2,1,0,1,4
GTCGGATATCTCAGAC-1_V10B01-087_A1,1,0,1,0,1,3
CGCTCTCCGTAGATTA-1_V10B01-087_A1,1,0,0,0,0,1
CAAGCAACGTCGGAGT-1_V10B01-087_A1,0,0,0,0,2,2
CCATTCCCTGCCCACA-1_V10B01-087_A1,0,0,0,0,1,1
CTTTGGCTTTAGTAAA-1_V10B01-087_A1,1,0,0,0,0,1
GGCTATTAAGTTGTAT-1_V10B01-087_A1,1,3,0,0,1,5
CCATTAGCGATAATCC-1_V10B01-087_A1,1,0,0,0,1,2
TGTTCTTCCATTGACT-1_V10B01-087_A1,0,0,1,0,1,2
AGATAACTTCAGGGCC-1_V10B01-087_A1,0,2,0,0,1,3
ATAGACGAAGAGAAAG-1_V10B01-087_A1,0,3,3,0,1,7
GGCGGAGTAATATTAG-1_V10B01-087_A1,1,0,0,0,1,2
TGACCCACGTTAGACA-1_V10B01-087_A1,0,1,1,0,1,3
TCACAGGTTATTGGGC-1_V10B01-087_A1,0,0,0,0,1,1
TCACGCATTGTAGATC-1_V10B01-087_A1,0,0,0,0,1,1
TTGAAGAATTCCCAGG-1_V10B01-087_A1,0,0,0,0,0,0
AAATGGTCAATGTGCC-1_V10B01-087_A1,0,1,2,0,0,3
TAGTGCCCTCCAGAGT-1_V10B01-087_A1,1,2,0,0,0,3
GGTATTGCCGAGTTTA-1_V10B01-087_A1,1,2,2,0,1,6
CGTATTAAGAGATCTA-1_V10B01-087_A1,2,3,0,0,0,5
ACTGTCCAGGATTATA-1_V10B01-087_A1,0,6,3,0,0,9
CGGGCAGCTAAACCGC-1_V10B01-087_A1,2,1,2,0,0,5
TTGCTGATCATGTTCG-1_V10B01-087_A1,0,2,4,0,0,6
TATGGGTACGTATCGT-1_V10B01-087_A1,0,0,5,0,0,5
CAGCTCACTGAGACAT-1_V10B01-087_A1,1,3,1,0,0,5
GGGACTGCATAGATAG-1_V10B01-087_A1,0,3,1,0,0,4
ACGCATTCGTGAGTAC-1_V10B01-087_A1,1,1,4,0,0,6
CTCTGGACGCCTGGTG-1_V10B01-087_A1,3,3,4,0,0,10
AGGGTTTAGTTCGGGA-1_V10B01-087_A1,1,2,1,0,0,4
GGGAGAACTCACAGTA-1_V10B01-087_A1,0,3,0,1,0,4
ATCAATCTGGGCTGCA-1_V10B01-087_A1,1,0,6,0,0,7
TCTTCGATACCAATAA-1_V10B01-087_A1,1,2,2,0,0,5
ACGTAGATTGCTGATG-1_V10B01-087_A1,2,2,0,1,0,5
TCTTGATGCGTAGCGA-1_V10B01-087_A1,2,2,1,0,0,5
GGGCTGCCTAGGGCGA-1_V10B01-087_A1,1,1,0,0,0,2
CTCTCACAATCGATGA-1_V10B01-087_A1,0,7,1,1,0,9
CCAAGCGTAACTCGTA-1_V10B01-087_A1,1,4,0,0,0,5
ACAACAGCATGAGCTA-1_V10B01-087_A1,0,1,0,0,0,1
GTCCCAACGTAAAGTA-1_V10B01-087_A1,1,1,0,0,0,2
TCGGAGTACATGAGTA-1_V10B01-087_A1,1,2,0,0,0,3
GGGAGTTAATGAGGCG-1_V10B01-087_A1,0,0,3,0,0,3
CCGGGCGGTCTCGTCA-1_V10B01-087_A1,1,3,0,0,0,4
CCGTAAGTTGGTCCCA-1_V10B01-087_A1,1,5,0,0,0,6
GGAGGGCTTGGTTGGC-1_V10B01-087_A1,4,1,0,0,0,5
TCGGACGCCCAGCCCA-1_V10B01-087_A1,3,7,0,0,0,10
TCTGTGCCATCATAGT-1_V10B01-087_A1,3,3,1,0,1,8
GTACTGGAGTTAGACC-1_V10B01-087_A1,3,3,0,0,0,6
GGAATGCGCTAGCGTG-1_V10B01-087_A1,2,4,0,0,0,6
GTGTGAATAACTTAGG-1_V10B01-087_A1,1,3,0,0,0,4
GGTCGGCCAGGAGCTT-1_V10B01-087_A1,0,3,0,1,0,4
TAGCCGGCGGTCAGCG-1_V10B01-087_A1,2,8,1,2,1,14
CGGGTGTACCCATTTA-1_V10B01-087_A1,0,2,0,0,0,2
AGTGATTCAAGCAGGA-1_V10B01-087_A1,3,6,0,1,0,10
GTTGGATTGAGAACAC-1_V10B01-087_A1,2,1,1,0,0,4
CACACGCGCTGTCTTA-1_V10B01-087_A1,10,4,0,1,0,15
TAGACGCCCGTACCGG-1_V10B01-087_A1,1,6,0,0,0,7
GGTTTCAATCGGTCAG-1_V10B01-087_A1,0,4,0,1,0,5
AATCTGCGTTGGGACG-1_V10B01-087_A1,0,6,0,0,0,6
TTACGGATGGTTCGAG-1_V10B01-087_A1,1,2,0,0,0,3
CGGCAGGGTCGGGTTG-1_V10B01-087_A1,1,4,0,0,0,5
GCTTTCAGAGGAGGTG-1_V10B01-087_A1,5,2,0,2,0,9
TCTTCCCATGGGCACA-1_V10B01-087_A1,2,0,0,0,0,2
TACCGCGGACTTGCAG-1_V10B01-087_A1,0,0,0,0,0,0
GGTATGAAAGAACTGA-1_V10B01-087_A1,2,0,0,0,2,4
GTGGCCTAATATCATT-1_V10B01-087_A1,0,0,0,0,0,0
CCTGTGAAACCGTAAC-1_V10B01-087_A1,2,0,1,0,0,3
GGCAGAGAGATCGGGA-1_V10B01-087_A1,2,0,0,0,0,2
TAGCGTCGAATATTGA-1_V10B01-087_A1,1,0,0,0,1,2
CGCCGACTATTCGCTA-1_V10B01-087_A1,2,1,0,0,0,3
TCTGGCGCAAGCCGGG-1_V10B01-087_A1,2,0,0,0,1,3
AGTGGTTGCGTATAGG-1_V10B01-087_A1,4,0,2,0,0,6
ATCGGTTACCTAGTAA-1_V10B01-087_A1,4,0,0,0,1,5
CCTGCCCGTTGTCTAG-1_V10B01-087_A1,2,0,0,0,3,5
GCACACGCCCATGGTC-1_V10B01-087_A1,1,0,0,0,1,2
AGTACGGCCCGTATCG-1_V10B01-087_A1,1,0,0,0,1,2
TATCTAGCCTAAAGGA-1_V10B01-087_A1,0,1,0,0,2,3
CACTCGGTTAGGAGGA-1_V10B01-087_A1,0,2,0,0,2,4
ATGTTCGTCGACCCAC-1_V10B01-087_A1,1,1,0,0,0,2
TTCCTCTGCCCGAATA-1_V10B01-087_A1,1,0,0,0,0,1
TTACTATCGGCTTCTC-1_V10B01-087_A1,1,0,0,0,1,2
GCCGCATTAGTCCGGC-1_V10B01-087_A1,2,0,1,0,0,3
TAAGGGCTGGGAGAGG-1_V10B01-087_A1,0,1,0,0,0,1
TAAGCAGGCGACACGC-1_V10B01-087_A1,1,0,0,0,0,1
AGCACTACCGGCCTGT-1_V10B01-087_A1,1,0,0,0,0,1
GAAAGCCCTTTGGACC-1_V10B01-087_A1,1,0,0,0,1,2
GACCGACTGAAGCGTC-1_V10B01-087_A1,1,0,0,0,1,2
CGGTGAAGACTAAAGT-1_V10B01-087_A1,1,1,0,0,0,2
CCCTGCGCTACGCATA-1_V10B01-087_A1,1,0,0,0,0,1
TACTGGACAGCTCGGC-1_V10B01-087_A1,0,0,1,0,1,2
TTAGTAGGGCGGCGGG-1_V10B01-087_A1,1,0,2,0,0,3
GAGGCTATCAAAGTCG-1_V10B01-087_A1,1,0,3,0,1,5
TTACCATTGATTACCC-1_V10B01-087_A1,1,1,1,0,1,4
ATACCACGGGCAACTT-1_V10B01-087_A1,0,3,1,0,0,4
TGTCCTAAGTCACCGC-1_V10B01-087_A1,2,0,1,0,1,4
AGGTAGGTACAAAGCT-1_V10B01-087_A1,0,2,0,0,0,2
GGCATACAGGTAGCGG-1_V10B01-087_A1,0,1,0,0,2,3
TGTAGTGATCTATAAT-1_V10B01-087_A1,0,2,0,0,2,4
TCCCGGGTGTGCTGCT-1_V10B01-087_A1,0,2,4,0,2,8
TACGATGTTGATCATC-1_V10B01-087_A1,0,4,0,0,0,4
CCTCTCTCCCATCTAG-1_V10B01-087_A1,1,2,1,0,2,6
GCAGGACTATAGAATA-1_V10B01-087_A1,1,2,0,0,1,4
CTAGTGAAGGACAGGA-1_V10B01-087_A1,0,4,3,0,0,7
TACGAGAACTTCACGT-1_V10B01-087_A1,1,1,1,0,1,4
CGTTGTTTCAATTCCC-1_V10B01-087_A1,0,5,0,0,4,9
GCAAATATTACGCTTT-1_V10B01-087_A1,0,0,0,0,2,2
CCAATAGTGCCGTCGA-1_V10B01-087_A1,0,1,2,0,4,7
ATTGCTGCTCCTCCAT-1_V10B01-087_A1,2,0,3,0,3,8
GAGATCTGCTTGGCAT-1_V10B01-087_A1,1,4,1,0,0,6
GCCGAAATTCCTACGT-1_V10B01-087_A1,1,0,0,0,0,1
GGCACTCCACTGGGCA-1_V10B01-087_A1,1,0,2,0,1,4
GGGTCACCGTGACGGT-1_V10B01-087_A1,0,1,0,0,1,2
CACTTAATCAGACGGA-1_V10B01-087_A1,1,2,0,0,0,3
CGTTTCGCTCATTACA-1_V10B01-087_A1,1,0,0,0,1,2
ATAAAGGCTCGGTCGT-1_V10B01-087_A1,1,3,1,0,0,5
CACTAAAGTTGCCTAT-1_V10B01-087_A1,1,1,3,1,0,6
GTGCTCAAGTACTGTC-1_V10B01-087_A1,1,1,2,0,0,4
CCATGCCTGTTTAGTA-1_V10B01-087_A1,1,0,2,0,1,4
TCTAGTTATCAGAAGA-1_V10B01-087_A1,0,6,2,0,0,8
TTGTAATCCGTACTCG-1_V10B01-087_A1,1,0,0,0,1,2
TCCCAGCTTTAGTCTG-1_V10B01-087_A1,1,1,2,0,1,5
CTACGCACGGAGTACC-1_V10B01-087_A1,1,1,0,0,0,2
AAATTAACGGGTAGCT-1_V10B01-087_A1,2,0,1,0,0,3
CGGCCACGCACAAAGT-1_V10B01-087_A1,0,4,0,0,0,4
GAAGCGTGAGGAATTT-1_V10B01-087_A1,0,1,2,0,1,4
ATATCTTAGGGCCTTC-1_V10B01-087_A1,4,1,1,0,0,6
ACGCGGGCCAAGGACA-1_V10B01-087_A1,0,1,0,0,0,1
GCGAGTTCTGCAAAGA-1_V10B01-087_A1,0,1,1,0,0,2
TATTCGTGCCAGAATA-1_V10B01-087_A1,1,4,1,0,0,6
AGGGCTGCAGTTACAG-1_V10B01-087_A1,2,2,0,0,0,4
CTAGCATAGTATAATG-1_V10B01-087_A1,1,2,1,0,0,4
TAGGTTCGAGTTCGTC-1_V10B01-087_A1,3,0,3,0,0,6
GAATTATAGTGAAAGG-1_V10B01-087_A1,1,1,2,0,0,4
CTATCGGGTCTCAACA-1_V10B01-087_A1,0,1,0,0,0,1
GCGCTAATTGAATAGA-1_V10B01-087_A1,3,4,0,0,0,7
ATGCGACAGTCCCATT-1_V10B01-087_A1,1,2,0,0,0,3
GGTAGTGCTCGCACCA-1_V10B01-087_A1,1,3,0,1,0,5
AAGCTCGTGCCAAGTC-1_V10B01-087_A1,3,1,0,0,1,5
TATTCAATTCTAATCC-1_V10B01-087_A1,0,0,1,0,1,2
TTCAAAGTCTCTAGCC-1_V10B01-087_A1,1,0,0,0,0,1
TTGAATATGGACTTTC-1_V10B01-087_A1,3,4,1,1,0,9
AAGAGCTCTTTATCGG-1_V10B01-087_A1,4,3,0,0,1,8
TTACTCCGGCCGGGAA-1_V10B01-087_A1,1,1,0,1,0,3
AAACGAGACGGTTGAT-1_V10B01-087_A1,2,3,0,0,0,5
GCTAAGTAGTTTCTCT-1_V10B01-087_A1,4,3,0,0,0,7
ATAACGCCGGAGGGTC-1_V10B01-087_A1,3,3,0,0,0,6
GGATCCGGAATATACT-1_V10B01-087_A1,3,1,1,0,0,5
TGAAAGGACCTGACTC-1_V10B01-087_A1,2,2,0,0,0,4
TCCGCGGCAGCATCTG-1_V10B01-087_A1,1,1,0,1,1,4
TGCATATGTCTGTCAC-1_V10B01-087_A1,2,6,2,0,0,10
TGTAGGAGAAATTTCC-1_V10B01-087_A1,2,2,2,0,0,6
AGTGAGACTTCCAGTA-1_V10B01-087_A1,1,0,0,0,0,1
CCCAAACATGCTGCTC-1_V10B01-087_A1,2,1,1,4,0,8
GCTTATGAAGCAGGAA-1_V10B01-087_A1,1,4,0,0,0,5
TTCTAACCGAAGCTTA-1_V10B01-087_A1,3,2,1,1,0,7
GGATGTCCTTACCGCA-1_V10B01-087_A1,1,4,0,0,0,5
AGGGTGCTCTCGAGGG-1_V10B01-087_A1,5,3,0,0,0,8
AACTCTCAATAGAGCG-1_V10B01-087_A1,2,0,0,0,0,2
TCTGAATTCCGTACAA-1_V10B01-087_A1,3,0,0,0,0,3
GCGTGGTACTGGGTTA-1_V10B01-087_A1,2,0,0,0,0,2
CGTCGGATAGTGTTGA-1_V10B01-087_A1,2,2,0,1,0,5
ATATGTCTCCCTAGCC-1_V10B01-087_A1,2,4,0,0,0,6
TCTTTAAGACTATGAA-1_V10B01-087_A1,0,0,2,2,0,4
TCATTTAAGTCTCCGA-1_V10B01-087_A1,1,1,1,0,1,4
GATATTGAGATTGGCG-1_V10B01-087_A1,0,0,0,0,0,0
TGACATCGAGCGGACC-1_V10B01-087_A1,2,0,0,0,0,2
CAAACCAGGTCTGCAT-1_V10B01-087_A1,2,1,1,0,0,4
ACAAGCTATATGGAAG-1_V10B01-087_A1,2,0,0,0,0,2
TCGCCCACTGCGAGAG-1_V10B01-087_A1,3,0,0,0,0,3
AGCCGCAAATTCAAAT-1_V10B01-087_A1,2,0,0,0,2,4
TTAACGTTAAAGCCTG-1_V10B01-087_A1,1,1,0,0,0,2
CAGCGCCAACACGATA-1_V10B01-087_A1,1,1,0,0,1,3
ATCCAATGGTACCGAA-1_V10B01-087_A1,0,1,1,0,0,2
GTGCTGCAGATAAGGA-1_V10B01-087_A1,0,0,0,0,1,1
GGCCTTTGCAACTGGC-1_V10B01-087_A1,2,0,1,0,1,4
GTCGTACCTACGATTG-1_V10B01-087_A1,2,2,1,0,0,5
TAGAAATTCACGTATA-1_V10B01-087_A1,2,0,1,0,1,4
AGAATAAATCTTCAGG-1_V10B01-087_A1,0,1,0,0,1,2
CATTGCGAAATGGGCG-1_V10B01-087_A1,2,0,0,0,0,2
GTCTACTCAATTACAA-1_V10B01-087_A1,2,3,1,0,2,8
TGTAATGACCACAATA-1_V10B01-087_A1,2,1,2,0,1,6
AAAGTCGACCCTCAGT-1_V10B01-087_A1,1,4,0,0,1,6
TACTCGGCACGCCGGG-1_V10B01-087_A1,2,1,0,0,0,3
AGGTGTATCGCCATGA-1_V10B01-087_A1,1,3,1,0,4,9
TGTGCTTTACGTAAGA-1_V10B01-087_A1,3,1,2,0,1,7
AAACCTCATGAAGTTG-1_V10B01-087_A1,0,4,0,0,4,8
TATAGGGTACTCATGA-1_V10B01-087_A1,4,0,0,0,0,4
CCAGCTGATGGTACTT-1_V10B01-087_A1,0,4,2,0,4,10
AATATTGGAGTATTGA-1_V10B01-087_A1,2,2,0,0,1,5
GGCCCTCACCCACTTA-1_V10B01-087_A1,0,0,1,0,1,2
AACCAAGACTTCTCTG-1_V10B01-087_A1,0,3,1,0,0,4
TCGTATTACCCATTGC-1_V10B01-087_A1,0,1,0,0,0,1
ATTCGACGCCGGGCCT-1_V10B01-087_A1,0,3,2,0,1,6
GGCGCAGGACATCTTC-1_V10B01-087_A1,1,0,0,0,0,1
GTACTCCCTTATCGCT-1_V10B01-087_A1,1,6,1,0,0,8
TGGTCTGTTGGGCGTA-1_V10B01-087_A1,2,1,0,0,0,3
AATAACAACGCTCGGC-1_V10B01-087_A1,1,1,0,0,0,2
CATACCCGTACCCAGT-1_V10B01-087_A1,1,3,1,0,0,5
ACAATCCATTTAAACC-1_V10B01-087_A1,1,0,2,0,0,3
GTTACAATTGGTGACG-1_V10B01-087_A1,0,0,1,0,1,2
TTGCCCTGATCACGGG-1_V10B01-087_A1,2,0,0,0,1,3
CTAACCGCGCGCCCGT-1_V10B01-087_A1,2,1,0,0,1,4
CTAAAGAATGCCTACT-1_V10B01-087_A1,0,0,1,0,1,2
ACCCATCTTGAGGGTA-1_V10B01-087_A1,0,0,0,0,0,0
GATCTTTGCAGGGTAT-1_V10B01-087_A1,1,0,0,0,0,1
GGGTACTTCATGAACT-1_V10B01-087_A1,1,0,0,0,0,1
GCCGCTTGTGAGAAAC-1_V10B01-087_A1,0,0,0,0,0,0
CCTGTAAGACATGATA-1_V10B01-087_A1,0,0,0,0,2,2
CGACAGTTCGCGTTAT-1_V10B01-087_A1,0,0,0,0,0,0
ACGATGCATATGTTAT-1_V10B01-087_A1,1,0,4,0,1,6
TGTTCCGCTTCCATGA-1_V10B01-087_A1,0,0,4,0,0,4
GGATGACGCGAGTTTA-1_V10B01-087_A1,0,0,3,0,1,4
GAAGTTTCCACTCAAT-1_V10B01-087_A1,0,1,1,0,1,3
GCGAGGCCCGAGCAGA-1_V10B01-087_A1,0,1,1,0,2,4
CATACTATGTAATTGT-1_V10B01-087_A1,1,0,1,0,2,4
CCAATGTCACAGCAAG-1_V10B01-087_A1,1,0,0,0,0,1
GTTGGATTTGCGTTGG-1_V10B01-087_A1,0,1,2,0,1,4
GGGAGGATGCCCGAAA-1_V10B01-087_A1,1,2,0,0,0,3
GATCGCGGGCTCTCCA-1_V10B01-087_A1,0,2,2,0,0,4
GTTCGCCATAAGTGCC-1_V10B01-087_A1,2,2,0,0,1,5
AGATTATAGGACGTTT-1_V10B01-087_A1,0,1,0,0,0,1
TCGAGACCAACACCGT-1_V10B01-087_A1,2,1,0,0,1,4
TATGGGACCGAGCAGG-1_V10B01-087_A1,1,2,0,0,1,4
GATGCGTCCTGCATTC-1_V10B01-087_A1,2,0,2,0,0,4
TATGGTCTGAGTAACA-1_V10B01-087_A1,2,0,1,0,1,4
GCATAGAGCACTCAGG-1_V10B01-087_A1,1,2,3,0,0,6
CTTCATTGTCAGTGGA-1_V10B01-087_A1,2,0,0,0,1,3
GCAGATTAGGGATATC-1_V10B01-087_A1,0,0,0,0,0,0
CCTGTCGCCCGTAAAT-1_V10B01-087_A1,3,2,2,0,0,7
CAATTTCGTATAAGGG-1_V10B01-087_A1,0,0,2,0,2,4
GTACACTTACCTGAAG-1_V10B01-087_A1,1,1,0,0,0,2
CCAGCCTGGACCAATA-1_V10B01-087_A1,0,1,1,1,1,4
ATGGAGCAGGCCGTGA-1_V10B01-087_A1,1,1,0,0,0,2
GTCATTAGAGCGAACG-1_V10B01-087_A1,1,1,1,0,0,3
AAGACTGCAAGCTACT-1_V10B01-087_A1,2,1,2,0,1,6
CTAGTCACGTCTTAAG-1_V10B01-087_A1,0,3,1,0,0,4
ACTCTTGTATAGTAAC-1_V10B01-087_A1,2,4,0,0,0,6
ATTAGGCGATGCTTTC-1_V10B01-087_A1,1,2,0,0,0,3
TTCGGGACTAATCGCG-1_V10B01-087_A1,1,3,0,0,0,4
TGGACTGTTCGCTCAA-1_V10B01-087_A1,4,0,0,0,0,4
AACGTGCGAAAGTCTC-1_V10B01-087_A1,2,4,0,0,0,6
CCACCCAAGGAAAGTG-1_V10B01-087_A1,3,4,2,0,0,9
CCGCACAAAGACCAAC-1_V10B01-087_A1,3,2,1,0,0,6
GCGATTGTTAACGTTA-1_V10B01-087_A1,1,1,0,0,1,3
ACTCGTCAGTAATCCC-1_V10B01-087_A1,3,2,0,0,0,5
GGTGATAAGGAGCAGT-1_V10B01-087_A1,4,1,1,0,0,6
AAGAGGCATGGATCGC-1_V10B01-087_A1,3,2,1,0,0,6
CACGTTCGTGCTCTAG-1_V10B01-087_A1,1,0,0,0,0,1
CTATTTGGTTACGGAT-1_V10B01-087_A1,2,0,0,0,0,2
GTACAGAGGCAAGGGT-1_V10B01-087_A1,1,1,0,0,0,2
GGGCCGGCCGAAGTAC-1_V10B01-087_A1,2,4,2,0,0,8
CCTGAACGATATATTC-1_V10B01-087_A1,2,2,0,1,0,5
CCGGGCTGCTCCATAC-1_V10B01-087_A1,2,3,1,0,1,7
TACTTGTTAGTAGTCC-1_V10B01-087_A1,2,0,0,0,0,2
CCTAGGCGTAGCGATC-1_V10B01-087_A1,1,1,0,0,0,2
CTGGCGCACAGGTCTG-1_V10B01-087_A1,1,0,0,1,0,2
ACTTATACTTACCCGG-1_V10B01-087_A1,0,0,0,0,0,0
GAAGTCTCCCTAGCGA-1_V10B01-087_A1,2,5,0,0,0,7
ACCGATGGTAGCATCG-1_V10B01-087_A1,3,3,0,0,0,6
CGAGTTTATCGGACTG-1_V10B01-087_A1,0,3,0,0,0,3
CATAACGGACAGTCGT-1_V10B01-087_A1,4,3,0,0,0,7
TGACGATGCACTAGAA-1_V10B01-087_A1,3,2,0,0,0,5
TAGGGAGCTTGGGATG-1_V10B01-087_A1,0,1,0,0,0,1
AGGGTCGATGCGAACT-1_V10B01-087_A1,1,0,1,0,1,3
TATATCCCTGGGAGGA-1_V10B01-087_A1,1,1,1,0,0,3
CATCTTACACCACCTC-1_V10B01-087_A1,2,1,0,1,1,5
GTGCGACAGGGAGTGT-1_V10B01-087_A1,0,2,0,0,0,2
CCGATCTCAACCTTAT-1_V10B01-087_A1,3,4,1,0,0,8
ACGATCATCTTGTAAA-1_V10B01-087_A1,1,3,2,1,0,7
GAAAGAACAGCGTTAT-1_V10B01-087_A1,0,0,3,1,0,4
ATATCAACCTACAGAG-1_V10B01-087_A1,2,0,0,0,0,2
ACAGGTGTGTTGTTGC-1_V10B01-087_A1,1,0,0,0,0,1
TGAACTGCTATGACTT-1_V10B01-087_A1,0,0,0,0,1,1
TGACATATATGACGAT-1_V10B01-087_A1,1,1,0,0,2,4
AAGTCTTCTGTGGCCT-1_V10B01-087_A1,3,0,0,0,0,3
ACCAGACCATAACAAC-1_V10B01-087_A1,1,0,0,0,0,1
TGAGACGTACCTCTCA-1_V10B01-087_A1,5,1,2,0,1,9
GACCGTTACATGCGAC-1_V10B01-087_A1,1,0,0,0,2,3
GGTTCGGATTATACTA-1_V10B01-087_A1,1,0,1,0,1,3
CCTCCTGAGCCCACAT-1_V10B01-087_A1,1,1,1,0,2,5
CCGCGATTTGGTAGGT-1_V10B01-087_A1,3,0,0,0,1,4
AATCTCTACTGTGGTT-1_V10B01-087_A1,2,0,1,0,1,4
ACTTTGACTGCATCCT-1_V10B01-087_A1,0,3,0,0,2,5
CCCTGACTAACAAATT-1_V10B01-087_A1,4,2,0,0,0,6
ACGCTGTGAGGCGTAG-1_V10B01-087_A1,2,5,1,0,2,10
GCATACGAGGTCTTTA-1_V10B01-087_A1,0,5,1,0,4,10
TCGGGATTCAAACATA-1_V10B01-087_A1,1,0,0,0,0,1
GGGCCCTACGAAAGGG-1_V10B01-087_A1,2,3,0,0,1,6
CGCCAAGAAGCCGAGT-1_V10B01-087_A1,3,0,0,0,0,3
GGTACATCTGGGACGA-1_V10B01-087_A1,0,3,0,0,2,5
GGATGCTGGCGTTCCT-1_V10B01-087_A1,0,1,3,0,2,6
CCGATTCGAGGGACCC-1_V10B01-087_A1,1,0,2,0,2,5
CCACTGGTGGCTGGTT-1_V10B01-087_A1,0,0,2,0,1,3
GACAGGCACACACTAT-1_V10B01-087_A1,1,0,1,0,1,3
TCAACGCGACCGGCAG-1_V10B01-087_A1,0,0,0,0,1,1
CTACGACTAGCTATAA-1_V10B01-087_A1,0,1,0,0,1,2
CGGTTGACCTGGCATA-1_V10B01-087_A1,0,0,0,0,1,1
ATCCTGAATCGCTGCG-1_V10B01-087_A1,0,2,0,0,0,2
GTTTCATATCGTCGCT-1_V10B01-087_A1,2,4,3,0,0,9
ATAAATATTAGCAGCT-1_V10B01-087_A1,0,0,0,0,1,1
AAGAGGATGTACGCGA-1_V10B01-087_A1,2,1,0,0,0,3
TCCTGCGTTGATACTC-1_V10B01-087_A1,4,1,0,0,0,5
CGTGCATTGTCGACGC-1_V10B01-087_A1,3,0,0,0,0,3
CCGGGTTCGAGGTTAC-1_V10B01-087_A1,3,0,1,0,1,5
CCCAATTTCACAACTT-1_V10B01-087_A1,0,0,0,0,0,0
TGATTTATTAGCTGTG-1_V10B01-087_A1,3,0,0,0,1,4
TGGAAGAAGGGAACGT-1_V10B01-087_A1,2,0,1,0,0,3
GACGCTTGCTTCTAAA-1_V10B01-087_A1,5,0,0,0,0,5
GGGAACGGGAGGTTAG-1_V10B01-087_A1,2,1,0,0,0,3
GCGGCTCTGACGTACC-1_V10B01-087_A1,1,1,0,0,0,2
ACGTTAGATTTGCCCG-1_V10B01-087_A1,1,0,0,0,0,1
GAGAGGGCGCGAGGTT-1_V10B01-087_A1,2,2,1,0,1,6
GCGTCTCTGCATTGGG-1_V10B01-087_A1,1,0,0,0,1,2
GCAGCACACAGCCCAG-1_V10B01-087_A1,3,0,0,0,0,3
CAGGCCGTTTGGGTGT-1_V10B01-087_A1,1,0,0,0,1,2
AACTCAAGTTAATTGC-1_V10B01-087_A1,1,1,4,0,1,7
CTTCGTAGATAGGTGA-1_V10B01-087_A1,0,0,0,0,1,1
TGCAGAGTACCGAGCA-1_V10B01-087_A1,0,0,0,1,0,1
GAAGTGATTTATCGTG-1_V10B01-087_A1,0,0,0,0,0,0
CGCTACGGGACATTTA-1_V10B01-087_A1,0,1,0,0,2,3
CCACACTGAGATATTA-1_V10B01-087_A1,0,0,0,0,2,2
CGATCCGACCCAGTGC-1_V10B01-087_A1,1,2,1,0,2,6
CTGTACTTCTTAGCAT-1_V10B01-087_A1,0,0,4,0,0,4
ACTTATTAGGATCGGT-1_V10B01-087_A1,2,1,1,0,1,5
TAGTCCGCAGAGAATG-1_V10B01-087_A1,0,0,2,1,2,5
TTCACGAAAGGATCAC-1_V10B01-087_A1,0,0,2,0,0,2
TACATTTCTAACGTGC-1_V10B01-087_A1,1,0,1,0,0,2
ACCATATCCGCAATAA-1_V10B01-087_A1,2,0,0,0,0,2
CACTCAAGAGCTATGG-1_V10B01-087_A1,0,0,0,0,1,1
TGTACGAACAAATCCG-1_V10B01-087_A1,2,1,0,0,0,3
ATCATCCAATATTTGT-1_V10B01-087_A1,2,1,0,0,1,4
CGCTATTCTTAGGCTC-1_V10B01-087_A1,0,1,1,0,1,3
TGGCAGCAGTAATAGT-1_V10B01-087_A1,1,0,0,0,0,1
TCACGTGCCCGATTCA-1_V10B01-087_A1,1,1,1,0,0,3
CATACGGCGTCTGGGC-1_V10B01-087_A1,0,1,0,0,0,1
CACATGATTCAGCAAC-1_V10B01-087_A1,1,1,4,1,0,7
GCTAGTAGAGCTTGTA-1_V10B01-087_A1,2,1,0,1,0,4
TGCTGTTGAAGAACTC-1_V10B01-087_A1,0,2,0,1,2,5
CGGAGCATGGCGATCC-1_V10B01-087_A1,2,0,2,0,0,4
TAGCGTTGGGTCTTAC-1_V10B01-087_A1,1,2,1,0,0,4
GTAGCGGCTATACACT-1_V10B01-087_A1,2,0,0,0,1,3
TAACATACAATGTGGG-1_V10B01-087_A1,0,0,0,0,0,0
TCTTCGAATAGACGTT-1_V10B01-087_A1,2,2,2,1,0,7
GATCGTGACTGATATC-1_V10B01-087_A1,4,0,0,0,0,4
GATCCGGGAATTAACA-1_V10B01-087_A1,2,2,0,0,0,4
TTATATACGCTGTCAC-1_V10B01-087_A1,2,0,0,1,0,3
GTCGCGTAACCCGTTG-1_V10B01-087_A1,2,2,0,0,0,4
AGCTCTAGACGTTCCA-1_V10B01-087_A1,1,0,0,1,0,2
GTCAAGCGGACTCGGG-1_V10B01-087_A1,3,2,1,1,1,8
CGAGGGACTGCGGTCG-1_V10B01-087_A1,5,0,0,0,0,5
AATCGCCTCAGCGCCA-1_V10B01-087_A1,2,1,1,0,0,4
CTTGTTGCTGAGTCAA-1_V10B01-087_A1,5,1,0,0,0,6
GATATGAGACACTAAC-1_V10B01-087_A1,1,0,1,1,0,3
TTATGATCTTAACGAA-1_V10B01-087_A1,0,2,0,1,0,3
CGCCGCCCATGCCTGT-1_V10B01-087_A1,2,1,0,0,1,4
CTGGGATAAATAATGG-1_V10B01-087_A1,1,1,0,0,1,3
GTGCCCGTTCGGATTC-1_V10B01-087_A1,1,0,0,0,0,1
TTCAATACTCTGAATC-1_V10B01-087_A1,2,4,0,1,0,7
CGCACATGTCCACTAC-1_V10B01-087_A1,2,1,0,2,1,6
AGAAGAGCGCCGTTCC-1_V10B01-087_A1,6,1,0,0,0,7
GATAACTCGCACTGTG-1_V10B01-087_A1,1,1,0,0,0,2
AGTCGACGGTCTCAAG-1_V10B01-087_A1,2,5,0,1,0,8
GTGACCGCACACTACG-1_V10B01-087_A1,4,4,0,0,0,8
GTATGTGGGTCTAGTT-1_V10B01-087_A1,0,1,0,0,1,2
CTTGAGTTAGGGTAAT-1_V10B01-087_A1,3,1,1,0,0,5
TTAGCTGATTTGCCGT-1_V10B01-087_A1,4,1,0,2,0,7
GCTGTTGCTACCGAAC-1_V10B01-087_A1,2,1,0,0,0,3
TATTACCATCCTGCTT-1_V10B01-087_A1,1,0,0,0,1,2
TTGAATTCACGTGAGG-1_V10B01-087_A1,2,1,1,0,1,5
CCATCTCACCAGTGAA-1_V10B01-087_A1,1,0,1,0,0,2
CGCACGTGCGCTATCA-1_V10B01-087_A1,2,1,1,1,0,5
ACCCGGATGACGCATC-1_V10B01-087_A1,4,1,0,0,0,5
CGCTAGAGACCGCTGC-1_V10B01-087_A1,2,0,1,0,0,3
ATAGTTCCACCCACTC-1_V10B01-087_A1,2,0,4,0,1,7
GCAGACCCAGCACGTA-1_V10B01-087_A1,3,0,0,2,0,5
TAGACTACCTAGCGTT-1_V10B01-087_A1,2,0,2,2,0,6
GGTTCTACTCGTCTGA-1_V10B01-087_A1,1,0,0,0,0,1
GACTCACCCACGTGAG-1_V10B01-087_A1,4,1,0,0,1,6
AGCTCTTCGTAACCTT-1_V10B01-087_A1,4,0,0,0,0,4
AAGGATCGATCGCTTG-1_V10B01-087_A1,1,0,0,0,0,1
TAATTTCCGTCCAGTA-1_V10B01-087_A1,1,0,0,0,1,2
TCCTTCAATCCCTACG-1_V10B01-087_A1,2,0,1,0,0,3
TACCTATCCCTAGAGG-1_V10B01-087_A1,1,1,0,0,0,2
GCATGGGTACTGACGC-1_V10B01-087_A1,0,2,0,0,1,3
GTCGGGAACATGGTAG-1_V10B01-087_A1,4,1,1,0,0,6
GCAAATGAGGACACTT-1_V10B01-087_A1,0,1,0,0,1,2
GAATGGGCTTATCGAC-1_V10B01-087_A1,1,1,0,0,2,4
TGGTCGTGCAAGGCAA-1_V10B01-087_A1,2,0,1,0,0,3
CACCACGCCACACAGA-1_V10B01-087_A1,3,5,3,0,0,11
GAACCTCGACCTACAC-1_V10B01-087_A1,2,1,0,0,0,3
CAATACGCTCTGAGGC-1_V10B01-087_A1,0,1,0,0,1,2
TGGTAAGCAGGATTGA-1_V10B01-087_A1,2,0,0,0,2,4
AGTGGCTCCGTCGGCC-1_V10B01-087_A1,1,0,1,0,1,3
GATCGGATAGAACCAT-1_V10B01-087_A1,0,0,0,0,0,0
GCTACAGTACGGACCG-1_V10B01-087_A1,0,1,0,0,1,2
TCTATTACTAGAGGAT-1_V10B01-087_A1,1,0,2,0,0,3
TTCAGGCGTCAAAGCC-1_V10B01-087_A1,2,0,0,0,0,2
AGACCGGGAAACCCTG-1_V10B01-087_A1,3,2,0,0,0,5
AGAGATCTCTAAAGCG-1_V10B01-087_A1,5,0,0,0,1,6
CCCTGCCCAATCCGCT-1_V10B01-087_A1,1,1,2,0,2,6
GTGGCGGTCCCAGCGT-1_V10B01-087_A1,1,0,0,0,2,3
GCATTGTAATTCATAT-1_V10B01-087_A1,1,0,1,0,0,2
CCGTTCCGAATCTCGG-1_V10B01-087_A1,2,0,0,0,2,4
AGCTTGATCTTAACTT-1_V10B01-087_A1,6,0,1,0,3,10
CCTGTACTCACGCCCA-1_V10B01-087_A1,0,0,1,0,2,3
AAGTGACGACCGAATT-1_V10B01-087_A1,0,0,0,0,2,2
CTCACTTGGCTGGTAA-1_V10B01-087_A1,2,2,3,0,2,9
CGCCTGGCCTACGTAA-1_V10B01-087_A1,3,0,0,0,2,5
CCCGTAAGTCTAGGCC-1_V10B01-087_A1,0,0,1,0,1,2
TTGGACATGTGGCTTA-1_V10B01-087_A1,2,0,0,0,1,3
ATTACGCGCTGGCAGG-1_V10B01-087_A1,2,0,0,0,0,2
ACGCGCTACACAGGGT-1_V10B01-087_A1,1,0,0,0,1,2
TACGTTTACCGGCAAT-1_V10B01-087_A1,0,1,1,0,0,2
CGAAACGCAATTCATG-1_V10B01-087_A1,0,0,0,0,1,1
TAGTCTAACAACGAGA-1_V10B01-087_A1,0,0,0,0,0,0
TTGCATGCTGATCACG-1_V10B01-087_A1,2,0,3,0,0,5
TCTGGGTAGCGCTCAT-1_V10B01-087_A1,0,0,3,0,1,4
ACATCGGTCAGCCGCG-1_V10B01-087_A1,1,1,1,0,0,3
AGATACCGGTGTTCAC-1_V10B01-087_A1,1,0,0,0,0,1
GATTACTGAATTTGGG-1_V10B01-087_A1,1,0,1,0,0,2
TCCAACTTTAAATTCT-1_V10B01-087_A1,1,1,0,0,1,3
TCCTAGCAAAGAAGCT-1_V10B01-087_A1,2,0,2,0,2,6
GTCTATCTGAGTTTCT-1_V10B01-087_A1,2,0,0,0,0,2
GATGTTCAATCCACGA-1_V10B01-087_A1,0,1,1,0,0,2
AGTTAAACACTTGCGA-1_V10B01-087_A1,1,2,0,0,0,3
AGCTCTTTACTCAGTT-1_V10B01-087_A1,2,0,2,0,0,4
ATCCAGGATTCGTGAA-1_V10B01-087_A1,0,1,0,0,0,1
AGTCAACACCACCATC-1_V10B01-087_A1,2,1,1,0,2,6
CGATACCTCGCGGACA-1_V10B01-087_A1,1,1,0,0,0,2
TACAACGCACAACTCA-1_V10B01-087_A1,1,1,1,2,0,5
AATTAAAGGTCGGCGT-1_V10B01-087_A1,1,1,0,0,1,3
TACGCAGTTCTTTCCT-1_V10B01-087_A1,1,1,0,0,0,2
GACCGTGCTGACGGTG-1_V10B01-087_A1,0,0,1,0,1,2
GGCAAATTACTTTACT-1_V10B01-087_A1,0,2,0,0,2,4
GGTACAAACATGCTAT-1_V10B01-087_A1,1,0,4,0,1,6
CGGGCCTTCTTTGTAA-1_V10B01-087_A1,1,1,2,0,0,4
CGTGAAGTTAATTCAC-1_V10B01-087_A1,2,1,0,0,0,3
ATAGTGAAGCGTTCTC-1_V10B01-087_A1,0,0,0,0,0,0
TACGCCATATTCTAAT-1_V10B01-087_A1,1,1,2,0,0,4
GCCGGGTTAGGGTCGC-1_V10B01-087_A1,0,1,0,0,0,1
TACATAGGCATACACC-1_V10B01-087_A1,0,2,3,0,1,6
GCCGATTGGCCAAGCT-1_V10B01-087_A1,1,1,0,0,1,3
CTGCCATGCATCACAT-1_V10B01-087_A1,1,3,0,0,0,4
TTATGAATGAAAGGGA-1_V10B01-087_A1,3,1,1,0,2,7
GCTGAGGCGTGAGTAT-1_V10B01-087_A1,2,0,0,0,0,2
GCGCCGTTCCACGATA-1_V10B01-087_A1,1,7,0,0,0,8
CGCATGGTGCGATGCT-1_V10B01-087_A1,1,1,0,0,0,2
AGGTTTCACACACCTT-1_V10B01-087_A1,0,3,1,0,2,6
CAAGGATCGCATGTTC-1_V10B01-087_A1,1,1,1,0,0,3
ACGTTAATGTCGAAGA-1_V10B01-087_A1,1,0,0,0,0,1
TCCAGAGCACCGGTTC-1_V10B01-087_A1,3,0,0,0,1,4
GATTCGACGGTTCACG-1_V10B01-087_A1,1,1,2,2,3,9
GTTTCTGCAGTCTCCC-1_V10B01-087_A1,2,2,0,0,1,5
GCTGCACGGTTTCTTA-1_V10B01-087_A1,2,1,0,1,0,4
CGTGCAGACTGGGACA-1_V10B01-087_A1,3,3,0,1,0,7
GTGTTACTATGCGTCC-1_V10B01-087_A1,1,1,0,0,2,4
TCCTCGGGCTGGGCTT-1_V10B01-087_A1,3,0,0,0,0,3
GTGAGGACACTTAAGG-1_V10B01-087_A1,4,2,0,0,0,6
ATACGCCGGCGAAACC-1_V10B01-087_A1,0,3,0,0,0,3
TCTGCCAGAAACTGCA-1_V10B01-087_A1,1,1,0,0,0,2
TTCTGCGGGTTAGCGG-1_V10B01-087_A1,2,1,0,1,0,4
CTCGGTACCACTGCTC-1_V10B01-087_A1,2,1,0,0,0,3
GTAAGTAACAGTCTGG-1_V10B01-087_A1,5,2,0,2,0,9
GTGCGTGTATATGAGC-1_V10B01-087_A1,2,3,0,2,1,8
ATTTGTCTTGGGAGCT-1_V10B01-087_A1,2,2,0,0,0,4
CCTCGGACCGGGATAG-1_V10B01-087_A1,1,3,1,0,0,5
TAGGTGCTCGCCTAGC-1_V10B01-087_A1,0,4,0,0,0,4
CTTTAGGAACACTGTT-1_V10B01-087_A1,2,3,0,0,0,5
TCGGGCCGTCGTGGTA-1_V10B01-087_A1,5,0,0,4,0,9
AGTGCTTGCACGAATA-1_V10B01-087_A1,1,2,2,1,0,6
TGCAGTTTCCTCCCAT-1_V10B01-087_A1,3,1,0,3,0,7
TGAGAGATTTACCACG-1_V10B01-087_A1,3,1,1,0,0,5
GAAACAGATGACCACC-1_V10B01-087_A1,1,2,0,2,0,5
AGCAACATATCTTATT-1_V10B01-087_A1,1,0,2,0,0,3
CAAGTGTGGTTGCAAA-1_V10B01-087_A1,3,1,1,0,0,5
GCCTCATCTGGAAATA-1_V10B01-087_A1,1,1,3,0,0,5
AACCCTACTGTCAATA-1_V10B01-087_A1,0,1,1,1,0,3
ACGTATTACTCCGATC-1_V10B01-087_A1,0,0,1,0,0,1
TCTGGGAACCTTTGAA-1_V10B01-087_A1,2,0,1,0,1,4
GCTCGCTCATGTCCAA-1_V10B01-087_A1,1,2,0,0,0,3
GCGCAAGAGCGCGCTG-1_V10B01-087_A1,4,0,1,0,0,5
TTGACGCTCCATGAGC-1_V10B01-087_A1,0,0,2,0,0,2
TATAGATGGTCGCAGT-1_V10B01-087_A1,2,2,1,0,0,5
TTACATGCCACAACTA-1_V10B01-087_A1,2,4,2,1,0,9
ACATGGCGCCAAAGTA-1_V10B01-087_A1,1,1,2,1,0,5
TATGGTTAGTGGGAGA-1_V10B01-087_A1,0,1,4,1,0,6
CATGACTTCGCTGAAT-1_V10B01-087_A1,0,0,3,2,0,5
ACCACCAATGTAACAA-1_V10B01-087_A1,2,4,1,0,0,7
TCTTAGAGCTCCAATT-1_V10B01-087_A1,3,1,0,0,0,4
CCACGAATTTAACCTC-1_V10B01-087_A1,2,1,2,0,0,5
TTCTTGCTAGCATCTC-1_V10B01-087_A1,0,1,0,0,0,1
ACACCTTACTACTTGC-1_V10B01-087_A1,3,0,0,0,0,3
TGTGTCGAAGTCGAGG-1_V10B01-087_A1,2,2,0,0,0,4
GGATCAGAGCCATCAG-1_V10B01-087_A1,1,0,0,0,0,1
GTCCCAATCATCCCGC-1_V10B01-087_A1,1,0,0,0,1,2
TGCCACACTAGAGGAA-1_V10B01-087_A1,2,0,1,0,2,5
TGAATTTCACTTGCCT-1_V10B01-087_A1,3,0,1,0,0,4
CTCAGATTGTGATAAG-1_V10B01-087_A1,1,2,0,0,0,3
CGGACGTTACTTGAAG-1_V10B01-087_A1,1,0,0,0,1,2
CCGCCTTGCGATGTCG-1_V10B01-087_A1,1,0,0,0,1,2
CCAGTCAAATCTCTTA-1_V10B01-087_A1,2,0,0,0,0,2
AAACAGCTTTCAGAAG-1_V10B01-087_A1,1,0,0,0,0,1
TAGCTGATGTGAAGCG-1_V10B01-087_A1,0,0,2,0,0,2
CTTATGCGCTCAGGGC-1_V10B01-087_A1,1,0,2,0,2,5
TGGCTCTTGTCGCGTA-1_V10B01-087_A1,0,0,0,0,0,0
TTGTGAGGCATGACGC-1_V10B01-087_A1,2,1,0,0,0,3
CATAAGCTCTCCGTCT-1_V10B01-087_A1,0,1,1,0,0,2
CCTTCTCAGCGTTCCT-1_V10B01-087_A1,2,0,0,0,0,2
TGCAGCTACGTACTTC-1_V10B01-087_A1,1,2,0,0,0,3
CTCTACACTGGCGATT-1_V10B01-087_A1,1,0,0,0,0,1
TGCAGATCGTCCTAGG-1_V10B01-087_A1,2,0,0,0,1,3
TGCCAAAGTCAGACTT-1_V10B01-087_A1,4,1,0,0,0,5
ACAATAGTCGTACGTT-1_V10B01-087_A1,1,0,0,0,2,3
CATGCCAACTCGCAAA-1_V10B01-087_A1,2,0,2,0,1,5
TGCAGAACTATATCGT-1_V10B01-087_A1,2,0,1,0,2,5
TCGTGTCACGCTGACA-1_V10B01-087_A1,0,1,0,0,2,3
TGATCAGGGAACTGCT-1_V10B01-087_A1,3,1,2,0,1,7
CTTGCAACCGCCTCCT-1_V10B01-087_A1,2,1,0,0,2,5
AGCCCATACATGTAAG-1_V10B01-087_A1,3,1,0,0,3,7
ATCCAATGGAGGGTCC-1_V10B01-087_A1,2,0,0,0,2,4
AAACCGGGTAGGTACC-1_V10B01-087_A1,4,1,1,0,3,9
GCAACCACGGCCGCGT-1_V10B01-087_A1,0,1,4,0,2,7
CGCTTATTCCCGGTCG-1_V10B01-087_A1,4,0,2,0,0,6
TTACTCTGGTACGTAC-1_V10B01-087_A1,2,0,0,0,1,3
GTGGTTTCCGCCTTTC-1_V10B01-087_A1,7,1,5,0,1,14
ATAGGCGGCTATAGAA-1_V10B01-087_A1,1,1,1,0,0,3
GTGCCATCACACGGTG-1_V10B01-087_A1,2,0,1,0,0,3
CCCAACATACGTCGCG-1_V10B01-087_A1,0,0,0,0,0,0
CGGTGCAGATAGAACG-1_V10B01-087_A1,2,0,0,0,1,3
GGGCGGGTTCCCTACG-1_V10B01-087_A1,2,0,2,0,2,6
TGAGCCATACAGTCTC-1_V10B01-087_A1,0,0,2,0,0,2
CTCCGCCCACATGAGG-1_V10B01-087_A1,1,1,0,0,1,3
GTTGAACCGGTTCCAT-1_V10B01-087_A1,2,1,0,0,0,3
TTGACTACCATATGGT-1_V10B01-087_A1,0,0,3,0,1,4
ACCATCGTATATGGTA-1_V10B01-087_A1,1,2,1,0,0,4
TGCGTAAGAACCTGAT-1_V10B01-087_A1,1,0,0,0,2,3
AGAAGGTTGCCGAATT-1_V10B01-087_A1,1,2,0,0,1,4
AGGACGACCCATTAGA-1_V10B01-087_A1,2,1,1,0,0,4
GGTGCTGGTACACATT-1_V10B01-087_A1,1,1,0,0,0,2
GCGCTATGCCGAGGCA-1_V10B01-087_A1,0,0,1,0,0,1
ACCCGGTTACACTTCC-1_V10B01-087_A1,1,1,0,0,0,2
TAACTCATCCGCGCGG-1_V10B01-087_A1,0,1,0,0,1,2
CACAATGAGCTGCTAT-1_V10B01-087_A1,0,1,1,0,0,2
GTTACTTTGGGCCTAG-1_V10B01-087_A1,0,1,0,0,0,1
GGGCCCGTCTTAAACA-1_V10B01-087_A1,0,1,0,0,0,1
GAAATTGTCTCTATAA-1_V10B01-087_A1,1,0,0,0,2,3
GGCGCATGAATTGATG-1_V10B01-087_A1,0,1,2,0,1,4
CATATAGGTACAGTCA-1_V10B01-087_A1,2,0,0,0,1,3
TCAACGAGGAGACAAA-1_V10B01-087_A1,1,0,0,0,1,2
TTGCACAATTCAGAAA-1_V10B01-087_A1,1,2,0,0,1,4
CATCGGACGGGTTAAT-1_V10B01-087_A1,0,0,1,0,1,2
ATTAAACATGCGGACC-1_V10B01-087_A1,1,0,0,1,3,5
TATCTACCACAGCGGG-1_V10B01-087_A1,1,0,0,1,0,2
CGAGACCCTAGAGTGT-1_V10B01-087_A1,1,2,1,0,0,4
ACATCGATCGTTTACC-1_V10B01-087_A1,2,0,1,0,1,4
ATCGACCCAATACAGA-1_V10B01-087_A1,0,0,1,0,1,2
GAATCTGAACATTCTC-1_V10B01-087_A1,1,1,0,0,0,2
AGTTCCTATTTATGTT-1_V10B01-087_A1,1,0,2,0,0,3
CAGTCTGTATACTGGG-1_V10B01-087_A1,1,4,0,0,0,5
GGAGACGACACCTTTG-1_V10B01-087_A1,2,0,0,0,1,3
CCTAAATTAACGGTTC-1_V10B01-087_A1,1,0,3,0,0,4
GCTACGACTTATTGGG-1_V10B01-087_A1,3,4,0,0,0,7
CTGTGCAGGGTAGGTC-1_V10B01-087_A1,0,3,0,0,1,4
ACGCCGCTAGACGACC-1_V10B01-087_A1,1,0,0,0,1,2
ACTTGACTCCCTCTTT-1_V10B01-087_A1,1,1,0,0,0,2
CGCCTCCCTCCTCTAT-1_V10B01-087_A1,1,2,1,0,0,4
CTAGATTTACGACGGC-1_V10B01-087_A1,2,2,0,0,0,4
GATGCTGTATTTCATC-1_V10B01-087_A1,3,0,2,0,0,5
TGCGTTTGTTGACACT-1_V10B01-087_A1,1,7,0,0,0,8
CGTGCCCTCCCGAAGA-1_V10B01-087_A1,0,0,2,0,0,2
ACTCTCTGACTTAGGT-1_V10B01-087_A1,1,2,0,0,0,3
CTGGGTAGGCAGTTAA-1_V10B01-087_A1,2,0,0,1,1,4
GTTTGGCCCAAGTTAT-1_V10B01-087_A1,2,1,1,0,0,4
GAATGTGGTCCGGATT-1_V10B01-087_A1,1,0,1,0,0,2
CCCAGTTAAGGCGCCG-1_V10B01-087_A1,3,1,0,0,2,6
CGGTACTAGAATCAAA-1_V10B01-087_A1,2,0,0,3,0,5
GCTTAATGTAACTAAC-1_V10B01-087_A1,1,4,2,0,0,7
AGGACAGTCGAATCCC-1_V10B01-087_A1,2,1,2,0,0,5
GACAGCCAGACCTGAC-1_V10B01-087_A1,2,0,0,3,0,5
GGCGAAATCTAACTTG-1_V10B01-087_A1,2,1,0,0,0,3
CTGGTAACACATAGAA-1_V10B01-087_A1,2,0,0,1,0,3
TAGCCATTTCAAAGTC-1_V10B01-087_A1,0,0,2,3,1,6
GGGATTTACCGCACCT-1_V10B01-087_A1,3,1,0,3,0,7
ATGCCATTTGCGACCA-1_V10B01-087_A1,1,1,0,0,0,2
GAATAGACGCGACCCA-1_V10B01-087_A1,0,2,1,1,0,4
TGTATGGCGCAGACAG-1_V10B01-087_A1,0,0,0,0,0,0
GGATGAAGATCGCTGA-1_V10B01-087_A1,1,0,1,0,0,2
CGACAATTTGATCTAA-1_V10B01-087_A1,2,0,2,1,0,5
AAAGTTGACTCCCGTA-1_V10B01-087_A1,1,1,2,0,0,4
CGCGGCTCAACTTGAA-1_V10B01-087_A1,1,3,1,0,0,5
CACGCGGAACTGTTGC-1_V10B01-087_A1,1,2,3,2,0,8
TCTTAGAGTGAACTCT-1_V10B01-087_A1,1,1,1,3,0,6
AGTCCATTGGCTGATG-1_V10B01-087_A1,1,1,3,0,0,5
TTAAGATAGGATTGAC-1_V10B01-087_A1,1,1,0,1,0,3
ACATCCTGGTAACTGT-1_V10B01-087_A1,2,0,0,0,0,2
CACCTTGGCGCCTTTG-1_V10B01-087_A1,2,2,1,2,0,7
GCTAGACCGTCTACTG-1_V10B01-087_A1,1,1,1,0,0,3
CGGCCCAGGTATATCC-1_V10B01-087_A1,0,1,2,0,0,3
GTCCATTACTGCTACG-1_V10B01-087_A1,2,1,1,0,0,4
GGGTTTAGGATAGGAT-1_V10B01-087_A1,0,2,1,0,0,3
TAATTAGGACATCCGT-1_V10B01-087_A1,1,2,1,0,0,4
GCTCCCAGTCGGTCCA-1_V10B01-087_A1,1,4,0,0,0,5
ATTCGTGCTATCTCTT-1_V10B01-087_A1,3,1,0,0,0,4
GTTAACTATGTTGTCA-1_V10B01-087_A1,0,2,1,0,0,3
GCTCCGCTCGCTTCAG-1_V10B01-087_A1,0,2,2,3,0,7
GCAACGGCTAGTTATG-1_V10B01-087_A1,0,1,1,3,1,6
AATCGCGCAGAGGACT-1_V10B01-087_A1,0,0,0,0,0,0
AGGTTACACCATGCCG-1_V10B01-087_A1,0,0,0,1,0,1
CTTTGACGTCGCTTCT-1_V10B01-087_A1,1,2,0,0,0,3
CGTTATCATACTTCCA-1_V10B01-087_A1,1,0,1,0,1,3
GCTATGCCAGCTTATG-1_V10B01-087_A1,2,1,0,0,1,4
CAGTCGGCCTAGATAT-1_V10B01-087_A1,1,0,0,0,1,2
CCCGTGAGGGCGGTGA-1_V10B01-087_A1,0,1,0,0,0,1
TCTCGTGTTACGAGGA-1_V10B01-087_A1,0,0,1,0,0,1
ACGTCTCGTTCCGGGA-1_V10B01-087_A1,0,0,0,0,1,1
CGAGAGCGCGTAGATA-1_V10B01-087_A1,0,0,0,0,2,2
GACAGATTTCTGGCTC-1_V10B01-087_A1,2,0,0,0,2,4
GGGCCTAAATGGGCTA-1_V10B01-087_A1,0,1,0,0,2,3
ACTTGTAGTCCCTTCA-1_V10B01-087_A1,2,1,0,0,0,3
CCCGAAGTTTCGCGAA-1_V10B01-087_A1,1,0,1,0,1,3
ACCATCCGCCAACTAG-1_V10B01-087_A1,2,1,2,0,0,5
TGCGAATATGGGATTT-1_V10B01-087_A1,0,0,0,0,0,0
TACATCCCTATCCCTG-1_V10B01-087_A1,5,0,1,0,0,6
GTGGGAAGACTGAATC-1_V10B01-087_A1,1,2,0,0,1,4
TCAACATCGACCGAGA-1_V10B01-087_A1,0,0,0,0,0,0
CTATGTGAGTCACGGC-1_V10B01-087_A1,4,0,1,0,1,6
CCGAACACTGGGCCTC-1_V10B01-087_A1,2,0,1,0,0,3
AAACTTGCAAACGTAT-1_V10B01-087_A1,0,0,1,0,0,1
AGGGCGAGCAGCTGAT-1_V10B01-087_A1,0,0,1,0,1,2
AACACGAGACGCGGCC-1_V10B01-087_A1,2,0,0,0,0,2
TGACGAATATTTCCCT-1_V10B01-087_A1,3,1,1,0,1,6
TCGGAGAGTATCGGGA-1_V10B01-087_A1,0,5,0,0,0,5
CAAATCTCTCACAAGG-1_V10B01-087_A1,0,4,0,0,2,6
AGGCCCTAGAACGCCA-1_V10B01-087_A1,0,3,3,0,3,9
TAGAGATCATGCAACT-1_V10B01-087_A1,1,1,1,0,1,4
TTGTTTCCATACAACT-1_V10B01-087_A1,3,0,2,0,1,6
GAGAGGTGCATTCTGG-1_V10B01-087_A1,1,0,2,0,3,6
GTGGACCAACCCGATT-1_V10B01-087_A1,0,1,0,0,0,1
CTGGGCCTGCTATATC-1_V10B01-087_A1,0,0,0,0,0,0
CATAGTCCACAAGAAC-1_V10B01-087_A1,1,0,1,0,1,3
TTGACATGAACGTGGA-1_V10B01-087_A1,1,0,3,0,1,5
GGTTACCACCCTCGGG-1_V10B01-087_A1,2,0,1,0,0,3
TACCGGTCGTTTCCAT-1_V10B01-087_A1,1,0,1,0,0,2
CGAGTACTAAAGAGGA-1_V10B01-087_A1,0,0,1,0,0,1
GCAAGAATTCCTTGGC-1_V10B01-087_A1,3,0,0,0,0,3
TCGCCGAAGTTGCGTC-1_V10B01-087_A1,3,0,0,0,0,3
TTGAGAGTACTGCTAA-1_V10B01-087_A1,2,0,0,0,0,2
GCCACAATTTAAGGAC-1_V10B01-087_A1,2,0,0,0,1,3
ATATTCAGTTAAACCT-1_V10B01-087_A1,6,2,0,0,1,9
TGAGTGCCTCTTAAAT-1_V10B01-087_A1,1,2,1,0,2,6
ATCAGACGGCACGCCG-1_V10B01-087_A1,0,0,0,0,1,1
GTGCGAAATCGAACAC-1_V10B01-087_A1,3,0,2,0,0,5
GTGCCGCTTCAAAGGT-1_V10B01-087_A1,0,0,0,0,0,0
GATACGATGGGAGTCA-1_V10B01-087_A1,0,5,2,0,0,7
GACACTGAGTTCAGTG-1_V10B01-087_A1,1,1,1,0,1,4
ATCCTGCGTGGAATGG-1_V10B01-087_A1,1,0,0,0,0,1
ATCCTACCTAAGCTCT-1_V10B01-087_A1,0,1,2,0,0,3
AGTGATATGAGTAGTT-1_V10B01-087_A1,1,1,0,0,1,3
ATGATGCAATGGTACA-1_V10B01-087_A1,1,1,1,0,0,3
GAAACCGAATTACCTT-1_V10B01-087_A1,0,1,0,0,1,2
AGTGACCTACTTTACG-1_V10B01-087_A1,2,0,0,0,0,2
CAAATGTCCTTCCGTG-1_V10B01-087_A1,2,0,1,0,2,5
TTACTGGGATATTTCA-1_V10B01-087_A1,1,0,0,0,2,3
CTTGCCCAGGCTCTAC-1_V10B01-087_A1,0,2,5,0,0,7
AAATCGTGTACCACAA-1_V10B01-087_A1,1,2,0,0,0,3
GTGATCATAGATCTGC-1_V10B01-087_A1,0,0,2,0,3,5
TGGCAGATTACGATCA-1_V10B01-087_A1,0,2,0,0,0,2
TCACCCTCTTAAGATT-1_V10B01-087_A1,0,1,0,0,1,2
CAGGATATATCGTTGT-1_V10B01-087_A1,0,0,0,0,1,1
CCTGACCACCGATGGT-1_V10B01-087_A1,3,0,2,0,1,6
CTAAAGGGAAATAGGA-1_V10B01-087_A1,0,0,0,0,1,1
CCGCTATCAGCACCAG-1_V10B01-087_A1,1,0,1,0,1,3
CTTTAGTGCTATTATT-1_V10B01-087_A1,3,0,1,0,1,5
CGGGAATTTATGTAAA-1_V10B01-087_A1,2,1,0,0,0,3
TACGACTGCCTCTTAG-1_V10B01-087_A1,1,2,0,0,2,5
AAACTGCTGGCTCCAA-1_V10B01-087_A1,0,0,1,0,1,2
GTACGTTTGCCCGTCA-1_V10B01-087_A1,0,1,1,0,0,2
GGCAAGGCGAAATAGC-1_V10B01-087_A1,0,1,0,0,0,1
GATCTTGGAGGGCATA-1_V10B01-087_A1,0,1,2,0,0,3
AGCGTGGTATTCTACT-1_V10B01-087_A1,0,2,1,0,0,3
CTAAGGGAATGATTGG-1_V10B01-087_A1,0,1,1,1,0,3
CATGGTAAGTAGCGTT-1_V10B01-087_A1,1,0,1,0,0,2
CGTTGAGCGACCGTCG-1_V10B01-087_A1,3,1,0,0,1,5
TGCCCGTACCGTTAAA-1_V10B01-087_A1,0,0,1,0,0,1
ACAAGGGCAGGCTCTG-1_V10B01-087_A1,0,0,0,0,0,0
GAGATCTTCCATGACA-1_V10B01-087_A1,1,0,0,0,0,1
AATGACGTAGGATGTC-1_V10B01-087_A1,1,1,1,0,0,3
GTGGTGGCCAAGTGAA-1_V10B01-087_A1,2,0,2,0,0,4
TCCCGTGTGCAATTTG-1_V10B01-087_A1,3,0,0,0,0,3
ACATCGTATGCAATGG-1_V10B01-087_A1,2,2,2,1,0,7
GCGAAACTTAACTGGA-1_V10B01-087_A1,0,1,2,0,0,3
AATTGAACGCTCTGGT-1_V10B01-087_A1,1,1,0,3,0,5
ACAAATGGTAGTGTTT-1_V10B01-087_A1,1,0,4,0,0,5
ATGGTCGCGTGGTTTC-1_V10B01-087_A1,2,1,0,2,0,5
TGTTATTGTATGTGGC-1_V10B01-087_A1,0,2,1,0,0,3
TTCCGGTTACCCACTT-1_V10B01-087_A1,2,11,0,2,0,15
GAGTGTGCGGTACCCA-1_V10B01-087_A1,1,0,1,2,0,4
CAAGATATTATAACGT-1_V10B01-087_A1,1,0,1,2,0,4
ACACACCAGGACCAGT-1_V10B01-087_A1,0,1,0,3,0,4
ATGGGCCTCGGCCTCT-1_V10B01-087_A1,2,2,1,2,0,7
AAGGTGATAAACCAGC-1_V10B01-087_A1,0,1,1,0,0,2
TCTTACTTATGCCTCT-1_V10B01-087_A1,1,0,0,0,0,1
AAAGTGTGATTTATCT-1_V10B01-087_A1,1,2,0,0,0,3
TGCTCCACAGTTCTTA-1_V10B01-087_A1,0,0,1,0,0,1
CTGGCTGATTCATCCT-1_V10B01-087_A1,1,0,2,1,0,4
TAAGGCTGAATCCCTC-1_V10B01-087_A1,1,0,1,0,0,2
TCTAGTGATATCGTGG-1_V10B01-087_A1,4,0,1,0,0,5
TCGAAGAACCGAGCAC-1_V10B01-087_A1,1,0,3,1,1,6
GACAAACATATGCAGG-1_V10B01-087_A1,2,1,2,2,0,7
AAGTCAATTGTCGTCA-1_V10B01-087_A1,0,1,2,0,0,3
AGTGAACAAACTTCTC-1_V10B01-087_A1,0,1,1,3,0,5
CATGATGGAAGTTAGC-1_V10B01-087_A1,0,2,3,2,0,7
AAGTGCCTTGACTGTA-1_V10B01-087_A1,1,3,0,0,0,4
ATCGCCAGTCAACATT-1_V10B01-087_A1,2,0,0,1,0,3
ACCGCGGTGGAAGTCG-1_V10B01-087_A1,2,1,2,0,0,5
TCTTCTATAACCCGCC-1_V10B01-087_A1,0,1,1,1,0,3
CACATTTCTTGTCAGA-1_V10B01-087_A1,3,2,1,0,1,7
TAGCGTCCCTCGATTG-1_V10B01-087_A1,3,0,3,0,0,6
GTTCGGATCGGGAACA-1_V10B01-087_A1,1,1,1,0,0,3
CAAACTCGCGACGCCG-1_V10B01-087_A1,2,0,1,0,0,3
GTCTTGTAGCTATTCA-1_V10B01-087_A1,0,2,0,0,0,2
TCTCGACGTATCGCCG-1_V10B01-087_A1,1,1,1,0,0,3
TTGCCAAGCAGAACCC-1_V10B01-087_A1,0,1,1,1,0,3
AAACCCGAACGAAATC-1_V10B01-087_A1,1,2,2,0,0,5
TTGAGCAGCCCACGGT-1_V10B01-087_A1,2,1,0,1,0,4
CGCCTTTAGCATGCTC-1_V10B01-087_A1,3,0,2,1,0,6
CGACCTACTAGACAAT-1_V10B01-087_A1,1,0,0,0,0,1
GAGTCTTGTAAAGGAC-1_V10B01-087_A1,1,1,0,0,0,2
AATATCCTAGCAAACT-1_V10B01-087_A1,2,0,0,0,0,2
CCCTAGGCAACAAGAG-1_V10B01-087_A1,4,2,0,0,2,8
ACAAAGAAGGTAGGCC-1_V10B01-087_A1,1,0,0,0,0,1
CCCTGGCTGTTCCTTC-1_V10B01-087_A1,0,0,0,0,0,0
TCGCCGCACCGCGTGA-1_V10B01-087_A1,2,0,3,0,0,5
TATAGCGCACGTTATC-1_V10B01-087_A1,6,1,0,0,0,7
TTATCTGACATTAGGA-1_V10B01-087_A1,1,0,0,1,0,2
AGTGGTGTTACCCGTG-1_V10B01-087_A1,1,0,0,0,0,1
GCCAAGAATACTTCTG-1_V10B01-087_A1,0,0,2,0,1,3
CCGGCGTGAGACTCTG-1_V10B01-087_A1,3,0,0,0,1,4
TTCCCGGCGCCAATAG-1_V10B01-087_A1,1,0,0,0,1,2
AAACAGGGTCTATATT-1_V10B01-087_A1,3,0,0,0,1,4
ACAGTAATACAACTTG-1_V10B01-087_A1,1,0,0,0,0,1
CGAACGGCCGGACAAC-1_V10B01-087_A1,1,0,0,0,1,2
GCAACACACTAGAACT-1_V10B01-087_A1,0,1,0,0,2,3
ACTCCCATTCCTAAAG-1_V10B01-087_A1,2,0,0,0,0,2
ACCTGCGTGTCATGTT-1_V10B01-087_A1,3,0,0,0,1,4
TACTTTCCGCACGCCA-1_V10B01-087_A1,0,0,0,0,0,0
AGGTCAGGTGAGAGTG-1_V10B01-087_A1,2,0,1,0,0,3
TCCTCCTAAGACATTC-1_V10B01-087_A1,0,4,0,0,1,5
ATGTGAAAGCCTAATG-1_V10B01-087_A1,3,3,0,0,0,6
AGTCGGCTCAACTTTA-1_V10B01-087_A1,0,0,0,0,0,0
CGATCTGTTGGAGGAC-1_V10B01-087_A1,0,1,3,0,1,5
ACGGGAGTGTCGGCCC-1_V10B01-087_A1,1,2,1,0,0,4
TTAACTTCAGGTAGGA-1_V10B01-087_A1,3,1,0,0,1,5
CCACGGAGCCATAAGA-1_V10B01-087_A1,1,0,0,0,0,1
CTTCTATGTTGAAGTA-1_V10B01-087_A1,3,0,0,0,1,4
CACCGTTGCGCGATAT-1_V10B01-087_A1,2,0,0,0,0,2
TCTAGCAATCTCCGCC-1_V10B01-087_A1,1,0,0,0,3,4
AGTTTGGCCAGACCTA-1_V10B01-087_A1,0,0,1,0,1,2
TTGTAAGGACCTAAGT-1_V10B01-087_A1,1,1,1,0,0,3
AAATTTGCGGGTGTGG-1_V10B01-087_A1,0,0,0,0,0,0
AAGTTCGGCCAACAGG-1_V10B01-087_A1,2,1,1,0,0,4
CCGCTTACCTCACTCT-1_V10B01-087_A1,0,0,0,0,2,2
ATCACGTGCTAATTAA-1_V10B01-087_A1,0,4,0,0,1,5
GGTGAAGTACAGGGAT-1_V10B01-087_A1,2,2,1,0,0,5
GCTGTATTACTGGCCC-1_V10B01-087_A1,2,0,1,0,2,5
AACGGCCATCTCCGGT-1_V10B01-087_A1,1,0,0,0,3,4
TAAGTAACATCTTGAC-1_V10B01-087_A1,3,1,0,0,1,5
TTCTTGAGCCGCGCTA-1_V10B01-087_A1,7,0,0,0,0,7
AGTGCGTAGCTCGTAA-1_V10B01-087_A1,3,0,0,0,1,4
GGGATGGTCGTAACCG-1_V10B01-087_A1,0,0,0,0,0,0
GTCTGGGCGGTCGAGA-1_V10B01-087_A1,0,0,1,0,1,2
CGGAACGTAAACATAG-1_V10B01-087_A1,0,0,0,0,0,0
TGCGACACCCTAGTGC-1_V10B01-087_A1,4,0,0,0,1,5
CAAACGAGTATCGCAG-1_V10B01-087_A1,1,0,0,0,1,2
TCAGTAGGGACTATAA-1_V10B01-087_A1,2,0,0,0,2,4
GCGGTTCCCTATCATG-1_V10B01-087_A1,0,0,1,0,1,2
GTGACTTCAGTAGTGC-1_V10B01-087_A1,0,0,0,0,0,0
CGTCACGTCCATTGGT-1_V10B01-087_A1,0,0,0,0,0,0
ATAAGTTACCGCGACG-1_V10B01-087_A1,1,1,0,0,2,4
CTGAATCCGAGACCTC-1_V10B01-087_A1,3,0,0,0,0,3
TACGACGCTTGCTGCG-1_V10B01-087_A1,2,1,0,0,1,4
GAATTCACCCGGGTGT-1_V10B01-087_A1,1,0,0,0,0,1
GGGTGACACCTTAACT-1_V10B01-087_A1,1,3,0,0,1,5
TGAGTAAATTAGCGTA-1_V10B01-087_A1,3,1,0,0,1,5
GAGTCCGCTTACCGGA-1_V10B01-087_A1,0,0,0,0,0,0
GGCGCGTTCGAGTTTA-1_V10B01-087_A1,0,0,0,0,0,0
ATTCATATACTGTCCA-1_V10B01-087_A1,0,2,0,0,0,2
ATAAACGGACCCGTAA-1_V10B01-087_A1,0,2,2,0,1,5
GTCGTACCATCTCGGG-1_V10B01-087_A1,0,0,0,0,1,1
ATAATAGCTGTTGAAT-1_V10B01-087_A1,1,2,0,0,1,4
TTCCGCGTGAGGCGAT-1_V10B01-087_A1,1,0,0,0,2,3
TACCGGCTCACTGCCC-1_V10B01-087_A1,2,1,2,0,1,6
GTATCTTTCATAACCA-1_V10B01-087_A1,1,2,0,0,1,4
GTTACCTACAACTTGC-1_V10B01-087_A1,0,0,0,0,2,2
TGACTATAATCCTTTC-1_V10B01-087_A1,0,1,0,0,1,2
AAATACCTATAAGCAT-1_V10B01-087_A1,1,3,2,1,0,7
TTATTAGAGCGTGTTC-1_V10B01-087_A1,0,1,2,0,0,3
ATGTGGACATCTTGAT-1_V10B01-087_A1,1,0,2,0,0,3
GTACGCTTCATTGCAC-1_V10B01-087_A1,1,0,0,0,0,1
CACATATTAGCAGGAT-1_V10B01-087_A1,1,0,2,0,0,3
CAAGAGGGCGGAGTAC-1_V10B01-087_A1,0,1,4,0,0,5
TCGCAAAGATGCATTT-1_V10B01-087_A1,1,0,2,0,0,3
GTCGTTATTCGCTTAT-1_V10B01-087_A1,2,2,1,0,0,5
TCGTGTACTATGGATG-1_V10B01-087_A1,1,0,2,2,1,6
GCGGAGAGGGAGAACG-1_V10B01-087_A1,2,2,1,0,0,5
TCACAGGGAATCGCAA-1_V10B01-087_A1,0,1,1,0,0,2
GACTGCACCAGCCCAG-1_V10B01-087_A1,3,0,1,0,0,4
TCCGCTGTCATCCCGG-1_V10B01-087_A1,1,2,1,0,1,5
AGATACTCAAGATCGA-1_V10B01-087_A1,1,0,1,0,0,2
ACTGAATGGCGAAAGT-1_V10B01-087_A1,1,0,3,0,0,4
TCCTACATCCACGGCC-1_V10B01-087_A1,3,1,2,0,0,6
TTCAGCCCTGGTCCAC-1_V10B01-087_A1,4,1,0,0,0,5
TTAGAGTTTAGAAGGA-1_V10B01-087_A1,0,1,1,1,0,3
GGTTAGCTATATGTCT-1_V10B01-087_A1,1,0,2,1,0,4
CTGGTTTCGAGCAAGA-1_V10B01-087_A1,1,0,2,1,1,5
TGGGCCCATACTAATT-1_V10B01-087_A1,1,3,2,2,0,8
ACTTATTTATGTGCCA-1_V10B01-087_A1,3,1,0,0,0,4
TTAGTTATTCGTGGCA-1_V10B01-087_A1,0,0,3,0,0,3
AACCGCTAAGGGATGC-1_V10B01-087_A1,2,0,0,2,1,5
ATACGTCCACTCCTGT-1_V10B01-087_A1,0,1,3,2,0,6
CGACACGCTCCGACAG-1_V10B01-087_A1,2,3,1,0,0,6
TCTGAACTCGTACCCG-1_V10B01-087_A1,0,1,0,0,0,1
AGGATATAGGGATTTA-1_V10B01-087_A1,0,1,3,0,0,4
GTGATCACTAACGCCT-1_V10B01-087_A1,1,0,0,2,0,3
ACCGGGCCTTTGTTGA-1_V10B01-087_A1,0,2,2,2,1,7
TTGACAGGAGCTCCCG-1_V10B01-087_A1,0,1,3,0,0,4
CTCTTCTATTGACTGG-1_V10B01-087_A1,0,3,5,0,0,8
CGTGGCCGAATATCTA-1_V10B01-087_A1,1,2,0,3,0,6
GGTTTAGCCTTTCTTG-1_V10B01-087_A1,1,1,1,0,0,3
TCAAGGTTACTACACC-1_V10B01-087_A1,2,1,0,0,0,3
TTGACTATTGTCCGGC-1_V10B01-087_A1,0,0,1,0,0,1
CGGGAATATAGTATAC-1_V10B01-087_A1,0,1,0,1,0,2
GCAACAGCAGTATGCG-1_V10B01-087_A1,1,1,2,0,0,4
ATCAAACACTGTTCCA-1_V10B01-087_A1,3,1,1,0,0,5
TGGGCAATAGTTGGGT-1_V10B01-087_A1,2,2,3,1,0,8
TGAATGTCAGCCGGCC-1_V10B01-087_A1,0,0,3,0,0,3
CGGCTCTAAAGCTGCA-1_V10B01-087_A1,1,1,2,0,0,4
GGACACAAGTTTACAC-1_V10B01-087_A1,1,2,3,1,1,8
CCGAGAAGTCGCATAA-1_V10B01-087_A1,2,3,1,0,0,6
AACTACCCGTTTGTCA-1_V10B01-087_A1,2,0,0,0,0,2
GCACAAACGAGGCGTG-1_V10B01-087_A1,1,2,3,2,0,8
CACACAGCTTGCGCTC-1_V10B01-087_A1,0,1,0,1,0,2
GTGCTTACATCAGCGC-1_V10B01-087_A1,2,1,2,0,0,5
GCAAACGTCGCCAGGT-1_V10B01-087_A1,0,3,2,2,0,7
GAATAGCATTTAGGGT-1_V10B01-087_A1,2,1,3,0,0,6
TACTGTTTCTCTGGTA-1_V10B01-087_A1,2,0,2,1,0,5
TATGACCTTGCGCTGG-1_V10B01-087_A1,3,0,0,0,1,4
ATATACATGTATGGTA-1_V10B01-087_A1,1,1,0,0,1,3
TGTGTGACCATGAATC-1_V10B01-087_A1,2,0,2,0,0,4
CCCACTCCACGGTATC-1_V10B01-087_A1,1,1,1,0,1,4
GGGCAGACGTCACTGC-1_V10B01-087_A1,0,0,0,1,0,1
TCAAAGAGCTATCTGT-1_V10B01-087_A1,2,0,2,0,1,5
AGATGCATCCTGTGTC-1_V10B01-087_A1,1,0,3,0,0,4
GTGAAGTCACGACTCG-1_V10B01-087_A1,3,1,0,0,2,6
TGATTCAGGTCCCGCG-1_V10B01-087_A1,4,1,1,0,1,7
CGCCACAGGTCGCGAT-1_V10B01-087_A1,0,1,0,0,0,1
TTGAATCGTTGTATAA-1_V10B01-087_A1,0,0,0,0,0,0
TGGCCAATTTGGTACT-1_V10B01-087_A1,0,0,0,0,1,1
CGACCCTTAACGCCGG-1_V10B01-087_A1,1,0,1,0,1,3
TCGGCGTACTGCACAA-1_V10B01-087_A1,1,1,0,0,0,2
GAGTAAGGCCACGGGA-1_V10B01-087_A1,1,0,0,0,0,1
ATCAGCTCGTCCACTA-1_V10B01-087_A1,1,0,1,0,1,3
AGGATCACGCGATCTG-1_V10B01-087_A1,2,0,0,0,0,2
AAATGGCCCGTGCCCT-1_V10B01-087_A1,0,2,1,0,0,3
CAGTACCAGTTTACGT-1_V10B01-087_A1,0,0,2,0,1,3
GGTCGTAAGCTCGCAC-1_V10B01-087_A1,1,1,0,0,0,2
CGTTCATGGTGCGCGT-1_V10B01-087_A1,1,5,1,0,0,7
GACTACAAAGCGGTGG-1_V10B01-087_A1,3,1,1,0,0,5
CAGCTGGCGTAACCGT-1_V10B01-087_A1,0,2,1,0,1,4
ACTCGTAACCCGTCCT-1_V10B01-087_A1,1,1,1,0,1,4
CATATGTCAGGCTACG-1_V10B01-087_A1,0,0,0,0,0,0
GCCCGACTTCTTCCCG-1_V10B01-087_A1,0,0,0,0,0,0
CTGGCATCCGAATGAG-1_V10B01-087_A1,2,0,1,0,1,4
AAGTGCGTTAGAATCT-1_V10B01-087_A1,2,1,0,0,0,3
AGAAGTGATTCGTGAT-1_V10B01-087_A1,3,0,0,0,0,3
TACCTTAAGATTTCCC-1_V10B01-087_A1,5,0,0,0,0,5
AATGACAGCAATGTCT-1_V10B01-087_A1,3,0,1,0,1,5
TCAACGCAGGAAATAA-1_V10B01-087_A1,1,0,1,0,2,4
TATTCCTCCGCCCACT-1_V10B01-087_A1,2,1,1,0,7,11
ATCAAACGAAGGTTTG-1_V10B01-087_A1,0,2,1,0,1,4
TTGATTAGCTGTTTCT-1_V10B01-087_A1,1,0,0,0,3,4
CTGCTGAGGCCACGAA-1_V10B01-087_A1,1,0,1,0,0,2
CCGTGTTAAATTCCAT-1_V10B01-087_A1,1,4,0,0,0,5
CACGTCGGCAACCTCT-1_V10B01-087_A1,1,0,2,0,1,4
GTATTCTGAGAAACGA-1_V10B01-087_A1,2,1,0,0,2,5
CGGTGCGCGTTGGTCC-1_V10B01-087_A1,2,1,0,0,0,3
GTGATTCGCCGCTCAA-1_V10B01-087_A1,1,0,0,0,0,1
GCCCGCGCGTAAACGG-1_V10B01-087_A1,1,1,1,0,1,4
AACGTACTGTGGGTAC-1_V10B01-087_A1,1,0,1,0,1,3
GAGTATGCCCGCCTTG-1_V10B01-087_A1,1,0,1,0,1,3
TGATTCTGTCGCCGGT-1_V10B01-087_A1,1,1,1,0,0,3
GGGCGGCAAATGAATT-1_V10B01-087_A1,1,1,0,0,0,2
TTCCAATCTGGCTATC-1_V10B01-087_A1,2,3,0,0,0,5
GGAACCGTGTAAATTG-1_V10B01-087_A1,0,0,0,0,0,0
TTGGTCACACTCGTAA-1_V10B01-087_A1,1,0,0,0,0,1
CGAACCCGCATGCGTC-1_V10B01-087_A1,2,0,0,0,0,2
GGGCGTCACCACGTAA-1_V10B01-087_A1,1,0,0,0,1,2
TACCAGAAGTAGGTTC-1_V10B01-087_A1,0,3,1,0,0,4
TTGGATATCGTCTACG-1_V10B01-087_A1,3,0,0,0,0,3
TAGATATGGACTGGAA-1_V10B01-087_A1,1,0,1,0,0,2
GCGACGATAGTTGTAC-1_V10B01-087_A1,1,0,0,0,1,2
CTGGATTTACACTTGA-1_V10B01-087_A1,3,1,0,0,0,4
GTTATATTATCTCCCT-1_V10B01-087_A1,1,0,2,0,2,5
TATTCCACTCAGCTCG-1_V10B01-087_A1,1,0,1,0,1,3
CTGTTACCCAATCTAG-1_V10B01-087_A1,0,2,0,0,2,4
ACGCGAAGTCAGACGA-1_V10B01-087_A1,3,1,0,0,1,5
GATAGGTAACGTTGAC-1_V10B01-087_A1,2,1,1,0,1,5
TGTTCGTATTGCGGTG-1_V10B01-087_A1,1,0,0,0,3,4
GGTCAGTGGGTCCCAC-1_V10B01-087_A1,0,0,0,0,2,2
AATTCTAGAGTTAGGC-1_V10B01-087_A1,0,2,1,0,1,4
GTTTACGTTCCATCTG-1_V10B01-087_A1,0,1,0,0,2,3
AGACCCACCGCTGATC-1_V10B01-087_A1,1,1,2,0,0,4
TCTAGCATGCCCAGAA-1_V10B01-087_A1,1,0,0,0,1,2
CCCGCAGCGCGAACTA-1_V10B01-087_A1,0,1,0,0,0,1
CTCTATTTGGCTGCAG-1_V10B01-087_A1,0,0,1,0,1,2
TTCTGCCGCGCCTAGA-1_V10B01-087_A1,1,2,0,0,2,5
ACTCCCTAGAATAGTA-1_V10B01-087_A1,0,4,5,0,2,11
CCGAACCTTCCCGGCC-1_V10B01-087_A1,2,1,2,0,1,6
TCAGACGCTATAGAAG-1_V10B01-087_A1,1,0,1,0,1,3
CAGGCGCCATGCTAGG-1_V10B01-087_A1,1,2,1,0,0,4
CACTCGAGCTGAACAA-1_V10B01-087_A1,3,0,4,0,1,8
ACAAGGAAATCCGCCC-1_V10B01-087_A1,2,0,1,0,0,3
ACCACGTGCAGCTATA-1_V10B01-087_A1,0,0,0,0,0,0
ACGGCGACGATGGGAA-1_V10B01-087_A1,3,0,0,0,0,3
TTACTAAAGGACTTTA-1_V10B01-087_A1,1,2,0,0,0,3
GGCTGAAATAGCAAAG-1_V10B01-087_A1,1,0,3,0,1,5
TTAGACGAGTCACCTC-1_V10B01-087_A1,1,0,0,0,0,1
GTAGTCGCGGGAATCA-1_V10B01-087_A1,1,1,2,0,0,4
GCAAACCCTACATTAT-1_V10B01-087_A1,1,0,1,0,0,2
GTTAAAGTAGGACTGG-1_V10B01-087_A1,0,0,2,0,0,2
ACCCTCCCTTGCTATT-1_V10B01-087_A1,0,0,1,4,1,6
CATGTCTCATTTATGG-1_V10B01-087_A1,1,0,1,0,0,2
AATAGAATCTGTTTCA-1_V10B01-087_A1,1,2,1,0,0,4
TCTCATGAGATAGGGT-1_V10B01-087_A1,2,1,2,0,0,5
ATGACTATGCGACATT-1_V10B01-087_A1,1,0,0,1,0,2
CCTAACCCAAACAAGT-1_V10B01-087_A1,0,2,0,0,0,2
AGTCAAGATGACACTT-1_V10B01-087_A1,1,1,0,0,1,3
CGGGAGCTTCAGTGTA-1_V10B01-087_A1,1,1,1,0,0,3
CCACAGTACCCATCCT-1_V10B01-087_A1,1,0,1,0,1,3
GAGCGCGCACGAGTAG-1_V10B01-087_A1,0,2,0,1,0,3
ACCAGTGCGGGAGACG-1_V10B01-087_A1,1,1,2,0,2,6
TCCTTACGACGGTCCG-1_V10B01-087_A1,0,2,2,0,0,4
TAGTCGATCACGGGTT-1_V10B01-087_A1,1,0,3,1,0,5
AGACGAAGTGCCGGTC-1_V10B01-087_A1,1,1,1,1,0,4
CGCTGGTGACTACCCT-1_V10B01-087_A1,2,0,2,2,0,6
AGGCATTGTCGTAGGG-1_V10B01-087_A1,4,1,1,0,0,6
TGGTAGAATATATGGG-1_V10B01-087_A1,0,1,1,1,1,4
TTCTTATCCGCTGGGT-1_V10B01-087_A1,1,0,2,4,0,7
AGTTTGGCACGGGTTG-1_V10B01-087_A1,1,2,1,2,0,6
GCATCGGCCGTGTAGG-1_V10B01-087_A1,2,1,2,0,0,5
ATGCGAGTCCCACCAC-1_V10B01-087_A1,0,0,0,0,0,0
TCGGCGAACCCAAACC-1_V10B01-087_A1,3,1,0,0,0,4
AGAGTAAACTTCACTA-1_V10B01-087_A1,2,1,0,1,0,4
AAGCCGAAGCGGTTTA-1_V10B01-087_A1,0,1,1,1,0,3
CCCGAGTTTCTCCGTA-1_V10B01-087_A1,1,1,4,0,0,6
AATATCGAATCAATGC-1_V10B01-087_A1,0,1,3,0,0,4
GCGCCTCCCACTCCGA-1_V10B01-087_A1,1,2,2,0,0,5
CGTTAAACTAGTTAGG-1_V10B01-087_A1,1,5,1,0,0,7
TGAGTTAAAGACATTC-1_V10B01-087_A1,1,1,3,3,0,8
AACAGGTAGTATGGAT-1_V10B01-087_A1,1,0,2,3,0,6
GAACGCGGGTCACACG-1_V10B01-087_A1,0,4,2,1,0,7
TGTTTGAGATCGTCAG-1_V10B01-087_A1,1,0,0,5,0,6
ATCTCGTGAGCGAAAC-1_V10B01-087_A1,2,1,0,1,0,4
CTGAGAAAGTTCGGCG-1_V10B01-087_A1,1,3,1,0,0,5
ATTACCACACTGCCTG-1_V10B01-087_A1,1,1,3,2,0,7
CTGCTGTCTAACGAGC-1_V10B01-087_A1,1,2,2,0,0,5
CGTGGAAGCCTCGTAC-1_V10B01-087_A1,0,1,1,0,0,2
GGACTCACAAATTAGG-1_V10B01-087_A1,0,0,1,0,0,1
CTTTGCTGTCATGGAT-1_V10B01-087_A1,0,0,1,0,0,1
GGTGTTGGGCGTCTTA-1_V10B01-087_A1,1,1,0,0,0,2
TTAGAGGGATATACAG-1_V10B01-087_A1,1,0,0,0,0,1
TTGTACACCTCGAACA-1_V10B01-087_A1,1,0,1,0,0,2
GTGGGTACTGAGCGTA-1_V10B01-087_A1,2,0,0,0,1,3
CTTAAGCAGCGAGCCG-1_V10B01-087_A1,1,0,1,0,1,3
GCATTGACTTGCGGAA-1_V10B01-087_A1,4,1,0,0,0,5
CCATAACCTGTGCAGT-1_V10B01-087_A1,1,1,1,0,1,4
GGGCTACTATTTCGTG-1_V10B01-087_A1,4,0,0,0,0,4
GGCGAGCGAAACGGCA-1_V10B01-087_A1,3,0,0,0,1,4
GGAGACCATCTACATA-1_V10B01-087_A1,1,0,0,0,0,1
AGACCAAACCACACCT-1_V10B01-087_A1,2,1,0,0,0,3
CGACGCATCCGTACCT-1_V10B01-087_A1,1,1,0,0,1,3
CCTAGGTAAAGGTAGC-1_V10B01-087_A1,1,0,0,0,1,2
AGCGGCGGTTAGCGGT-1_V10B01-087_A1,0,0,0,0,0,0
CTGGACGCAGTCCGGC-1_V10B01-087_A1,1,1,0,0,0,2
AGCCTAATACCCACGT-1_V10B01-087_A1,2,0,0,0,1,3
AATCTGGCTTTCTAGT-1_V10B01-087_A1,0,0,0,0,0,0
CACCCTTGGTGAGACC-1_V10B01-087_A1,3,1,1,0,0,5
GGATCTTGACTCAACC-1_V10B01-087_A1,1,1,0,0,0,2
ACGAGGATACCACTCT-1_V10B01-087_A1,1,1,0,0,2,4
GAGTTGATGGCAATTT-1_V10B01-087_A1,2,0,1,0,0,3
GTGGCAAACAGCGGCA-1_V10B01-087_A1,2,0,1,0,1,4
GATGTAACGAACCACC-1_V10B01-087_A1,3,0,1,0,0,4
AGCCGTGGCTAAATGT-1_V10B01-087_A1,0,1,1,0,0,2
CTCCCTCCTTTCGATC-1_V10B01-087_A1,2,1,2,0,3,8
TTGGAAGAATACAGTC-1_V10B01-087_A1,2,4,0,0,0,6
AGTTAAGTCAACCGCT-1_V10B01-087_A1,2,0,0,0,1,3
CTCATGGTAATTTGCG-1_V10B01-087_A1,0,0,2,0,3,5
AAAGTAGCATTGCTCA-1_V10B01-087_A1,1,0,2,0,0,3
TTGTGGTAGGAGGGAT-1_V10B01-087_A1,1,0,2,0,3,6
AGTCGTGGGCATTACG-1_V10B01-087_A1,3,1,0,0,0,4
ACCTAAGTACCTTTCA-1_V10B01-087_A1,3,1,1,0,0,5
GTAGAGGGAGACAAGT-1_V10B01-087_A1,4,0,2,0,1,7
GATCCTCGACACTGGC-1_V10B01-087_A1,3,0,1,0,2,6
CCTACATTCACAGACG-1_V10B01-087_A1,0,2,0,0,0,2
TTGACCGTGTTAATGA-1_V10B01-087_A1,2,0,0,0,0,2
TCTGTTACCCAGCATA-1_V10B01-087_A1,3,2,0,0,2,7
CTAACTGGTCCGGTTC-1_V10B01-087_A1,0,0,1,0,3,4
AGCGACAGGAACGGTC-1_V10B01-087_A1,2,0,2,0,1,5
TAATAGAACAGAGTTA-1_V10B01-087_A1,1,0,1,0,3,5
ACAGGTGGAGGTGAGG-1_V10B01-087_A1,0,0,0,0,1,1
TGCGAGAATATTACCC-1_V10B01-087_A1,0,1,1,0,1,3
TTGCGTCGGCCAACCG-1_V10B01-087_A1,1,1,0,0,0,2
AGGCTTCCCGAAGAAG-1_V10B01-087_A1,2,0,3,0,0,5
GCGGACCGCGTTGTGG-1_V10B01-087_A1,3,0,0,0,0,3
GTAATCTGATTCTTCG-1_V10B01-087_A1,1,0,1,0,0,2
CCGCGGAATGCGTCAC-1_V10B01-087_A1,1,0,1,0,1,3
TTCCACACAGATTTGA-1_V10B01-087_A1,2,0,0,0,1,3
CTTCTATTAATGCTAG-1_V10B01-087_A1,1,0,0,0,1,2
CATTTGAGTGGTACGT-1_V10B01-087_A1,3,0,1,0,0,4
TCACAGCAAACTCGAA-1_V10B01-087_A1,3,0,2,0,1,6
CAGACGAACCTGATAC-1_V10B01-087_A1,2,0,0,0,0,2
TAGCTAGAAGGCATGA-1_V10B01-087_A1,4,0,0,0,0,4
ATCCAGAGCAACAACC-1_V10B01-087_A1,3,0,1,0,0,4
TCCGGTTCGTCCGGTC-1_V10B01-087_A1,1,0,0,0,1,2
CGCGCATGTTTGATTG-1_V10B01-087_A1,1,1,3,0,1,6
TGGCGATCAAGTTATG-1_V10B01-087_A1,1,1,0,0,0,2
CCCTTTGACAGGTCTT-1_V10B01-087_A1,1,1,1,0,2,5
CAGAGACGGTCACCCA-1_V10B01-087_A1,0,1,1,0,0,2
TAGCTCGCCTGATAAC-1_V10B01-087_A1,0,0,2,0,1,3
TTGTGTTTCCCGAAAG-1_V10B01-087_A1,2,0,1,0,0,3
TATACACAGACGCCTT-1_V10B01-087_A1,1,0,0,0,2,3
ACATTAGTTTATATCC-1_V10B01-087_A1,1,0,0,0,0,1
CCATCGCAGTTAAACT-1_V10B01-087_A1,2,1,0,0,0,3
AATTAGCGCTGCAGCG-1_V10B01-087_A1,3,0,0,0,1,4
TCCGCTTATCCCATTA-1_V10B01-087_A1,1,0,0,0,3,4
GTTTGGGCTTGTGAGC-1_V10B01-087_A1,1,4,0,0,0,5
CTTGTCAACATTCGAG-1_V10B01-087_A1,1,0,0,0,0,1
GGACCAACAGGATAAC-1_V10B01-087_A1,4,0,0,0,0,4
AAGCTAGATCGAGTAA-1_V10B01-087_A1,1,2,0,0,1,4
TACCGTGCCTCGGACC-1_V10B01-087_A1,1,1,0,0,1,3
GTAGCCAAACATGGGA-1_V10B01-087_A1,0,0,0,0,0,0
TGCCAGTACGTGGAGA-1_V10B01-087_A1,1,2,1,0,0,4
ATAAGGTGGAGAACAT-1_V10B01-087_A1,3,0,0,0,0,3
CTTTAATATTGGTCGA-1_V10B01-087_A1,0,1,3,0,1,5
TGGTTCAACGGGTAAT-1_V10B01-087_A1,0,0,0,0,1,1
GCTGCTACTGCGTAGC-1_V10B01-087_A1,3,0,1,0,0,4
CTGCACAACTACATAT-1_V10B01-087_A1,0,0,0,3,0,3
ATATTCCACATAGTGA-1_V10B01-087_A1,5,1,1,0,0,7
TGGCAAACTAAATTAC-1_V10B01-087_A1,5,0,1,0,0,6
ACCGCAATAACTGCCT-1_V10B01-087_A1,2,0,0,0,0,2
TCGCACCAGGAGGCAG-1_V10B01-087_A1,0,1,0,0,0,1
ACTTCAGGCTGATCCC-1_V10B01-087_A1,0,1,1,0,1,3
ACAAATCGCACCGAAT-1_V10B01-087_A1,0,1,0,0,0,1
TCTGATGTATTCTGTC-1_V10B01-087_A1,1,1,0,0,0,2
CTTTACCGAATAGTAG-1_V10B01-087_A1,1,0,2,0,0,3
GCAGATCCATAAGACT-1_V10B01-087_A1,5,0,1,0,0,6
TTCCTCGGACTAACCA-1_V10B01-087_A1,1,0,1,0,0,2
TTATCCGGGATCTATA-1_V10B01-087_A1,3,0,0,0,0,3
CTGGAAGACACGGTGG-1_V10B01-087_A1,3,1,1,0,0,5
GTTCGTCTAAAGAACT-1_V10B01-087_A1,1,0,0,0,0,1
GTCTATTGGTTCCGGT-1_V10B01-087_A1,0,0,1,0,0,1
CTAGGCGCCCTATCAG-1_V10B01-087_A1,5,0,0,0,0,5
AACGGACGTACGTATA-1_V10B01-087_A1,1,0,1,1,0,3
AACACACGCTCGCCGC-1_V10B01-087_A1,3,0,3,0,0,6
GCTACTATAGTAGAGT-1_V10B01-087_A1,3,0,0,0,1,4
AGCATATCAATATGCT-1_V10B01-087_A1,2,0,3,0,0,5
CGAACAGTATGGGCGT-1_V10B01-087_A1,3,0,1,0,0,4
ACAATTGTGTCTCTTT-1_V10B01-087_A1,1,1,1,0,0,3
GATCGCTACCCGATTT-1_V10B01-087_A1,2,0,1,0,0,3
ATTGCGATCAGTAACT-1_V10B01-087_A1,0,0,1,2,0,3
CAGCAGTCCAGACTAT-1_V10B01-087_A1,0,1,0,0,0,1
AGAGGCTTCGGAAACC-1_V10B01-087_A1,0,0,1,3,0,4
AAACAAGTATCTCCCA-1_V10B01-087_A1,0,0,0,2,0,2
GGCAGCAAACCTATGC-1_V10B01-087_A1,3,0,0,0,0,3
ACTAGTTGCGATCGTC-1_V10B01-087_A1,0,0,2,2,0,4
TTGGACCATCTGGCAA-1_V10B01-087_A1,2,0,1,1,0,4
CCCTCCTCGCTCGTAT-1_V10B01-087_A1,0,1,3,0,1,5
GAGCGCAAATACTCCG-1_V10B01-087_A1,2,1,0,1,0,4
ATTACATGTCAGTCTT-1_V10B01-087_A1,0,2,2,2,0,6
TTGGGACGTAAGAGTT-1_V10B01-087_A1,0,1,0,0,0,1
CTTCGGCCAATTGTTT-1_V10B01-087_A1,3,1,0,1,0,5
AGACCGCTCCGCGGTT-1_V10B01-087_A1,2,0,1,0,0,3
GACCGCGTCTGACGTG-1_V10B01-087_A1,1,1,3,0,0,5
CCAAATAACAAGATTC-1_V10B01-087_A1,1,3,0,0,0,4
TCTTTAGAGTCTAACA-1_V10B01-087_A1,2,0,5,3,0,10
CTCCCAATGAGTCGCG-1_V10B01-087_A1,2,1,2,0,0,5
TAGTCTTTCCGAATTG-1_V10B01-087_A1,1,0,3,0,0,4
GAGTAAACCGGAAAGT-1_V10B01-087_A1,5,0,0,0,0,5
GATCTCGACGCTGTGG-1_V10B01-087_A1,0,0,1,0,0,1
CTGACATAGAAATAGA-1_V10B01-087_A1,1,3,0,0,0,4
TATACCGAGTGCCACA-1_V10B01-087_A1,2,0,1,3,0,6
TCCGAACGTTGCCGCT-1_V10B01-087_A1,2,1,0,1,0,4
GCAGAAGGTAATCTCC-1_V10B01-087_A1,1,2,0,1,0,4
GGTACTAAGTGCTTTG-1_V10B01-087_A1,2,4,1,0,0,7
CAGAATATTCGTTATC-1_V10B01-087_A1,1,1,4,1,0,7
TAATCAACCAAATGGG-1_V10B01-087_A1,1,2,2,0,0,5
AACTGAGTTATACTGA-1_V10B01-087_A1,3,0,0,0,0,3
CCTCAACGATCGCTGT-1_V10B01-087_A1,1,0,0,0,0,1
CGGTACGGCAAACCCA-1_V10B01-087_A1,2,0,1,0,0,3
CAGATGTTTGTCCCAA-1_V10B01-087_A1,2,0,0,0,1,3
GTTTGTTAGCCAAGTA-1_V10B01-087_A1,3,0,0,0,0,3
ACGTGACAAAGTAAGT-1_V10B01-087_A1,0,0,0,0,0,0
TTGTCACCGCGGTATC-1_V10B01-087_A1,1,0,0,0,1,2
GATCTAACCGTATTCA-1_V10B01-087_A1,3,0,0,0,0,3
ATGGAAATTTAAGGAG-1_V10B01-087_A1,2,3,0,0,0,5
ATTGATCACCACATTT-1_V10B01-087_A1,3,1,0,0,0,4
ACTGCTCGGAAGGATG-1_V10B01-087_A1,0,0,0,0,0,0
TCTAAAGAACAGTCTC-1_V10B01-087_A1,1,0,0,0,0,1
CTGGGTTGAGTTAAAG-1_V10B01-087_A1,4,0,0,0,0,4
CCCAGTAAACTTGGGA-1_V10B01-087_A1,1,1,0,0,1,3
AGATTCACAACCGATA-1_V10B01-087_A1,0,0,1,0,1,2
AGAAGGTACACTTCAC-1_V10B01-087_A1,1,0,0,0,1,2
GCAGGAACTTAGATCT-1_V10B01-087_A1,1,0,0,0,0,1
AATCTAGGTTTACTTG-1_V10B01-087_A1,0,0,1,0,0,1
CCCGGTGTATCGGAAT-1_V10B01-087_A1,0,0,0,0,0,0
TTATCCTCAAGGAATA-1_V10B01-087_A1,1,0,0,0,1,2
AGCATCATTTCGAAAG-1_V10B01-087_A1,1,0,1,0,2,4
CGCGAGTCTGCCGGGT-1_V10B01-087_A1,2,0,0,0,2,4
TGCGTCATGACTGAGC-1_V10B01-087_A1,2,1,3,0,1,7
GTATGAAATTTCACTC-1_V10B01-087_A1,2,1,0,0,0,3
TTGGTTGCGGTGCGCG-1_V10B01-087_A1,2,1,0,0,1,4
ACAGAACTGAGAACAA-1_V10B01-087_A1,0,2,1,1,1,5
CTACTATCATAGGTTT-1_V10B01-087_A1,1,0,0,0,1,2
CCTCTATCGATTAGCA-1_V10B01-087_A1,3,2,0,0,0,5
CCGTATCTCGTCGTAG-1_V10B01-087_A1,0,0,2,0,0,2
TCACGATGTCCGTGGA-1_V10B01-087_A1,4,1,1,0,0,6
TCAACAAAGATAATTC-1_V10B01-087_A1,0,1,2,0,0,3
ATGACGCGTTCTATCC-1_V10B01-087_A1,4,0,0,0,1,5
ATTTGCGCGAGTAGCT-1_V10B01-087_A1,3,0,3,0,2,8
TTCTTGGACGATCTGC-1_V10B01-087_A1,3,0,1,0,0,4
AGACGACGATGCCGCT-1_V10B01-087_A1,0,0,0,0,0,0
GGTCTCTGAATGGACT-1_V10B01-087_A1,6,0,1,0,1,8
GCTCAATCCGTTTATT-1_V10B01-087_A1,2,2,0,0,0,4
CCAGAAAGCAACTCAT-1_V10B01-087_A1,1,0,0,0,1,2
CACCGTTAGGGATCAC-1_V10B01-087_A1,2,0,0,0,0,2
AATAACACTAGAACAA-1_V10B01-087_A1,1,0,0,0,0,1
CACCCGGTTTGTGACT-1_V10B01-087_A1,0,0,0,0,3,3
CCACCAACTTTACTGT-1_V10B01-087_A1,5,0,3,0,1,9
AACTCTCAGTGTGCTC-1_V10B01-087_A1,3,0,1,0,1,5
AAACCGTTCGTCCAGG-1_V10B01-087_A1,2,0,0,0,0,2
CAGCGATTCCCTTCAA-1_V10B01-087_A1,1,0,0,0,3,4
GCTAGCTTGAATAGCT-1_V10B01-087_A1,2,0,0,0,0,2
TTGCGGCATCAGAAAG-1_V10B01-087_A1,2,2,0,0,1,5
AATAGAACAGAGTGGC-1_V10B01-087_A1,2,1,0,0,1,4
GCCATCGAGCTGCGTG-1_V10B01-087_A1,2,1,0,0,0,3
ACACTGATCAAGGTGT-1_V10B01-087_A1,3,0,2,0,0,5
ACCAACGCTTATTTAT-1_V10B01-087_A1,0,0,0,0,0,0
GACATCGATTTATAAC-1_V10B01-087_A1,4,1,0,0,2,7
CAGACACCGATCGCTG-1_V10B01-087_A1,4,1,0,0,0,5
CCAAGAAAGTGGGCGA-1_V10B01-087_A1,3,3,2,0,0,8
GGTAGACCGTTGGGCG-1_V10B01-087_A1,1,0,2,0,0,3
TCGTTAGGAGTCCCTA-1_V10B01-087_A1,2,0,1,0,1,4
ACGGCCAACATGGACT-1_V10B01-087_A1,3,0,2,0,1,6
GTGAGTGGTACAACGC-1_V10B01-087_A1,2,0,3,0,0,5
GAGACTTCGCGACCGA-1_V10B01-087_A1,1,0,0,0,0,1
GAAGTCAGTTGCACTA-1_V10B01-087_A1,3,1,1,0,0,5
GTTTGGTAGGGTCAAC-1_V10B01-087_A1,0,0,2,0,2,4
ACGGCACTTGCTTGGG-1_V10B01-087_A1,3,0,2,0,1,6
CCTCTGTACTATTCTA-1_V10B01-087_A1,0,0,0,0,1,1
CTATTCATGTGTCCCA-1_V10B01-087_A1,4,0,0,0,1,5
GCCCGATCTGTGGTCG-1_V10B01-087_A1,0,0,0,0,1,1
TTAGAAGAACATGACT-1_V10B01-087_A1,2,1,0,0,1,4
AGGATAAAGTCGGGAT-1_V10B01-087_A1,0,0,0,0,0,0
CGGCAAACATCGTGCG-1_V10B01-087_A1,0,1,0,0,0,1
CTAGTTACAACCCGGT-1_V10B01-087_A1,2,1,1,0,1,5
TTCGACAGAGCCCGTG-1_V10B01-087_A1,0,0,0,0,0,0
AAGCATACTCTCCTGA-1_V10B01-087_A1,3,1,0,0,1,5
GACGACGATCCGCGTT-1_V10B01-087_A1,0,0,1,0,0,1
GGTAGAAGACCGCCTG-1_V10B01-087_A1,1,1,1,0,1,4
GAGATGGGAGTCGACA-1_V10B01-087_A1,0,0,1,0,0,1
AACGATAATGCCGTAG-1_V10B01-087_A1,0,0,2,0,1,3
TGGTCCCACGCTACGG-1_V10B01-087_A1,0,0,0,0,0,0
CTGCTTGGCGATAGCT-1_V10B01-087_A1,1,0,2,0,1,4
ATCGGAGACAGACGGC-1_V10B01-087_A1,3,0,0,0,1,4
TAGCGTCCGGTGTGGT-1_V10B01-087_A1,2,0,0,0,2,4
GTTGAGTCCCGCCGGT-1_V10B01-087_A1,1,1,0,0,0,2
AAATAGGGTGCTATTG-1_V10B01-087_A1,1,0,0,0,0,1
AAGTGTTTGGAGACGG-1_V10B01-087_A1,3,0,0,0,1,4
AGCACTACCTCACCAG-1_V10B01-087_A1,2,0,2,0,0,4
TGCCTTGGCCAGGCAA-1_V10B01-087_A1,0,0,2,0,0,2
TCGTCTTAGGCGTTAA-1_V10B01-087_A1,0,0,1,0,0,1
TTCTGACCGGGCTCAA-1_V10B01-087_A1,0,0,0,0,0,0
CAGAACTTAGCCCTCT-1_V10B01-087_A1,1,0,0,0,1,2
AGCTCCTTCGCACATC-1_V10B01-087_A1,2,2,2,1,0,7
ACAGGCTTGCCCGACT-1_V10B01-087_A1,1,0,1,0,0,2
GCTATACGTCTCGGAC-1_V10B01-087_A1,1,0,1,0,1,3
GAGCCAGCTACCTGTG-1_V10B01-087_A1,3,0,2,0,0,5
TGCTAAGTGTCTATTT-1_V10B01-087_A1,2,2,1,0,0,5
GTCCTACGAATAGTCT-1_V10B01-087_A1,1,1,1,0,0,3
CAGTGTCGGCTGGCCC-1_V10B01-087_A1,0,0,1,0,0,1
CTATCGACGAAATACA-1_V10B01-087_A1,1,0,1,1,0,3
CATCATTACCCTGAGG-1_V10B01-087_A1,1,2,0,0,0,3
TAAGTTGCGACGTAGG-1_V10B01-087_A1,0,0,2,3,0,5
AGTGCACGCTTAAGAA-1_V10B01-087_A1,1,1,3,2,0,7
TGTGCCGGTGCCGGAA-1_V10B01-087_A1,1,0,0,0,0,1
AGGAGGCCTTCGCGCG-1_V10B01-087_A1,0,0,2,2,0,4
TCCGCGGCCCAATGAA-1_V10B01-087_A1,3,1,2,0,0,6
TCCGTTAAGCTAATAT-1_V10B01-087_A1,1,2,2,0,0,5
AAATCTAGCCCTGCTA-1_V10B01-087_A1,1,1,1,2,1,6
CGCAGGCGATCCAAAC-1_V10B01-087_A1,6,6,0,1,0,13
CCATATGGAAACTATA-1_V10B01-087_A1,0,1,2,2,0,5
CACCGTATCCCATCCG-1_V10B01-087_A1,1,0,2,1,0,4
GGTCAAGACTACTTCG-1_V10B01-087_A1,0,0,5,1,1,7
CCCGTTTCGCAGATGT-1_V10B01-087_A1,0,1,2,0,0,3
GTTATAATACGGTGAA-1_V10B01-087_A1,2,1,0,0,0,3
ACTTGTGGATGGAACG-1_V10B01-087_A1,0,5,1,0,1,7
GTTCGCTGAGACGTCT-1_V10B01-087_A1,0,1,1,0,0,2
GACACTGGAACCCGAT-1_V10B01-087_A1,2,1,8,0,0,11
CCCAGGTCTGAAGGCT-1_V10B01-087_A1,1,1,4,0,0,6
TCTCGAGGAGGTTCGC-1_V10B01-087_A1,0,0,2,1,0,3
ACTATCTGCCCGCGTA-1_V10B01-087_A1,1,0,3,1,0,5
CCTAAATTGTATCCTA-1_V10B01-087_A1,1,1,0,0,0,2
AGAAATTATGACTCGC-1_V10B01-087_A1,0,2,2,0,0,4
TCCAGCGCTATAAGCG-1_V10B01-087_A1,2,2,0,0,0,4
TCGTGTATTGGTCACG-1_V10B01-087_A1,5,1,1,0,0,7
CCACATACTGCACCCA-1_V10B01-087_A1,0,1,7,0,0,8
GTTGCGGACGGTCAGG-1_V10B01-087_A1,0,4,4,0,0,8
GTATTTAATGGCATAA-1_V10B01-087_A1,2,0,0,0,0,2
GTCGATAGGTGACTTT-1_V10B01-087_A1,2,1,2,1,0,6
AATAATCTTCGTATCG-1_V10B01-087_A1,0,3,5,0,0,8
ATTGTTCAACGATCCG-1_V10B01-087_A1,2,0,2,2,0,6
GTGCAGCGTAGAGTAG-1_V10B01-087_A1,1,0,5,0,0,6
TGTGGTAGGGTGCCTT-1_V10B01-087_A1,0,3,3,0,0,6
TGTGGACTATCTACGT-1_V10B01-087_A1,1,0,1,0,0,2
GGCGGGCTCTAAGAGT-1_V10B01-087_A1,1,3,2,0,0,6
TGTGCCAGAGGCAAAG-1_V10B01-087_A1,2,0,0,0,0,2
TGGCTTATGTATAATG-1_V10B01-087_A1,2,0,0,0,0,2
GCAAGCTGGAAACCGC-1_V10B01-087_A1,3,0,0,0,0,3
GATATCAAGCAGGAGC-1_V10B01-087_A1,2,0,0,0,0,2
CACCAATCATCCGTCT-1_V10B01-087_A1,0,0,0,0,0,0
CCACATGGCTCTTTAT-1_V10B01-087_A1,2,0,0,0,0,2
GTCCTACTCTACGGGC-1_V10B01-087_A1,1,0,0,0,2,3
CTCGAGACATACGATA-1_V10B01-087_A1,1,0,0,0,0,1
TATCAGTGGCGTAGTC-1_V10B01-087_A1,2,0,1,0,0,3
TGACAGGACAAGTCCA-1_V10B01-087_A1,0,2,0,0,0,2
TATTAACACCAAAGCA-1_V10B01-087_A1,2,0,1,0,1,4
TAGGCGATGAGGTCTC-1_V10B01-087_A1,2,0,0,0,0,2
CCGCCGGAACTTCTCG-1_V10B01-087_A1,0,0,0,0,0,0
GCCATTAGCCTCAAAC-1_V10B01-087_A1,0,0,0,0,1,1
GTTAGGCTACCCGTTT-1_V10B01-087_A1,1,1,0,0,0,2
GGGTATTCTAGCAAAC-1_V10B01-087_A1,0,2,0,0,0,2
GCCCTAGCCGTCGCGA-1_V10B01-087_A1,2,0,0,0,0,2
CAGATCCTGGTTTGAA-1_V10B01-087_A1,3,0,0,0,2,5
CTTCAGTGGTCGCCTA-1_V10B01-087_A1,0,0,0,0,1,1
GGGCAACCGCACGTGC-1_V10B01-087_A1,0,1,0,0,0,1
GACCCAATTATGATAC-1_V10B01-087_A1,3,0,0,0,0,3
GAAGCTCGGACCCGTC-1_V10B01-087_A1,0,1,0,0,1,2
CGTCGGGTCTAAGCGC-1_V10B01-087_A1,2,0,0,0,0,2
GAGGCCCGACTCCGCA-1_V10B01-087_A1,0,0,0,0,0,0
TTGCCATAGCCCGCTC-1_V10B01-087_A1,2,0,1,0,2,5
TAACATACACGCGATC-1_V10B01-087_A1,1,4,1,0,0,6
CCGACGGGCATGAGGT-1_V10B01-087_A1,1,0,0,0,0,1
AATGTGCCCGAGGTGT-1_V10B01-087_A1,1,1,0,0,0,2
AGCTGTAACCTCAATC-1_V10B01-087_A1,2,0,0,0,1,3
CGAGTGAAGGTACCAG-1_V10B01-087_A1,0,1,1,0,0,2
AGTCTCACAAGACTAC-1_V10B01-087_A1,3,0,1,0,0,4
AAATTGATAGTCCTTT-1_V10B01-087_A1,5,1,0,0,2,8
TAAGTCGCCGAGTATC-1_V10B01-087_A1,4,0,2,0,0,6
GCGGAGAAACTTCGCA-1_V10B01-087_A1,3,0,2,0,0,5
GGCAAAGGCGCCAATA-1_V10B01-087_A1,1,1,1,0,0,3
ATTTCCGGGTTCTGCG-1_V10B01-087_A1,0,0,1,0,0,1
TAAACCCAGGAGGGCA-1_V10B01-087_A1,1,1,0,0,0,2
TTCGGGCGCTAGTCTT-1_V10B01-087_A1,2,0,0,0,0,2
GTGGAGTCGGCGGTTG-1_V10B01-087_A1,2,0,1,0,2,5
GCACGCCTACTTAGAT-1_V10B01-087_A1,1,0,0,0,1,2
CAATATTCTTGACCTA-1_V10B01-087_A1,2,0,0,0,0,2
CGTTTGTGTAGAGGGT-1_V10B01-087_A1,3,0,0,0,0,3
CATAGCGTTGCCCACC-1_V10B01-087_A1,1,0,0,0,1,2
TGATACATTTAGCCGT-1_V10B01-087_A1,3,0,0,0,2,5
TTCCGGCCTTGAGGCT-1_V10B01-087_A1,1,0,1,0,0,2
CCTATACCGTCCTGTC-1_V10B01-087_A1,2,0,0,0,1,3
TCGTTGCTATCCGGTC-1_V10B01-087_A1,2,0,0,0,1,3
TGGCGACTGCTCCAAA-1_V10B01-087_A1,4,1,0,0,1,6
CAGAGGCGATGCATGA-1_V10B01-087_A1,0,1,0,0,2,3
TCACAGGAGAATAAGA-1_V10B01-087_A1,2,1,0,0,1,4
GGGTTAACATTTGAGT-1_V10B01-087_A1,1,2,2,0,0,5
GCGGGCGAGCCTTACC-1_V10B01-087_A1,0,0,1,0,2,3
TGCCAATGGGTACTCT-1_V10B01-087_A1,2,0,0,0,1,3
AGGGACTCTACGCGAC-1_V10B01-087_A1,3,1,1,0,2,7
GACGCCGTAAAGGCTA-1_V10B01-087_A1,1,0,0,0,0,1
AAAGGCTCTCGCGCCG-1_V10B01-087_A1,1,2,1,0,0,4
CTGGCTGGTTGTCAGT-1_V10B01-087_A1,0,0,0,0,2,2
ACATCCCGGCCATACG-1_V10B01-087_A1,3,1,0,0,3,7
CTCTTGTCCCGCTTGG-1_V10B01-087_A1,4,0,2,0,0,6
TACGCCTCCATTCCGA-1_V10B01-087_A1,2,1,4,0,0,7
CGGAGCAATTTAATCG-1_V10B01-087_A1,2,0,1,0,3,6
AACTAGGCTTGGGTGT-1_V10B01-087_A1,3,0,1,0,0,4
GCGTCGCCAGGGTGAT-1_V10B01-087_A1,0,0,0,0,1,1
GTTGGTCATGCTATCC-1_V10B01-087_A1,3,0,0,0,0,3
GCTGGCGGCGCATGCT-1_V10B01-087_A1,0,0,0,0,0,0
TGAGCGGAAAGTGTTC-1_V10B01-087_A1,1,2,1,0,1,5
CTTTCTGTGCGGGCTT-1_V10B01-087_A1,3,0,1,0,0,4
ATCTAATATCCTACGG-1_V10B01-087_A1,0,1,1,0,2,4
AACCTTTAAATACGGT-1_V10B01-087_A1,2,0,0,0,0,2
TTCACTCGAGCACCTA-1_V10B01-087_A1,1,0,1,0,0,2
CTGCACTCCAGTACAG-1_V10B01-087_A1,1,1,2,0,1,5
CCATTTCTACCTATTA-1_V10B01-087_A1,1,2,1,0,1,5
CAAGCGGCACATAATT-1_V10B01-087_A1,2,1,0,0,1,4
GTTAACATCACTTAAA-1_V10B01-087_A1,1,0,0,0,0,1
ATATAAATGTAGCTGC-1_V10B01-087_A1,1,2,0,0,0,3
GCCTCTATACATAGCA-1_V10B01-087_A1,4,1,0,1,0,6
GTGTCGTATAGCGTTC-1_V10B01-087_A1,0,1,0,0,0,1
ATACGTACTTAGCCAC-1_V10B01-087_A1,1,1,0,0,0,2
GCTATCATACTCATGG-1_V10B01-087_A1,3,1,1,0,2,7
TATCCAATTGGTTATC-1_V10B01-087_A1,3,6,0,0,0,9
TCTCCCTGGGCAGCGT-1_V10B01-087_A1,0,0,0,0,1,1
CCTATAATGAGTGCCC-1_V10B01-087_A1,1,1,0,0,0,2
CAATGCGAGAAGTATC-1_V10B01-087_A1,1,0,0,0,1,2
TACCAATAAAGTACCA-1_V10B01-087_A1,1,3,0,0,1,5
GCTAGGCACCACGGAG-1_V10B01-087_A1,1,1,0,0,0,2
GGTGGACTGCTCTGGC-1_V10B01-087_A1,0,1,0,0,2,3
TATTCCGAGCTGTTAT-1_V10B01-087_A1,0,2,2,0,0,4
TTGAGAAGTTTAGCAT-1_V10B01-087_A1,0,0,0,0,0,0
GTCCGGACCTGAAATT-1_V10B01-087_A1,3,1,2,0,1,7
CTGTGGTCGGGAGATA-1_V10B01-087_A1,1,5,3,0,0,9
CATGTAAGAGACATTT-1_V10B01-087_A1,2,1,0,0,0,3
CACGTTTCGTACACAC-1_V10B01-087_A1,1,0,2,0,1,4
CATCCTCTCAAAGATC-1_V10B01-087_A1,1,0,0,0,0,1
GATTAACCGAAAGCCC-1_V10B01-087_A1,3,0,1,0,0,4
AACGCTGTTGCTGAAA-1_V10B01-087_A1,1,0,0,0,0,1
TTCAGCTGGCGTGCCC-1_V10B01-087_A1,4,1,0,0,1,6
TAGAGGTTCTACTTGT-1_V10B01-087_A1,0,0,1,3,1,5
GTATCAAACGTTAGCT-1_V10B01-087_A1,1,1,0,2,0,4
AATCATGTAAAGACTC-1_V10B01-087_A1,1,1,0,2,0,4
AGTCACTAGCTCTCGA-1_V10B01-087_A1,0,1,0,1,0,2
GCGAAACGATCGGGAG-1_V10B01-087_A1,2,1,2,0,0,5
CATGGATTGTCTTCCG-1_V10B01-087_A1,0,0,2,0,1,3
ATTGGATTACAGCGTA-1_V10B01-087_A1,1,1,0,1,0,3
CACACACGCTAACGAG-1_V10B01-087_A1,0,1,1,1,0,3
CTATGGGAAGCGGAAT-1_V10B01-087_A1,0,1,0,1,1,3
TGCCTAATTGAAGATT-1_V10B01-087_A1,1,0,0,2,0,3
TGGCAATGGGACGGCG-1_V10B01-087_A1,0,2,1,0,0,3
ACCTCCGCCCTCGCTG-1_V10B01-087_A1,4,1,0,0,0,5
CGGCAATAAGATCGCC-1_V10B01-087_A1,0,1,4,0,0,5
CCTTGACCACTTTATT-1_V10B01-087_A1,0,1,2,3,0,6
TCATTTAGAAGTGTGA-1_V10B01-087_A1,3,1,1,0,0,5
CAGAATAACACACGGA-1_V10B01-087_A1,0,0,2,0,0,2
TCTGAGCAATTGACTG-1_V10B01-087_A1,0,1,0,2,0,3
CAACGTGGTGGAGTCT-1_V10B01-087_A1,2,0,0,0,0,2
CACAGTTCGCTTCCCA-1_V10B01-087_A1,1,2,3,0,0,6
TCTCTCGCCGCACATA-1_V10B01-087_A1,2,1,2,0,0,5
TGGGCAGGCCACCGCA-1_V10B01-087_A1,0,2,2,0,0,4
CTCCTGTTCAAGGCAG-1_V10B01-087_A1,0,1,3,0,0,4
TATTTGATTTGCACAG-1_V10B01-087_A1,0,1,0,0,0,1
GCCACTCCTTACGGTA-1_V10B01-087_A1,0,2,4,1,0,7
ACCGATATTTAATCAT-1_V10B01-087_A1,1,0,2,2,0,5
TTATTATCTGGAAGGC-1_V10B01-087_A1,1,2,1,0,0,4
TACATGCCGGAATTGT-1_V10B01-087_A1,5,2,0,0,0,7
GGCACTCAGCCGACCC-1_V10B01-087_A1,3,3,3,1,0,10
AAACCGGAAATGTTAA-1_V10B01-087_A1,2,1,1,0,0,4
AGACAGGCATCTCAGC-1_V10B01-087_A1,3,1,1,0,0,5
GTGGTGATGGTTTGTG-1_V10B01-087_A1,1,2,0,2,0,5
CCGATATGACGTAAGG-1_V10B01-087_A1,2,3,0,0,0,5
CATACACAAAGTCAGC-1_V10B01-087_A1,0,0,0,0,0,0
TGCCGTTCTTAATCGG-1_V10B01-087_A1,4,0,0,0,0,4
TCGAGTCTACGATTCG-1_V10B01-087_A1,2,0,0,0,0,2
ACTTCCAGTGGAAGCT-1_V10B01-087_A1,3,0,0,0,0,3
CAATTGGGCCGCACTC-1_V10B01-087_A1,2,0,0,0,0,2
AAATCGCGGAAGGAGT-1_V10B01-087_A1,4,1,0,0,0,5
ATATCAATTCCAGCCT-1_V10B01-087_A1,4,1,0,0,1,6
CTTTGTCGAATGCTCC-1_V10B01-087_A1,1,0,0,0,0,1
TGAGGCATGTACTGTG-1_V10B01-087_A1,4,0,0,0,0,4
TTCGCCGCTCGCGCTA-1_V10B01-087_A1,3,1,0,0,2,6
GACTCCTTCCAATTGA-1_V10B01-087_A1,2,0,0,0,2,4
ACCGAAGAGTCTGGTT-1_V10B01-087_A1,1,0,0,0,0,1
TGGCATGAAGTTTGGG-1_V10B01-087_A1,0,0,2,0,0,2
ACGAGGTTTACAACGT-1_V10B01-087_A1,0,1,0,0,0,1
AACCCATCCCATGATC-1_V10B01-087_A1,1,0,0,0,0,1
TCGACAACTGAACCCG-1_V10B01-087_A1,3,0,0,0,0,3
TATCTTGCAATACAAC-1_V10B01-087_A1,1,1,1,0,0,3
TATTATGTTTGCCTGC-1_V10B01-087_A1,0,0,2,0,0,2
GTCAAAGAAGTGGTGT-1_V10B01-087_A1,0,0,0,0,0,0
GGGACAGAGTTACTCC-1_V10B01-087_A1,3,0,1,0,0,4
AGCAACCGAAAGTAAT-1_V10B01-087_A1,1,0,2,0,1,4
CTCTCTAACTGCCTAG-1_V10B01-087_A1,2,1,0,0,0,3
ATACGGAACGTCGTTT-1_V10B01-087_A1,0,0,0,0,2,2
TCGGTCCCGACAATAG-1_V10B01-087_A1,1,0,0,0,2,3
CGCGCAAATGTCCAGA-1_V10B01-087_A1,1,0,0,0,0,1
TCTAATACTGCCTCAG-1_V10B01-087_A1,3,0,0,0,0,3
CTCGGTTGTCGGCCCT-1_V10B01-087_A1,2,0,0,0,0,2
GGTAACCGGGAGGATA-1_V10B01-087_A1,1,0,1,0,0,2
CAGGCGCACGGTGGTC-1_V10B01-087_A1,0,0,1,0,1,2
TCATCGATGGTCCCAA-1_V10B01-087_A1,4,0,0,0,0,4
CAAAGATTATTGGGCC-1_V10B01-087_A1,2,0,0,0,0,2
ACAATGAATACGGAGA-1_V10B01-087_A1,3,0,0,0,1,4
GCTCCTGACATACTGG-1_V10B01-087_A1,2,0,2,0,1,5
GATGACAAGTAGGGCA-1_V10B01-087_A1,3,0,1,0,0,4
TACGCCGAGGGTACCC-1_V10B01-087_A1,2,0,0,0,0,2
AAGCGTCCCTCATCGA-1_V10B01-087_A1,2,0,0,0,1,3
CACTCCTATGTAAGAT-1_V10B01-087_A1,1,4,1,0,0,6
TCGAGCCAGGCAGGCC-1_V10B01-087_A1,6,0,2,0,0,8
TCGTCAAGTACGCGCA-1_V10B01-087_A1,4,0,2,0,1,7
CCCGTAGCTGGGAAGA-1_V10B01-087_A1,0,0,0,0,0,0
ACCCTATGCCATATCG-1_V10B01-087_A1,1,1,0,0,2,4
GTGGTATAGTCTGCCG-1_V10B01-087_A1,2,0,1,0,3,6
CCGGTTTGTAATTGTG-1_V10B01-087_A1,2,0,0,0,0,2
GTCGCCGTTGTGTGTT-1_V10B01-087_A1,2,1,0,0,0,3
TACTGAACAGATTTAG-1_V10B01-087_A1,0,0,0,0,1,1
TATTAACCTGACCGCG-1_V10B01-087_A1,0,0,0,0,2,2
CTGTAGCCATCTCACT-1_V10B01-087_A1,1,1,0,0,0,2
TACTATGGTTCCTCAG-1_V10B01-087_A1,3,0,0,0,0,3
GAGTCAGACCAGAATC-1_V10B01-087_A1,2,0,0,0,0,2
TAAGGCATAACATCAA-1_V10B01-087_A1,1,3,2,0,0,6
CTTCCGCTCCGTGAAG-1_V10B01-087_A1,1,0,0,0,1,2
GGGCTATGATCGATGG-1_V10B01-087_A1,1,0,0,0,4,5
GGTCGGTCGTCCACAG-1_V10B01-087_A1,0,3,0,0,1,4
GGGACCCGTATATCTT-1_V10B01-087_A1,3,0,0,0,1,4
GAAAGCAGTGCACTTT-1_V10B01-087_A1,3,0,0,0,0,3
AGCGCATAATGAATCG-1_V10B01-087_A1,0,1,2,0,1,4
GCTGCTAAGTAGTCGA-1_V10B01-087_A1,2,0,1,0,0,3
AATAGTCCGTCCCGAC-1_V10B01-087_A1,0,0,0,0,0,0
AGCAGCCAGATGAATA-1_V10B01-087_A1,1,0,0,0,2,3
CCTCGCGCTGTGCGAT-1_V10B01-087_A1,1,0,0,0,0,1
TTGTGTATGCCACCAA-1_V10B01-087_A1,1,0,0,0,0,1
TGCTCGGCGAAACCCA-1_V10B01-087_A1,1,0,0,0,0,1
CGATTAAATATCTCCT-1_V10B01-087_A1,1,0,0,0,1,2
TGCCGTGGATCGTCCT-1_V10B01-087_A1,2,0,0,0,0,2
GTGGACGCATTTGTCC-1_V10B01-087_A1,1,1,3,0,1,6
ACCCGGAAACTCCCAG-1_V10B01-087_A1,2,2,3,0,1,8
CCGCATGTGGTACGAT-1_V10B01-087_A1,1,0,3,0,1,5
GCAAACCTTGGCCATA-1_V10B01-087_A1,1,0,0,0,0,1
ATTCACTGATGTTGGA-1_V10B01-087_A1,1,0,0,0,0,1
ACTCCCTAATGCTAAA-1_V10B01-087_A1,0,0,0,0,0,0
TCCTAAATTGGGAAGC-1_V10B01-087_A1,3,1,0,0,0,4
GAACAGATTACTAAAT-1_V10B01-087_A1,0,2,1,0,1,4
ATACAGGCCCTCCAAT-1_V10B01-087_A1,1,1,1,0,0,3
CGATTCGCCTGGCTGC-1_V10B01-087_A1,1,2,0,0,0,3
TCCGCCTGTCTACAAG-1_V10B01-087_A1,1,0,0,0,1,2
CACATCTCACCGACGA-1_V10B01-087_A1,0,1,0,0,1,2
CGTCGTCCTTCGCGAA-1_V10B01-087_A1,1,1,0,0,1,3
CGTTGAATACCGCGCT-1_V10B01-087_A1,0,0,1,0,0,1
ACCAATATGCAAGTTA-1_V10B01-087_A1,1,0,0,0,0,1
ACGGATGGTGCGGATA-1_V10B01-087_A1,0,2,1,0,2,5
CACCCTAACAAGATCT-1_V10B01-087_A1,0,0,0,0,1,1
AAGCTCTTTCATGGTG-1_V10B01-087_A1,1,0,0,0,1,2
CATGGGTATGCCTTAT-1_V10B01-087_A1,3,0,0,0,2,5
GCGCGTCATTGGTACA-1_V10B01-087_A1,1,0,0,0,1,2
TCTGAAGCACGTGGTC-1_V10B01-087_A1,1,1,1,0,1,4
AAGTTCACTCCAAGCT-1_V10B01-087_A1,0,3,1,0,1,5
TTGGACCTATAACAGT-1_V10B01-087_A1,1,4,2,0,1,8
ATCAGCCTCATGCTGC-1_V10B01-087_A1,0,1,0,0,0,1
AGTACTCTTATGCCCA-1_V10B01-087_A1,0,1,0,0,1,2
GCGCTTAAATAATTGG-1_V10B01-087_A1,0,1,0,0,0,1
TTGTGAACCTAATCCG-1_V10B01-087_A1,1,1,0,0,0,2
AGTCGTCGACCACCAA-1_V10B01-087_A1,3,1,4,0,1,9
TCCTTTAAATCCGCTT-1_V10B01-087_A1,1,0,0,0,0,1
ACTGAAACGCCGTTAG-1_V10B01-087_A1,3,0,0,0,1,4
GCACACACTGGTAGCC-1_V10B01-087_A1,2,0,2,1,0,5
TAAGGGCCTGTCCGAT-1_V10B01-087_A1,1,0,1,0,0,2
GCTAGAGTAGAGATGT-1_V10B01-087_A1,1,0,0,2,0,3
CACAGGGCCATATAGT-1_V10B01-087_A1,1,0,3,0,0,4
CCATGCCCTAGATTTC-1_V10B01-087_A1,0,1,0,1,0,2
TCGCGTAGCAGTGTCC-1_V10B01-087_A1,0,0,1,0,0,1
GACGAGGCTAATAAAC-1_V10B01-087_A1,1,0,3,0,0,4
CTACACTCGCAGATGG-1_V10B01-087_A1,1,0,0,0,1,2
ACGCATACGTTTACTA-1_V10B01-087_A1,1,1,2,0,0,4
GGAGCAACATTTCAAG-1_V10B01-087_A1,5,0,0,0,0,5
CGAGAGGGTAGCCGCG-1_V10B01-087_A1,1,0,1,1,0,3
TCGTGTTCGACCACAA-1_V10B01-087_A1,0,1,4,0,0,5
TCTACCCAATAGAGAG-1_V10B01-087_A1,2,0,1,0,0,3
ATAAACGTTGCACCAC-1_V10B01-087_A1,2,1,1,0,0,4
TCAACTGCAGAGTCAG-1_V10B01-087_A1,0,0,0,0,0,0
AGCTCCATATATGTTC-1_V10B01-087_A1,1,1,1,2,0,5
GTAACATCTAAGATAA-1_V10B01-087_A1,3,1,3,1,2,10
CCGACAATAGGCCGCC-1_V10B01-087_A1,1,0,2,0,0,3
ATGCTTAGGAGTTGAT-1_V10B01-087_A1,1,2,3,3,0,9
AACCCGAGCAGAATCG-1_V10B01-087_A1,0,1,2,0,0,3
CGGGTTTGTTAGGGCT-1_V10B01-087_A1,0,4,1,0,0,5
AGGCACGTGACTGTCC-1_V10B01-087_A1,0,4,1,0,0,5
GACAAGAGATGAGATT-1_V10B01-087_A1,2,2,0,1,0,5
AGCCCTTGGACATCCC-1_V10B01-087_A1,1,1,0,0,0,2
GCAGTTCGATCCGAGC-1_V10B01-087_A1,0,2,3,0,0,5
TCGAGGGCAACAGACG-1_V10B01-087_A1,0,0,0,3,0,3
ACTTTGTCGACGCACT-1_V10B01-087_A1,0,1,3,0,0,4
GAGTATCAAAGTTACA-1_V10B01-087_A1,0,2,1,0,0,3
CCAGGCTGGCGTCTGA-1_V10B01-087_A1,1,2,3,0,0,6
GGACTCTTCCGGTTGA-1_V10B01-087_A1,0,4,1,0,0,5
TCCCAGCACACGACAT-1_V10B01-087_A1,1,0,5,1,0,7
GCTCCATGAGTGCAGA-1_V10B01-087_A1,1,0,2,0,1,4
GCAGTGCGGGCGGATG-1_V10B01-087_A1,3,4,0,0,0,7
GCGTTCTGACTAAGCG-1_V10B01-087_A1,0,2,1,0,0,3
ATTTGGAGATTGCGGT-1_V10B01-087_A1,3,1,0,0,0,4
AAGGGTTTGATTTCAG-1_V10B01-087_A1,0,0,0,0,0,0
CCGGCCGCGAGCATAT-1_V10B01-087_A1,4,0,0,0,0,4
GAGTTCTGTGGGTGCT-1_V10B01-087_A1,3,1,0,1,0,5
AAACGAAGATGGAGTA-1_V10B01-087_A1,3,1,0,0,0,4
AATTACGAGACCCATC-1_V10B01-087_A1,4,0,0,0,0,4
CCTTTGAATTATGGCT-1_V10B01-087_A1,3,0,0,0,0,3
CATGGTATTAGTTTGT-1_V10B01-087_A1,2,1,1,0,0,4
AACGAAAGTCGTCCCA-1_V10B01-087_A1,1,0,0,0,1,2
ACATAAGTCGTGGTGA-1_V10B01-087_A1,2,1,0,0,0,3
GCACAACCTCGGGCGT-1_V10B01-087_A1,2,0,1,0,0,3
ATGCACGCGCTGTTCA-1_V10B01-087_A1,3,0,0,0,1,4
CGATGTTGTTATCTAC-1_V10B01-087_A1,3,1,0,0,0,4
GTCTCCTGCCAGTATG-1_V10B01-087_A1,3,0,0,0,0,3
GATGCCTTCTGCGGCA-1_V10B01-087_A1,0,1,1,0,0,2
ACCGGTCAGGTACACC-1_V10B01-087_A1,2,2,1,0,0,5
GTGGAGCGTTTACCGA-1_V10B01-087_A1,0,1,0,0,0,1
AGGCGGTTTGTCCCGC-1_V10B01-087_A1,1,0,1,0,1,3
TCCCTGGCGTATTAAC-1_V10B01-087_A1,3,0,2,0,1,6
AAACACCAATAACTGC-1_V10B01-087_A1,1,1,0,0,0,2
TGGACGCAATCCAGCC-1_V10B01-087_A1,1,0,1,0,0,2
GGAACCTTGACTCTGC-1_V10B01-087_A1,1,0,0,0,0,1
GTATCTCAGTCTTGAC-1_V10B01-087_A1,0,0,0,0,0,0
GCTGAATCTTCCAATC-1_V10B01-087_A1,4,0,0,0,1,5
AGATGCAAGACGTGCA-1_V10B01-087_A1,1,1,0,0,0,2
TTAAGGCCCGTACTTT-1_V10B01-087_A1,5,0,0,0,1,6
AGTATGCTGGAGACCA-1_V10B01-087_A1,2,0,0,0,0,2
GCGGCAAAGTATTGCC-1_V10B01-087_A1,1,0,1,0,0,2
GCGCAAATATATTCAA-1_V10B01-087_A1,1,0,0,0,1,2
GAAGAAACGATATTGT-1_V10B01-087_A1,3,0,0,0,1,4
GGACCTCTAGGCCGCC-1_V10B01-087_A1,0,0,0,0,0,0
AACAGCTGTGTGGCAA-1_V10B01-087_A1,4,1,1,0,1,7
TCGAATATCCCGCAGG-1_V10B01-087_A1,5,0,0,0,0,5
GCGACCCAACCATCTG-1_V10B01-087_A1,4,0,0,0,2,6
AGAGAAGGAGTACAAT-1_V10B01-087_A1,1,0,0,0,0,1
GGCTCCTCCACCTGTT-1_V10B01-087_A1,1,1,2,0,1,5
TCAGTGTATACGTCAT-1_V10B01-087_A1,4,0,0,0,1,5
ATTATTATGTCCGTCA-1_V10B01-087_A1,1,2,0,0,1,4
TTAGGTCATAACCGAC-1_V10B01-087_A1,2,0,1,0,1,4
AAGATGGCACCGGACC-1_V10B01-087_A1,1,0,1,0,0,2
CTACAAGAAATAACCC-1_V10B01-087_A1,1,0,3,0,0,4
ACTATTTCCGGGCCCA-1_V10B01-087_A1,3,0,1,0,0,4
TTGTTTCACATCCAGG-1_V10B01-087_A1,4,0,5,0,1,10
CGCTGTGTGGATGTTG-1_V10B01-087_A1,3,0,1,0,2,6
TCAACATAGCGCCCTA-1_V10B01-087_A1,1,2,0,1,0,4
GGCCGTTTGGGTTTCA-1_V10B01-087_A1,5,2,1,0,2,10
TACTCTTTCGTCTTCA-1_V10B01-087_A1,1,0,0,0,3,4
TTCGCGCGCCATACGA-1_V10B01-087_A1,2,1,1,0,1,5
CGGAAAGAATCAAACG-1_V10B01-087_A1,2,0,2,0,1,5
AGGCAGGGAGCGTACT-1_V10B01-087_A1,1,0,1,0,3,5
CCTTTAAGGGAGCACT-1_V10B01-087_A1,6,0,0,0,0,6
CGCCCAGCACGCCTAG-1_V10B01-087_A1,4,0,1,0,0,5
AGTATTTGGCACGACC-1_V10B01-087_A1,2,0,1,0,0,3
TATCCGCACCGTCGGG-1_V10B01-087_A1,0,1,0,0,2,3
ACCCGTGTCATCAGTA-1_V10B01-087_A1,4,1,1,0,0,6
CAACTGCTCATCCGAT-1_V10B01-087_A1,0,1,1,0,2,4
CCGGAGCGTACTTTCT-1_V10B01-087_A1,0,0,0,0,2,2
TACCGTAGGTTAACTA-1_V10B01-087_A1,0,0,0,0,0,0
TGAGGAGTGCCAGCTT-1_V10B01-087_A1,2,1,1,0,1,5
CCAGTCTTGTCATAGA-1_V10B01-087_A1,0,1,1,0,3,5
GGGCAGAGCAATCGTT-1_V10B01-087_A1,3,1,1,0,1,6
TACCAAATAGCCCAGA-1_V10B01-087_A1,0,0,0,0,0,0
TACCTACTCCCAGTAT-1_V10B01-087_A1,3,0,1,0,0,4
TGTGAGACTAGCCCAA-1_V10B01-087_A1,0,0,0,0,0,0
ATACCTAACCAAGAAA-1_V10B01-087_A1,2,0,1,0,1,4
GTCGGGAAGCAGAAAC-1_V10B01-087_A1,1,0,1,0,1,3
AATTAACGGATTTCCA-1_V10B01-087_A1,1,1,3,0,1,6
GAACCCTCTGTGTTCT-1_V10B01-087_A1,2,0,1,0,1,4
ATATAAAGCGCTCGTG-1_V10B01-087_A1,2,0,0,0,0,2
CCTGGTCGAATGTGGG-1_V10B01-087_A1,0,1,0,0,0,1
CTAGGTTCGGACGTGA-1_V10B01-087_A1,2,0,1,0,0,3
TCGGGAGACAGCGTAC-1_V10B01-087_A1,4,0,1,0,1,6
CATAAGAAGCTTGGCT-1_V10B01-087_A1,0,2,1,0,0,3
AAGCACCCTGCGTATC-1_V10B01-087_A1,0,0,0,0,2,2
AGTTTGCACCTGCCTC-1_V10B01-087_A1,1,2,0,0,0,3
GACTGCAAATCGAGCT-1_V10B01-087_A1,1,2,0,0,0,3
GTGTATATCAGCGGGC-1_V10B01-087_A1,0,0,2,0,1,3
CTTCAACTCCACTTGG-1_V10B01-087_A1,0,1,0,0,1,2
ACTTACGCATCCACGC-1_V10B01-087_A1,2,0,0,0,0,2
CATGAGATGCACTCTC-1_V10B01-087_A1,1,0,2,0,0,3
GAGCACCTGTGTCCAG-1_V10B01-087_A1,1,0,0,0,2,3
CGCGACCGCGACAGAT-1_V10B01-087_A1,2,0,0,0,0,2
GTCCCGCGACGTTATG-1_V10B01-087_A1,0,0,3,0,1,4
GCAGTGTGGCTATAGG-1_V10B01-087_A1,3,0,1,0,0,4
ATACTGCCTTACACCG-1_V10B01-087_A1,2,0,1,0,3,6
TACAGAAACGGTGGGC-1_V10B01-087_A1,3,0,0,0,2,5
GGCGCGGAGATCTTTC-1_V10B01-087_A1,0,1,0,0,1,2
CGTTAATGTCCCGACG-1_V10B01-087_A1,2,0,0,0,0,2
GCTAACTGAAGTCTGA-1_V10B01-087_A1,3,0,0,0,2,5
AGTGATAACCTGCGCG-1_V10B01-087_A1,1,0,1,0,2,4
TATGATCTTCTCTTTA-1_V10B01-087_A1,0,0,2,0,2,4
TGTACCTACACGAGGG-1_V10B01-087_A1,2,1,0,0,0,3
ATATCGTTCCTCGAAC-1_V10B01-087_A1,0,0,1,0,1,2
CGGCGCCATCAATCCC-1_V10B01-087_A1,1,1,2,0,0,4
CCTGTTTGAAGACACG-1_V10B01-087_A1,1,1,3,0,0,5
GCCACTCAGAGCGCGA-1_V10B01-087_A1,0,0,3,0,0,3
TCGGCTTGTATCGACG-1_V10B01-087_A1,0,0,0,1,1,2
TAGATGGTTCCTTACT-1_V10B01-087_A1,3,1,0,0,0,4
ATCGTTAGCTAGCGGA-1_V10B01-087_A1,1,2,1,0,0,4
ACAGCGACATTCTCAT-1_V10B01-087_A1,2,0,1,0,1,4
ATTCAACCATTTAAGG-1_V10B01-087_A1,0,0,1,0,0,1
CACTCTTCTGCTAGCC-1_V10B01-087_A1,2,1,1,0,0,4
CTAACTGATAATCGCC-1_V10B01-087_A1,1,0,1,1,0,3
TGATGTCAATTAAGTG-1_V10B01-087_A1,3,1,0,2,0,6
CGCCGTTCAGCATAGT-1_V10B01-087_A1,1,0,4,0,1,6
ATACTACCCGTACCAC-1_V10B01-087_A1,2,1,0,0,0,3
CCACTGTTTGGATTAA-1_V10B01-087_A1,0,0,2,0,0,2
CACTACGGGAGCTGCC-1_V10B01-087_A1,1,2,2,1,0,6
GACCAAACGTTGACTG-1_V10B01-087_A1,0,0,3,0,1,4
AAGAGGCCCTTTGGAA-1_V10B01-087_A1,2,1,2,1,0,6
ACACGTAGGCCACAAG-1_V10B01-087_A1,1,0,1,1,0,3
TACTCTTACTTTACTG-1_V10B01-087_A1,2,0,0,1,2,5
AGAGCCGCCGAGATTT-1_V10B01-087_A1,1,1,0,1,0,3
GGCCTGCTTCTCCCGA-1_V10B01-087_A1,0,0,1,0,0,1
TCAAGCGCGGACGGTA-1_V10B01-087_A1,1,0,0,0,0,1
ACACTGGGACAGTCGT-1_V10B01-087_A1,1,2,5,2,0,10
TGTGTAGTAGCACGTG-1_V10B01-087_A1,1,1,1,0,0,3
CTAGCCACAGGCGAGC-1_V10B01-087_A1,0,1,1,1,0,3
CTATCGCGTAGAGAAC-1_V10B01-087_A1,0,2,3,1,0,6
GTTCCCGTAAACATAT-1_V10B01-087_A1,1,2,3,1,1,8
TCTTTCCTTCGAGATA-1_V10B01-087_A1,0,1,1,1,1,4
ATATTGGAGAGGCCTT-1_V10B01-087_A1,2,6,1,0,0,9
AGGCGATAACTGGCGT-1_V10B01-087_A1,0,1,1,0,0,2
ACCCGGAGCACCACAA-1_V10B01-087_A1,0,2,3,0,0,5
TGAGCTCAACTGTATA-1_V10B01-087_A1,3,3,1,0,0,7
ACGACCCATGAGTTGC-1_V10B01-087_A1,0,1,3,0,0,4
CGGTCAGTCCATATTT-1_V10B01-087_A1,0,2,3,0,1,6
TCCGGCTGTCGGGTCG-1_V10B01-087_A1,0,0,0,0,0,0
ATTCCCGAAGGTACAG-1_V10B01-087_A1,0,1,0,0,0,1
CTAACAGCACAATAAC-1_V10B01-087_A1,4,0,0,0,0,4
TTGTGCGGAAGCGGAT-1_V10B01-087_A1,6,2,1,1,0,10
GGGCACTATTGACCAT-1_V10B01-087_A1,4,1,0,0,1,6
CCATAGAGGCTGCCAG-1_V10B01-087_A1,5,0,1,0,0,6
CCGAAGCATTGACCAA-1_V10B01-087_A1,5,0,0,0,0,5
TACTGAGGGAAGAAAG-1_V10B01-087_A1,2,1,0,0,0,3
TATGTAGAAACCCGGC-1_V10B01-087_A1,5,0,0,0,0,5
TGGTTAACTTACATTT-1_V10B01-087_A1,3,2,0,0,0,5
AGAACCCTCAATTGGG-1_V10B01-087_A1,3,0,0,0,1,4
CCTATATCGTGTCACG-1_V10B01-087_A1,5,0,0,0,0,5
ACGGCTGGATGTAGAA-1_V10B01-087_A1,0,3,0,0,0,3
CTCGCATTGCATAGCC-1_V10B01-087_A1,2,0,0,0,0,2
ACTTTGGTCGTGCTCC-1_V10B01-087_A1,3,0,0,0,1,4
GCTGGTTTAGGCCATA-1_V10B01-087_A1,0,1,1,0,1,3
TGTCGTTATCACATAT-1_V10B01-087_A1,2,0,0,0,2,4
ACACATGATCAAATCT-1_V10B01-087_A1,1,0,0,0,0,1
TATCCATCTCGGTTAG-1_V10B01-087_A1,0,0,1,0,0,1
CTCGTCGAGGGCTCAT-1_V10B01-087_A1,1,1,0,0,1,3
ATCAATGCCGTGGCTG-1_V10B01-087_A1,1,0,0,0,0,1
GAAACATAGGAAACAG-1_V10B01-087_A1,0,0,0,0,0,0
TAATAGGTCACCAGAA-1_V10B01-087_A1,2,0,0,0,0,2
CACCAGTCAGCATGCA-1_V10B01-087_A1,1,0,0,0,0,1
GAGCGCTGTTAGGTAA-1_V10B01-087_A1,0,0,0,0,1,1
CCCTATGTAGAGCAGA-1_V10B01-087_A1,2,1,0,0,0,3
GATCGCTATATCTCAG-1_V10B01-087_A1,1,0,0,0,0,1
AAGGGACTATGCATTC-1_V10B01-087_A1,1,1,2,0,1,5
CTCGGGTTCTCTGGCC-1_V10B01-087_A1,3,1,0,0,1,5
TATATATCGAGAAATG-1_V10B01-087_A1,1,0,1,0,1,3
ACCCGAGCGAAATTAC-1_V10B01-087_A1,1,0,0,0,2,3
TTGTTTCATTAGTCTA-1_V10B01-087_A1,2,0,0,0,1,3
ATGGGACCTGCTGAAC-1_V10B01-087_A1,1,0,1,0,0,2
TGCGACGGCCGAACGT-1_V10B01-087_A1,2,1,1,0,1,5
AGCTAACAAGCAATGT-1_V10B01-087_A1,2,0,0,0,0,2
CGTGTCTCGTTACGAC-1_V10B01-087_A1,1,0,0,0,1,2
CTAAATCCGGTGTACA-1_V10B01-087_A1,1,0,1,0,0,2
GAATAGTGCTCGATTA-1_V10B01-087_A1,1,0,1,0,1,3
AACAATACATTGTCGA-1_V10B01-087_A1,2,0,0,0,0,2
CACATCGTGCACGCGC-1_V10B01-087_A1,0,0,2,0,1,3
ACCGTGACCACGTGGG-1_V10B01-087_A1,6,0,0,0,0,6
CCCAATGAGATTTGCA-1_V10B01-087_A1,2,0,0,0,1,3
TCAGCAGTAGGCCCTG-1_V10B01-087_A1,1,2,0,0,0,3
CTACTCAAGGTATAGT-1_V10B01-087_A1,4,0,0,0,0,4
TAGTAGCTTATACCAG-1_V10B01-087_A1,4,0,1,0,0,5
ACGTTCGTTCAGGAAA-1_V10B01-087_A1,2,2,0,0,0,4
TTAGAATAAGGGTCGG-1_V10B01-087_A1,2,1,2,0,1,6
TTCTAGAAAGTCTTAT-1_V10B01-087_A1,5,0,1,0,2,8
CCTTCAGTTAAAGTGA-1_V10B01-087_A1,1,1,1,0,2,5
TAGCTAGTGATGATGG-1_V10B01-087_A1,3,0,1,0,2,6
AGCCCGGTAGCCTGTA-1_V10B01-087_A1,2,1,0,0,1,4
TACCTCAGTTGTCTGT-1_V10B01-087_A1,1,1,1,0,2,5
GACGGGTTGGCCCGTA-1_V10B01-087_A1,4,0,0,0,3,7
GAAACCTATACAAATG-1_V10B01-087_A1,2,2,0,0,2,6
TCCACCTCTAGCCTTT-1_V10B01-087_A1,1,0,1,0,3,5
AAGACCCAACTGAACA-1_V10B01-087_A1,2,2,0,0,0,4
CATACACGGTTCCCAC-1_V10B01-087_A1,0,1,2,0,3,6
ACTACGCGTTAGAATT-1_V10B01-087_A1,0,0,2,0,3,5
CTTGGCCAAGCTGGGA-1_V10B01-087_A1,2,0,1,0,2,5
TTACCCTAGGGATTGG-1_V10B01-087_A1,3,1,1,0,0,5
TTCGCACTGTACGACA-1_V10B01-087_A1,5,0,0,0,1,6
TAGGTGTTCCACAGAT-1_V10B01-087_A1,5,0,2,0,1,8
GAAGCCTGCACATTCC-1_V10B01-087_A1,2,0,1,0,1,4
GGCTTTCAATAAGGGT-1_V10B01-087_A1,0,0,1,0,2,3
TCCAGGGTATATACGA-1_V10B01-087_A1,1,0,0,0,1,2
CTCGCCGAATGTAGGG-1_V10B01-087_A1,1,0,1,0,0,2
AGGAAGCTGTCCGCCG-1_V10B01-087_A1,1,0,4,0,1,6
GTCTCAAGGCCCGGCT-1_V10B01-087_A1,2,0,0,0,0,2
ACCGACACATCTCCCA-1_V10B01-087_A1,2,0,0,0,0,2
TATACGCGTCATCACT-1_V10B01-087_A1,1,1,1,0,1,4
ATCTGGGCTGTTCTTG-1_V10B01-087_A1,2,0,1,0,0,3
TCAAATTTGAGACTCA-1_V10B01-087_A1,0,1,0,0,1,2
GTTAAGGGTGCGATGT-1_V10B01-087_A1,1,0,0,0,1,2
AGCAAAGGCCGCTAGT-1_V10B01-087_A1,0,0,0,0,0,0
TTATAGGTAATTGTCT-1_V10B01-087_A1,1,1,1,0,0,3
TTGTGCAGCCACGTCA-1_V10B01-087_A1,2,0,1,0,1,4
ACGGACTCTCAAAGCG-1_V10B01-087_A1,2,1,0,0,1,4
ATGCTCTGGCGCGGTA-1_V10B01-087_A1,0,0,0,0,1,1
ATAATCTTGGAGAACC-1_V10B01-087_A1,1,0,1,0,0,2
CTCATTGCTCTAACAA-1_V10B01-087_A1,2,1,0,0,0,3
TAGGTGACGATAACCT-1_V10B01-087_A1,1,1,0,0,0,2
CGGATCCTCAAGGACT-1_V10B01-087_A1,1,2,1,0,3,7
GGGCGTGGTTTCCCAG-1_V10B01-087_A1,1,0,0,0,0,1
TGGCTATGTGACATAC-1_V10B01-087_A1,2,2,0,0,1,5
CTTAGTGTAGTAGCAT-1_V10B01-087_A1,2,1,1,0,0,4
GGATTGCTGTGACTCC-1_V10B01-087_A1,1,0,0,0,0,1
ACTTCCATGCGGGACA-1_V10B01-087_A1,2,0,1,0,3,6
ACTCAAGTGCAAGGCT-1_V10B01-087_A1,0,0,2,0,1,3
ACAAGGATGCTTTAGG-1_V10B01-087_A1,2,0,1,0,0,3
TTGAACGACGTGCTGA-1_V10B01-087_A1,1,1,0,0,0,2
ATTCATCGTTGAGGCA-1_V10B01-087_A1,4,0,0,0,0,4
TGCAACCCATCTGCGG-1_V10B01-087_A1,2,1,1,0,0,4
AGTGCTAAACACAGCA-1_V10B01-087_A1,0,0,1,0,2,3
AACTCCAGAGCGTGTT-1_V10B01-087_A1,1,1,1,0,1,4
TCTCCACAAGTTGAAT-1_V10B01-087_A1,2,0,2,0,1,5
CTTTGCATCGCTCTTG-1_V10B01-087_A1,0,1,0,0,0,1
TCACAAACCGAGGTAC-1_V10B01-087_A1,1,0,0,0,0,1
CCGTAGGAAATCCCTG-1_V10B01-087_A1,3,0,0,0,0,3
AAACATTTCCCGGATT-1_V10B01-087_A1,2,0,0,0,0,2
GCCTCCGACAATTCAC-1_V10B01-087_A1,4,0,0,0,0,4
TCTGCATACCTTGCTT-1_V10B01-087_A1,0,3,1,0,1,5
ACCCATTTGTCCCTCT-1_V10B01-087_A1,0,1,1,0,0,2
CTGCAGAGAATCAGAG-1_V10B01-087_A1,1,0,3,0,1,5
GGAAACTAAATGGGCC-1_V10B01-087_A1,1,2,0,0,0,3
CAACCTACCGAGCAGT-1_V10B01-087_A1,1,0,4,0,0,5
CCGTAGGGTTGTTTAC-1_V10B01-087_A1,0,0,1,0,2,3
GGTTTGTGACCTGAGG-1_V10B01-087_A1,0,3,2,1,0,6
TAACCTAGGGAGTCCA-1_V10B01-087_A1,1,0,0,0,0,1
TTCCATCGACAGCGTG-1_V10B01-087_A1,0,0,1,0,0,1
ATCTCCCACGGAATAT-1_V10B01-087_A1,2,1,2,1,1,7
GTTTCAAACGAGTTGT-1_V10B01-087_A1,2,4,0,1,0,7
GGAACTTTGGCGATTA-1_V10B01-087_A1,1,0,0,2,0,3
CTGCAAGCACGTTCCG-1_V10B01-087_A1,1,0,4,0,1,6
CACAGTCCCGCTTCGC-1_V10B01-087_A1,1,1,0,0,1,3
TACGCTCGGTATTGGA-1_V10B01-087_A1,1,3,2,0,0,6
CTGGTAAAGTGTGGGC-1_V10B01-087_A1,0,0,3,0,0,3
CAACCAGTGGCCTACC-1_V10B01-087_A1,0,2,1,1,0,4
TCTTCGCGGTGAGAGG-1_V10B01-087_A1,0,1,3,2,0,6
TTCGGGTTGCCACGGG-1_V10B01-087_A1,0,2,1,0,0,3
ACCGATAGGCATAACC-1_V10B01-087_A1,4,1,0,0,1,6
CTTATAGATGGCTGTT-1_V10B01-087_A1,1,3,3,1,0,8
AGACGCCCACTTCGCC-1_V10B01-087_A1,2,1,0,1,0,4
AGGTCGCCTCCCAACA-1_V10B01-087_A1,1,1,1,1,0,4
CCTCACGTCAGCTAAT-1_V10B01-087_A1,1,1,2,0,0,4
CCACCTGTATGGAATA-1_V10B01-087_A1,0,0,0,0,0,0
GGACTCGAAGCTTTCA-1_V10B01-087_A1,0,0,0,0,0,0
AAACATGGTGAGAGGA-1_V10B01-087_A1,1,0,1,1,0,3
ATCATTGTACCGCATT-1_V10B01-087_A1,1,0,0,2,0,3
TCAGCTTGAGCTTTCG-1_V10B01-087_A1,3,1,0,0,0,4
CCGCGCAAGATACCCA-1_V10B01-087_A1,0,0,0,0,0,0
CTATACTTAAAGCGAG-1_V10B01-087_A1,1,2,0,0,0,3
ACCGTCCACTGGGCCC-1_V10B01-087_A1,1,1,0,0,0,2
AAGACCAAATAACTCA-1_V10B01-087_A1,6,0,1,0,0,7
TGTTTCTGAAGCGTGC-1_V10B01-087_A1,4,4,0,0,0,8
TTCTCTTACAGGTGAT-1_V10B01-087_A1,4,0,0,0,0,4
AATTCATTGTCATGCA-1_V10B01-087_A1,4,0,0,0,0,4
GCCCGAGAGTCTAAAT-1_V10B01-087_A1,2,1,0,0,0,3
ATATAGAGTATTGGTC-1_V10B01-087_A1,3,0,0,0,0,3
TTGAAGGATGGGCGCC-1_V10B01-087_A1,1,0,0,0,1,2
TAGTACCACAACTTTC-1_V10B01-087_A1,4,0,0,0,0,4
ATCCCATCCACAGCGC-1_V10B01-087_A1,2,0,0,0,1,3
CTTAGGTATAGACCAG-1_V10B01-087_A1,5,1,0,0,0,6
TGACTCCGAATCATAC-1_V10B01-087_A1,1,0,1,0,0,2
ACTACATCCCGACAAG-1_V10B01-087_A1,0,0,0,0,0,0
TTGCCGCAGACCTACA-1_V10B01-087_A1,1,2,0,0,1,4
TAAGAGGGACAGGGAC-1_V10B01-087_A1,2,0,0,0,0,2
CGAATGAAGTCATTGC-1_V10B01-087_A1,2,0,0,0,1,3
AAGGGAACGACTGGCT-1_V10B01-087_A1,1,0,1,0,2,4
CGAATCTGCTCGACGC-1_V10B01-087_A1,2,0,0,0,0,2
ATCGTGGAAAGTCTGG-1_V10B01-087_A1,1,0,0,0,1,2
CCTATGGCTCCTAGTG-1_V10B01-087_A1,0,0,0,0,0,0
CGTCGCTTGGTTATAC-1_V10B01-087_A1,1,1,0,0,0,2
TGCTTAGAGAGAATGC-1_V10B01-087_A1,2,1,1,0,3,7
GATTGCTCCAGTTGCA-1_V10B01-087_A1,2,2,0,0,0,4
CGTGCTTCTACCTAAA-1_V10B01-087_A1,2,0,2,0,1,5
ACTCCAATATCATCAT-1_V10B01-087_A1,4,1,1,0,0,6
GCCGACCCACGACTGC-1_V10B01-087_A1,0,0,0,0,1,1
GAGGGTAGTAACAAAG-1_V10B01-087_A1,1,0,0,0,0,1
GGCCGAGACTCTGGTG-1_V10B01-087_A1,3,2,1,0,2,8
TATATAGGGCTTTACG-1_V10B01-087_A1,2,0,0,0,0,2
TGCCGGATGTACGAGC-1_V10B01-087_A1,1,0,0,0,1,2
AGGTAGATCGAGATAT-1_V10B01-087_A1,0,0,3,0,0,3
GATCAACATAAAGGGA-1_V10B01-087_A1,2,1,0,0,0,3
TAACAGCGTTTGTGCT-1_V10B01-087_A1,2,0,0,0,0,2
CTATAGGCGTTGATGT-1_V10B01-087_A1,2,1,0,0,0,3
GGTTTAATTACCATCG-1_V10B01-087_A1,1,1,0,0,0,2
CTCTTCTGGAAGTTAG-1_V10B01-087_A1,4,1,0,0,0,5
ATCTGACATGGAAGGA-1_V10B01-087_A1,1,1,1,0,0,3
TACGTACTAGTGCTGA-1_V10B01-087_A1,0,0,1,0,0,1
ATGACTATCAGCTGTG-1_V10B01-087_A1,1,0,1,0,1,3
CTTTGGGATTGTTGCA-1_V10B01-087_A1,5,0,0,0,0,5
AGACTGTTACCGGGTC-1_V10B01-087_A1,5,1,0,0,1,7
TCCTAACCGTCGGGCA-1_V10B01-087_A1,3,0,0,0,0,3
ACGCAAACTAATAGAT-1_V10B01-087_A1,1,0,0,0,0,1
AAGTGAGTCGGGTTTA-1_V10B01-087_A1,2,1,0,0,0,3
TAAAGCGGTATTTCCA-1_V10B01-087_A1,3,0,0,0,4,7
CTCCTCCAGCTCACAC-1_V10B01-087_A1,4,0,1,0,0,5
CGGTCCGTCGCAAGCC-1_V10B01-087_A1,1,0,0,0,0,1
CCTATATTTGTCCTGG-1_V10B01-087_A1,2,0,0,0,4,6
TCCAATAAAGGCTACC-1_V10B01-087_A1,1,0,0,0,1,2
AAAGGCTACGGACCAT-1_V10B01-087_A1,1,0,1,0,1,3
CGTGACCAGTCCTCTG-1_V10B01-087_A1,2,0,3,0,1,6
GATCTGCTATCTAAGG-1_V10B01-087_A1,1,2,1,0,0,4
CGAATGACGCATAATG-1_V10B01-087_A1,4,1,0,0,1,6
GCTCAATGTAATACCG-1_V10B01-087_A1,0,1,0,0,1,2
CTATGCCCGAATGCAA-1_V10B01-087_A1,3,0,0,0,1,4
CACAGGGCCGTTGTCA-1_V10B01-087_A1,2,0,0,0,0,2
TCAATACGCCGTCATG-1_V10B01-087_A1,3,0,0,0,2,5
AGCGGACACTTCGTAG-1_V10B01-087_A1,2,1,0,0,1,4
ATACGTTATGCACGGA-1_V10B01-087_A1,2,1,1,0,1,5
GAGTAGATACTAGTTG-1_V10B01-087_A1,0,1,0,0,0,1
CCAGCTCGAACGCATT-1_V10B01-087_A1,1,1,2,0,0,4
TGCTTCCCAAGCAGTA-1_V10B01-087_A1,1,0,0,0,0,1
GTAGACACGCCTGACT-1_V10B01-087_A1,2,1,2,0,2,7
CTCACATTTACTAAAT-1_V10B01-087_A1,1,0,1,0,0,2
GAATGCGAATCGGTTC-1_V10B01-087_A1,4,0,0,0,0,4
TAAGGCCCGTCACCCT-1_V10B01-087_A1,1,1,2,0,0,4
GAGTATGCGCGTGCAT-1_V10B01-087_A1,1,1,0,0,0,2
ATCCACATCGACAGAA-1_V10B01-087_A1,2,0,0,0,0,2
TAGACGAAACGCCAAT-1_V10B01-087_A1,4,0,0,0,0,4
CAGCAGTCTGTGCTGC-1_V10B01-087_A1,1,1,1,0,1,4
CTCACTGTGATACTTA-1_V10B01-087_A1,2,0,0,0,0,2
TTAATTGCTTTGGGTG-1_V10B01-087_A1,0,0,0,0,0,0
GTAGTCTACGATATTG-1_V10B01-087_A1,0,1,0,0,1,2
TTGCCGCTTTCTAGTA-1_V10B01-087_A1,2,0,2,0,0,4
GAACCTTTAACGATCC-1_V10B01-087_A1,0,0,0,0,1,1
TGGACCAATCTAAGAT-1_V10B01-087_A1,1,0,2,0,0,3
CTAGTAGAAAGGGATT-1_V10B01-087_A1,0,0,1,0,1,2
AACCTCGCTTTAGCCC-1_V10B01-087_A1,1,0,0,0,2,3
GAGTGTCAACCAGAAA-1_V10B01-087_A1,0,0,0,0,0,0
GTGATCCTTGTCATGA-1_V10B01-087_A1,1,0,0,0,1,2
CTCAACTAACCCGGAT-1_V10B01-087_A1,1,0,4,0,2,7
AGTGGCGTCTGAAGGT-1_V10B01-087_A1,3,1,4,0,0,8
GGGAAGGGCTTTCTCA-1_V10B01-087_A1,1,0,0,0,0,1
AGGCCTGAGAATCTCG-1_V10B01-087_A1,0,0,4,0,1,5
AGCCACAGGTTACCCG-1_V10B01-087_A1,0,0,1,0,1,2
TGCAATCTAACACGGT-1_V10B01-087_A1,2,0,1,0,1,4
GTTTGGGTTTCGCCCG-1_V10B01-087_A1,1,1,4,0,2,8
CCTATGTCCACTCCAC-1_V10B01-087_A1,3,0,4,0,0,7
CTGCCTTTCTAGTAAA-1_V10B01-087_A1,1,0,1,0,1,3
TTAGTAAACCTGCTCT-1_V10B01-087_A1,0,0,2,0,0,2
TTGTGGTGGTACTAAG-1_V10B01-087_A1,3,1,1,0,0,5
CCTCCTGTTGTGTCGT-1_V10B01-087_A1,0,0,1,0,1,2
ACAAAGCATGACCTAG-1_V10B01-087_A1,0,0,3,0,0,3
ATAGCAACTAGGGAAG-1_V10B01-087_A1,2,1,0,0,0,3
CCGCTCTTCCGAACTA-1_V10B01-087_A1,3,2,4,1,0,10
TAGAATAGCCGATGAA-1_V10B01-087_A1,2,3,0,0,0,5
GGTCTCCGTCCAGGTT-1_V10B01-087_A1,0,2,0,0,1,3
TAATTACGTCAGTAGA-1_V10B01-087_A1,0,0,1,0,0,1
TACGTAAAGCGGAGTG-1_V10B01-087_A1,1,1,1,0,1,4
GCTACAATCGAGGATA-1_V10B01-087_A1,0,1,1,0,0,2
TCAGCCAATCCGTAAA-1_V10B01-087_A1,0,1,0,0,0,1
ATCATAGCCCTATGTA-1_V10B01-087_A1,0,2,0,2,0,4
GAGGCCTGTTGATACA-1_V10B01-087_A1,1,2,2,0,1,6
ATATACGCTCGTGACG-1_V10B01-087_A1,0,0,1,0,0,1
CCCTTTAATGGAGTTC-1_V10B01-087_A1,0,1,2,0,0,3
TTACACGATCTGCGAC-1_V10B01-087_A1,0,0,1,0,1,2
TCGCATAAAGGGCGCA-1_V10B01-087_A1,0,0,1,0,1,2
TGTAGCCATCCCATTC-1_V10B01-087_A1,0,2,3,0,0,5
GGGTCTATCGCTTTCC-1_V10B01-087_A1,0,2,0,0,0,2
GGAGGGTCAAGTAAGA-1_V10B01-087_A1,0,1,0,0,0,1
TACGGCATGGACGCTA-1_V10B01-087_A1,0,3,6,0,0,9
CACGTCAATCAATGGA-1_V10B01-087_A1,1,2,2,0,0,5
CGCTTGGACGGATAGA-1_V10B01-087_A1,0,0,0,0,0,0
CGCGGTACGGTATACA-1_V10B01-087_A1,1,0,1,2,0,4
CGTTTGGTGTTGTGGG-1_V10B01-087_A1,0,0,0,0,0,0
GGACAAGCCATGATCG-1_V10B01-087_A1,0,0,0,0,0,0
TCCAATGCGTCGCCGC-1_V10B01-087_A1,4,1,0,3,0,8
AAAGAATGACCTTAGA-1_V10B01-087_A1,2,0,0,0,0,2
CCTATTATTCCGGCCG-1_V10B01-087_A1,1,0,0,3,0,4
CAGTAAGGGACGTCTC-1_V10B01-087_A1,1,2,1,3,1,8
GGGATGGACCCGCGTC-1_V10B01-087_A1,1,2,0,0,0,3
GACGCATACCCGTCGG-1_V10B01-087_A1,0,1,0,0,0,1
GGGCAGGATTTCTGTG-1_V10B01-087_A1,1,0,1,0,0,2
TATCTGAGCCGATATT-1_V10B01-087_A1,4,2,1,0,0,7
AATGTATGGCACTGTA-1_V10B01-087_A1,4,2,0,0,0,6
GCCTTTGTCAGTGGAC-1_V10B01-087_A1,4,0,0,0,0,4
AACCATAGGGTTGAAC-1_V10B01-087_A1,1,0,0,0,1,2
AAACTTAATTGCACGC-1_V10B01-087_A1,1,1,1,0,0,3
TAGGCGGCTGCAAAGA-1_V10B01-087_A1,0,0,1,0,1,2
TCCATCAATACTAATC-1_V10B01-087_A1,1,1,0,0,0,2
ACCTCGAACTTATGCT-1_V10B01-087_A1,2,0,0,0,0,2
ACAAACCATGCGTCCT-1_V10B01-087_A1,2,0,0,0,0,2
ACACCGGTCTGACCGC-1_V10B01-087_A1,2,0,2,0,0,4
ATGGCAGCATTACGAT-1_V10B01-087_A1,2,2,2,0,0,6
CTGGTGAATGGGCCTA-1_V10B01-087_A1,2,0,0,0,1,3
CACAGAGACGAGGACG-1_V10B01-087_A1,4,0,0,0,1,5
GCACAAACCCTAGATG-1_V10B01-087_A1,1,1,0,0,0,2
ACTATGTCCAGCTGCC-1_V10B01-087_A1,2,0,0,0,1,3
AAGCCGCCGTGAAATC-1_V10B01-087_A1,4,0,0,0,1,5
ATGGGTGTATACCTCC-1_V10B01-087_A1,2,0,0,0,0,2
TAAGCGCGAATCAAAT-1_V10B01-087_A1,3,0,2,0,1,6
AGCCCGGCATTAGAGG-1_V10B01-087_A1,2,0,0,0,1,3
GTGATCAAGCGTGCAC-1_V10B01-087_A1,5,0,0,0,0,5
CTGCCTTTAATACCTT-1_V10B01-087_A1,0,0,0,0,0,0
TACCTCCACACCAATG-1_V10B01-087_A1,1,2,0,0,1,4
GAGCATCAACAACTTG-1_V10B01-087_A1,4,1,0,0,0,5
CATACGAACTAGCTGG-1_V10B01-087_A1,2,0,0,0,2,4
GGGAACGGTTTCAGAT-1_V10B01-087_A1,0,1,0,0,1,2
AGGGTGCCGTTCTTTA-1_V10B01-087_A1,1,0,0,0,0,1
ACGACTGGTCATACTC-1_V10B01-087_A1,0,1,0,0,1,2
GGATCTTACTGCCCTT-1_V10B01-087_A1,2,3,0,0,0,5
TACTCCTCTAGTTGAC-1_V10B01-087_A1,3,0,0,0,0,3
GTAGCTCCGGGAGGCT-1_V10B01-087_A1,2,0,0,0,0,2
GGACTCGTGAGTGGTC-1_V10B01-087_A1,0,0,0,0,1,1
GTAGTTCGAAGGCGAA-1_V10B01-087_A1,2,0,1,0,0,3
CTCAAACCACTGCCCG-1_V10B01-087_A1,3,5,0,0,0,8
GAGGGAGTCAGATCGC-1_V10B01-087_A1,2,0,1,0,1,4
GCGTCCCTAAGACATA-1_V10B01-087_A1,1,1,2,0,0,4
TCTCTTACCGCGAACC-1_V10B01-087_A1,2,0,0,0,0,2
GGCTACTATACACTCC-1_V10B01-087_A1,2,1,0,0,0,3
CGTTGCCCGCGTGGGA-1_V10B01-087_A1,1,1,0,0,0,2
TATAGAGTCGCTTGAA-1_V10B01-087_A1,3,0,0,0,1,4
ATGTTGTAGTCTGTTT-1_V10B01-087_A1,2,0,0,0,2,4
AGTATACACAGCGACA-1_V10B01-087_A1,3,0,1,0,1,5
TGTGGTTGCTAAAGCT-1_V10B01-087_A1,2,0,1,0,2,5
TGATTCCCGGTTACCT-1_V10B01-087_A1,2,2,0,0,0,4
CACTGACGATTGTGGA-1_V10B01-087_A1,2,2,1,0,1,6
AACATTGTGACTCGAG-1_V10B01-087_A1,6,1,0,0,2,9
GTCCAATATTTAGCCT-1_V10B01-087_A1,1,0,1,0,0,2
GCTCTTTCCGCTAGTG-1_V10B01-087_A1,1,0,1,0,1,3
GGGTCAGGAGCTAGAT-1_V10B01-087_A1,2,0,1,0,3,6
AGGTGGTGACCTTCGC-1_V10B01-087_A1,2,0,0,0,4,6
CCCGGGTCGTTCAGGG-1_V10B01-087_A1,2,0,0,0,1,3
AGCCAAGCTTTGTGTC-1_V10B01-087_A1,2,0,0,0,1,3
TGTGGCGGGCTTCTGG-1_V10B01-087_A1,3,0,2,0,2,7
CGAGGGTATCCAGGTG-1_V10B01-087_A1,3,1,0,0,1,5
CGTTCAGACCCGCGAA-1_V10B01-087_A1,0,0,1,0,1,2
TCATATGAGCTTTGTT-1_V10B01-087_A1,1,1,0,0,1,3
AGTTGACGGTCCTTGC-1_V10B01-087_A1,1,0,0,0,2,3
ATAATTAGCTAAGTAG-1_V10B01-087_A1,3,1,1,0,1,6
GGTCTTGAGCGCTCTT-1_V10B01-087_A1,0,0,0,0,0,0
CGTTGTCGGCAATTGA-1_V10B01-087_A1,0,0,1,0,1,2
TCTTGCTCCCGATACT-1_V10B01-087_A1,2,1,4,0,0,7
AGCAGAAGGAGAAAGA-1_V10B01-087_A1,2,1,0,0,0,3
GAAGCCACTGATTATG-1_V10B01-087_A1,2,0,0,0,1,3
TGCTCTTGAGAGTTTG-1_V10B01-087_A1,5,1,0,0,1,7
GACATCCGTCGAACTG-1_V10B01-087_A1,1,0,0,0,1,2
AGATATAATACGACTA-1_V10B01-087_A1,3,2,0,0,1,6
TCGCTACTGGCTTTGA-1_V10B01-087_A1,3,0,0,0,1,4
GTGACAGCTTCCCACT-1_V10B01-087_A1,3,0,1,0,1,5
GTGACGCAGGTTTCAT-1_V10B01-087_A1,1,2,0,0,0,3
GGGAAGACGGTCTGTC-1_V10B01-087_A1,3,0,1,0,0,4
CGTCGCATGTGAGCCA-1_V10B01-087_A1,0,0,0,0,0,0
AGAAGGTTGTAGGTCG-1_V10B01-087_A1,1,0,0,0,0,1
GGCCGGCGTCTGCTAT-1_V10B01-087_A1,2,0,1,0,0,3
TTGACCAGGAACAACT-1_V10B01-087_A1,2,0,2,0,2,6
AGTCGTATAAAGCAGA-1_V10B01-087_A1,1,0,0,0,1,2
GGCGTAGGGAAAGCTG-1_V10B01-087_A1,2,0,1,0,1,4
AAACCTAAGCAGCCGG-1_V10B01-087_A1,0,0,2,0,0,2
ATTGCCTTTATGTTTG-1_V10B01-087_A1,1,0,0,0,2,3
CAGGCAGTCTTACCAG-1_V10B01-087_A1,1,0,0,0,1,2
AGCTAAGTACGCAGGC-1_V10B01-087_A1,1,0,0,0,0,1
AAATCCGATACACGCC-1_V10B01-087_A1,3,0,1,0,0,4
CGAGAGCTTTCACTAC-1_V10B01-087_A1,0,1,0,0,0,1
CGCCCAGCGTTTCACG-1_V10B01-087_A1,1,0,1,0,1,3
TTAAGTATTGTTATCC-1_V10B01-087_A1,1,1,0,0,2,4
AAACGGGCGTACGGGT-1_V10B01-087_A1,2,0,1,0,0,3
GTATCCTTTGGTAACC-1_V10B01-087_A1,0,0,0,0,1,1
CATAGTCAAATACATA-1_V10B01-087_A1,2,1,4,0,0,7
TCTATGCTATAACGAC-1_V10B01-087_A1,1,0,2,0,1,4
ACGTTCTGTACAAGTC-1_V10B01-087_A1,1,0,0,0,0,1
CGCGAAGTGGCATACT-1_V10B01-087_A1,1,0,0,0,2,3
ACCAACCGCACTCCAC-1_V10B01-087_A1,1,1,0,0,1,3
GTCATGCGCGAGGGCT-1_V10B01-087_A1,2,0,1,0,0,3
TAGGCTAAAGTGGCAC-1_V10B01-087_A1,1,1,0,0,0,2
TGGCTACACTCTACCT-1_V10B01-087_A1,1,0,2,0,1,4
TGTCCACGGCTCAACT-1_V10B01-087_A1,3,1,1,0,0,5
AATTGCAGCAATCGAC-1_V10B01-087_A1,0,1,1,0,0,2
GTCAACCAGGCCTATA-1_V10B01-087_A1,0,0,1,0,3,4
ATCTTATCGCACACCC-1_V10B01-087_A1,2,0,1,0,1,4
GTCTATTGCATGCTCG-1_V10B01-087_A1,3,0,1,0,1,5
GCACGTGGTTTACTTA-1_V10B01-087_A1,0,1,2,0,1,4
ATTCGCGCCTTGAGAG-1_V10B01-087_A1,0,3,0,0,0,3
AGCGATGCGCCTAATA-1_V10B01-087_A1,1,1,0,0,1,3
TCTATAGGTGGGTAAT-1_V10B01-087_A1,0,0,2,0,2,4
AGATACCAATAGAACC-1_V10B01-087_A1,2,0,1,0,0,3
CGTGTATGGGAGCTGA-1_V10B01-087_A1,1,1,1,0,0,3
ATGTACATGCGGTGAG-1_V10B01-087_A1,0,1,1,0,0,2
GTTCGGAGCACTCAAC-1_V10B01-087_A1,0,2,0,0,0,2
TGTAAGACTGATAAGA-1_V10B01-087_A1,0,0,0,1,0,1
CGGTTTACTGAACATT-1_V10B01-087_A1,0,0,0,0,0,0
GAGATCGATCTTACTC-1_V10B01-087_A1,0,0,0,0,0,0
TCTTTCATCCGTCCTT-1_V10B01-087_A1,1,0,0,0,0,1
TCGGATCTGGATGACC-1_V10B01-087_A1,0,0,0,0,0,0
GTCCTAGGATACCTTA-1_V10B01-087_A1,0,0,0,1,0,1
TGTACCCGACCCTAAT-1_V10B01-087_A1,0,1,0,0,0,1
AGGTTCTCCTTTCCGG-1_V10B01-087_A1,1,0,0,0,0,1
AATTGCGTGGATTACA-1_V10B01-087_A1,4,1,0,0,0,5
CGATAGCGATACAGTG-1_V10B01-087_A1,2,0,0,0,0,2
CGCCCTAATTGTTCAA-1_V10B01-087_A1,4,1,0,0,0,5
ATTATGAGACCCAATT-1_V10B01-087_A1,4,0,2,0,0,6
CCTCCTAGCTAGAGTC-1_V10B01-087_A1,4,0,0,0,0,4
CGAAGGGTTTCAGATT-1_V10B01-087_A1,2,1,0,0,0,3
CACAAGCTAAGAAAGG-1_V10B01-087_A1,5,3,0,0,0,8
CACCGGTAGAGACATT-1_V10B01-087_A1,0,0,0,0,0,0
ACTCATGGCAGCCTTC-1_V10B01-087_A1,2,0,0,0,0,2
CATCCAATATAGTTTG-1_V10B01-087_A1,2,0,0,0,1,3
CAGATATGAAGATGAC-1_V10B01-087_A1,5,0,0,0,0,5
GCAAAGGGCGTTAGCC-1_V10B01-087_A1,1,0,1,0,1,3
CTGTTGTTCAGTCGTA-1_V10B01-087_A1,3,0,0,0,2,5
AAAGGCCCTATAATAC-1_V10B01-087_A1,3,0,0,0,0,3
AACATTGAAGTTGATC-1_V10B01-087_A1,0,0,0,0,1,1
GCTAGCGATAGGTCTT-1_V10B01-087_A1,2,0,0,0,0,2
ATTGCCTATTAGACCG-1_V10B01-087_A1,1,0,2,0,0,3
GGGCGTTTACATTCAT-1_V10B01-087_A1,1,0,0,0,0,1
CCTCTACAAGGATTGG-1_V10B01-087_A1,0,0,2,0,0,2
AGTGACTGTGACACAA-1_V10B01-087_A1,5,0,0,0,1,6
AGCCCTCCCTGGTGGC-1_V10B01-087_A1,2,1,0,0,1,4
CGGTTGAGTATCCTTC-1_V10B01-087_A1,0,0,1,0,3,4
CATTATCCCATTAACG-1_V10B01-087_A1,2,0,0,0,0,2
AATGTGCTAATCTGAG-1_V10B01-087_A1,1,1,1,0,0,3
CTTAGTTGAGGAATCG-1_V10B01-087_A1,0,0,2,0,1,3
CTTCTGGGCGTACCTA-1_V10B01-087_A1,2,1,0,0,0,3
AGTCAAATGATGTGAT-1_V10B01-087_A1,2,0,0,0,1,3
TGAACAAGCAGGGACT-1_V10B01-087_A1,1,0,0,0,1,2
AATACCGGAGGGCTGT-1_V10B01-087_A1,0,0,0,0,0,0
GTTTGGTGATCGGTGC-1_V10B01-087_A1,2,0,0,0,0,2
GACTGCTGGTGAGAAA-1_V10B01-087_A1,1,1,0,0,1,3
CGATCCTCGCAACATA-1_V10B01-087_A1,1,0,0,0,0,1
CCAACCTTATGTAACT-1_V10B01-087_A1,1,0,0,0,0,1
CGTGGTACCCAAAGGC-1_V10B01-087_A1,2,1,0,0,0,3
AACCCGACAACCCGTG-1_V10B01-087_A1,0,0,4,0,1,5
TATGTAAAGTGCTTAA-1_V10B01-087_A1,2,1,0,0,1,4
GCAAGTGTAAAGCATG-1_V10B01-087_A1,2,0,1,0,1,4
GTAACTGCCCAAGGAG-1_V10B01-087_A1,1,1,0,0,1,3
GGTGCATAAATGATTA-1_V10B01-087_A1,4,0,1,0,1,6
TAGTCCCGGAGACCAC-1_V10B01-087_A1,0,0,0,0,0,0
CGGCCAGAGCGACCAT-1_V10B01-087_A1,2,0,1,0,0,3
TGAATGAGTGTTTCCC-1_V10B01-087_A1,1,1,0,0,0,2
TTCACTTCCTAGAACG-1_V10B01-087_A1,2,0,4,0,2,8
CGCTTAGTATTGATAC-1_V10B01-087_A1,0,1,0,0,1,2
AACGCGACCTTGGGCG-1_V10B01-087_A1,1,1,0,0,0,2
GTGCACCAGCTTCAAC-1_V10B01-087_A1,2,1,4,0,1,8
TTCTATTAAACGCAGC-1_V10B01-087_A1,5,2,0,0,0,7
TGGCAAGCACAAGTCG-1_V10B01-087_A1,2,0,1,0,6,9
ATCTGCTGTTATCGCC-1_V10B01-087_A1,1,1,2,0,1,5
AATTCCAAGCATGTAC-1_V10B01-087_A1,0,1,0,0,0,1
AAACGGTTGCGAACTG-1_V10B01-087_A1,3,1,0,0,1,5
GAAGGAGTCGAGTGCG-1_V10B01-087_A1,1,0,0,0,1,2
GGCAAGCCCATAGTGG-1_V10B01-087_A1,3,1,0,0,0,4
TGACCAAATCTTAAAC-1_V10B01-087_A1,1,0,0,0,1,2
TTCGGTACTGTAGAGG-1_V10B01-087_A1,2,0,0,0,2,4
ATGTACGATGACGTCG-1_V10B01-087_A1,0,2,0,0,0,2
ATCTAGCTTGTGAGGG-1_V10B01-087_A1,0,1,0,0,1,2
AGCGGGTCTGACACTC-1_V10B01-087_A1,1,0,0,0,1,2
GAGGTACGCGTGTCCC-1_V10B01-087_A1,1,0,0,0,2,3
GCACTGCCTACCTTTA-1_V10B01-087_A1,1,1,0,0,0,2
GGAGCGAGGCCTACTT-1_V10B01-087_A1,0,1,0,0,0,1
AAACTCGGTTCGCAAT-1_V10B01-087_A1,3,2,0,0,0,5
GGCGCTTCATTCCCTG-1_V10B01-087_A1,0,1,1,0,1,3
TGCTCGGTGGGTCACC-1_V10B01-087_A1,3,0,1,0,0,4
AAGCGCAGGGCTTTGA-1_V10B01-087_A1,3,0,2,0,1,6
GACCTTCCACGTCTAC-1_V10B01-087_A1,1,0,0,0,0,1
GTTAGCCCATGACATC-1_V10B01-087_A1,1,0,1,0,1,3
AATTCGATTCGAGGAT-1_V10B01-087_A1,2,1,0,0,1,4
AGTCTTTAAAGTGTCC-1_V10B01-087_A1,1,0,1,0,3,5
GACTAGGCCGTTAGGT-1_V10B01-087_A1,8,0,0,0,0,8
TCCAAGCCTAGACACA-1_V10B01-087_A1,1,1,0,0,1,3
GATTGGGAAAGGTTGT-1_V10B01-087_A1,0,0,0,0,1,1
GATGAGGAACCTTCGG-1_V10B01-087_A1,0,0,0,0,0,0
TGAATACCGACGCGTA-1_V10B01-087_A1,3,5,0,1,0,9
AATCGTGAGCCGAGCA-1_V10B01-087_A1,4,6,0,0,0,10
GCGAAGAATCTGACGG-1_V10B01-087_A1,1,0,0,0,0,1
GAACAACTGGGATGAA-1_V10B01-087_A1,4,0,0,0,0,4
TCGCCGACATATTCGC-1_V10B01-087_A1,0,2,2,0,0,4
CGTAGAGAGTAATTAT-1_V10B01-087_A1,3,2,1,0,1,7
CGATAGTCGTACTGCA-1_V10B01-087_A1,4,0,1,0,1,6
CGCATGCCGAATGCGT-1_V10B01-087_A1,3,0,0,0,0,3
CTCTAGCCCTCGGAAA-1_V10B01-087_A1,0,0,1,0,2,3
TCCAACTCAGCTATCT-1_V10B01-087_A1,3,0,1,0,0,4
GTCTAGTGAGCCGCTT-1_V10B01-087_A1,2,0,0,0,2,4
TACCGAATAATTGTAA-1_V10B01-087_A1,1,0,0,0,1,2
ATATAACACGGGCGCA-1_V10B01-087_A1,0,0,1,0,2,3
GCATGCTAATAACGAT-1_V10B01-087_A1,3,2,1,0,0,6
TCCGGGCTTGACGGGA-1_V10B01-087_A1,1,0,1,0,1,3
ATTATTCAGAGTCACT-1_V10B01-087_A1,1,0,0,0,1,2
TAGCAGTATGACTAAA-1_V10B01-087_A1,1,0,0,0,0,1
TATGAAGAATTAAGGT-1_V10B01-087_A1,0,2,2,0,1,5
CAAGGCCAGTGGTGCA-1_V10B01-087_A1,2,0,1,0,1,4
TGCGTACGGCTAATTG-1_V10B01-087_A1,0,0,0,0,1,1
CAGATAATGGGCGGGT-1_V10B01-087_A1,1,2,0,5,0,8
GAGAACGGTTCTGACT-1_V10B01-087_A1,0,1,1,0,0,2
CGCTTCGGTCTAAGAC-1_V10B01-087_A1,0,1,0,0,0,1
AGCATTACGAGGCAAG-1_V10B01-087_A1,0,0,0,0,0,0
AAGTTGTGATGTTATA-1_V10B01-087_A1,1,2,1,0,0,4
TACTTAAACATGTACA-1_V10B01-087_A1,0,2,2,0,0,4
ATTACGGGCTACGGTT-1_V10B01-087_A1,0,0,0,0,0,0
GCAAACGTAAGCGACC-1_V10B01-087_A1,1,0,0,2,0,3
TTCGGACTGGGCATGG-1_V10B01-087_A1,2,0,0,3,0,5
GGGCCATTCGTGCTGG-1_V10B01-087_A1,3,0,0,3,0,6
GAGTTGTCACCAGTCT-1_V10B01-087_A1,1,0,1,0,0,2
AGTAATTTGCAAGCGT-1_V10B01-087_A1,0,0,0,0,0,0
GTGGCCGGTTTCTCGG-1_V10B01-087_A1,4,0,0,0,0,4
ATCTTAGGGCATTAAT-1_V10B01-087_A1,1,3,0,0,0,4
CTACATATCGCGGGAC-1_V10B01-087_A1,2,0,1,0,0,3
ATGGTATTTACTGATT-1_V10B01-087_A1,0,2,0,0,0,2
CCGTCAACCTCTGGCG-1_V10B01-087_A1,6,0,0,0,0,6
GCTTCGACGTTCAATC-1_V10B01-087_A1,5,0,0,0,0,5
GACCGATTAAATATGT-1_V10B01-087_A1,0,1,0,0,1,2
GTCGAATTTGGGCGCT-1_V10B01-087_A1,2,0,1,0,1,4
TCACGGCCCAAGAGAG-1_V10B01-087_A1,3,0,0,0,0,3
CTACGATCCTATCCTA-1_V10B01-087_A1,3,7,0,1,0,11
TGCAGTGGTAGGGAAC-1_V10B01-087_A1,0,0,0,0,1,1
TTGCCTAATCCAAAGT-1_V10B01-087_A1,2,0,0,0,0,2
AGCGAGACGTGAAGGC-1_V10B01-087_A1,5,1,0,0,0,6
TTCTACCTCAATCGGT-1_V10B01-087_A1,3,0,0,0,0,3
TACGCTGCTGTGTTAA-1_V10B01-087_A1,2,0,0,0,0,2
TAGTCCTGCACTAAGC-1_V10B01-087_A1,0,0,0,0,4,4
AGCACACGTTTAGACT-1_V10B01-087_A1,0,0,0,0,0,0
GTTCGACAATTGTATA-1_V10B01-087_A1,2,1,1,0,0,4
CCATGTTCATCTATAT-1_V10B01-087_A1,0,0,0,0,1,1
CCCTCGATAATACACA-1_V10B01-087_A1,1,0,0,0,0,1
ACTGCCCGCCATTCTC-1_V10B01-087_A1,2,1,0,0,0,3
CTATATCCAGCCTGGC-1_V10B01-087_A1,0,0,0,0,0,0
CGCACGTCTGTTTATG-1_V10B01-087_A1,0,0,0,0,1,1
AATCAGGTTTCATTTA-1_V10B01-087_A1,1,0,1,0,1,3
AGAGAAACACCAGAAA-1_V10B01-087_A1,4,2,4,0,0,10
ACCCGATTGGTTCCGA-1_V10B01-087_A1,4,3,0,0,0,7
TACCAGGAATCCCGTC-1_V10B01-087_A1,1,2,0,0,0,3
AAGTGCTTCTCTATTG-1_V10B01-087_A1,1,0,0,0,0,1
TGCATGTGACCCATAG-1_V10B01-087_A1,2,1,0,0,0,3
TAGATTCAAAGTGCGG-1_V10B01-087_A1,2,1,0,0,0,3
AGGGTCAGAGCACTCG-1_V10B01-087_A1,1,0,1,0,1,3
GTGAGATAACCTTATA-1_V10B01-087_A1,0,1,0,0,0,1
GTGTCAGTGTACGTGG-1_V10B01-087_A1,4,8,0,0,0,12
CTGTAGTGAGGATCGA-1_V10B01-087_A1,4,1,0,0,0,5
GATAGTGCGAGTAAGT-1_V10B01-087_A1,2,0,2,0,2,6
AGGGTTCAGACGGTCC-1_V10B01-087_A1,2,0,0,0,0,2
GGACTCGACAGCGCAT-1_V10B01-087_A1,1,1,0,0,0,2
CACTCTCAAGCATCGA-1_V10B01-087_A1,2,0,0,0,1,3
GAGCGGAATGCGGTGT-1_V10B01-087_A1,4,1,1,0,1,7
CAGTTCGAGGACCCGA-1_V10B01-087_A1,3,0,1,0,0,4
CGTAACTTCGACACTT-1_V10B01-087_A1,0,0,0,0,0,0
TGATCACCACACTGAC-1_V10B01-087_A1,0,0,0,0,3,3
CATACTTCTTTCTCCG-1_V10B01-087_A1,1,0,0,0,0,1
CAAGTAAGTGATAGAC-1_V10B01-087_A1,1,0,0,0,0,1
AGCCCGCAACAAGCAG-1_V10B01-087_A1,1,2,0,0,0,3
GCTCCATGCAAAGCAA-1_V10B01-087_A1,2,0,5,0,1,8
TCGTACCGACGTCAAG-1_V10B01-087_A1,2,0,2,0,0,4
ATTATCGGAATGTACG-1_V10B01-087_A1,1,0,1,0,0,2
ACCTACTATAAATCTA-1_V10B01-087_A1,0,1,0,0,1,2
TATCCTATCAACTGGT-1_V10B01-087_A1,1,2,2,0,0,5
GCGCGGTCTAGTAACT-1_V10B01-087_A1,1,0,1,0,2,4
CCTTCGTATAGAATCC-1_V10B01-087_A1,4,2,0,0,0,6
TGGGCGATACAATAAG-1_V10B01-087_A1,0,0,0,0,0,0
TGACATGTAACGTGAC-1_V10B01-087_A1,3,0,0,0,0,3
TTGGGAAGACGAGCCG-1_V10B01-087_A1,1,0,0,0,2,3
GGTGTAAATCGATTGT-1_V10B01-087_A1,0,0,0,0,2,2
GAACTGTGGAGAGACA-1_V10B01-087_A1,2,0,1,0,1,4
TCCACATCGTATATTG-1_V10B01-087_A1,3,0,0,0,1,4
CCTATGGTCAAAGCTG-1_V10B01-087_A1,1,3,1,0,0,5
TCCTTGTCCTTTAATT-1_V10B01-087_A1,3,0,0,0,1,4
AAGTTTATGGGCCCAA-1_V10B01-087_A1,1,0,0,0,1,2
GTCCGGGTTCACATTA-1_V10B01-087_A1,2,0,0,0,2,4
ATGTAGCGCGCGTAGG-1_V10B01-087_A1,1,0,0,0,0,1
TACGGAAGCCAAACCA-1_V10B01-087_A1,4,0,0,0,1,5
GCCCTGAGGATGGGCT-1_V10B01-087_A1,3,1,0,0,1,5
CGGGCGATGGATCACG-1_V10B01-087_A1,2,0,0,0,0,2
TGCGGACTTGACTCCG-1_V10B01-087_A1,0,0,0,0,1,1
TAATACTAGAACAGAC-1_V10B01-087_A1,2,0,1,0,0,3
TCAAATTGTTGTGCCG-1_V10B01-087_A1,3,0,0,0,0,3
GGGCAGTCAACGCCAA-1_V10B01-087_A1,1,1,0,0,0,2
TCGCTGCCAATGCTGT-1_V10B01-087_A1,1,0,0,0,0,1
TACGTGGGCCCAGGGC-1_V10B01-087_A1,1,0,1,0,0,2
GCCTACGTTCTGTGCA-1_V10B01-087_A1,1,1,3,0,0,5
TTGCGTGTGTAGGCAT-1_V10B01-087_A1,0,1,1,0,2,4
TCCTAAAGATTCAGAC-1_V10B01-087_A1,1,2,1,0,0,4
TGGGTGCACAAGCCAT-1_V10B01-087_A1,1,0,0,0,0,1
GGGAGCGACCGTAGTG-1_V10B01-087_A1,6,1,0,0,0,7
CATAGAGGAGATACTA-1_V10B01-087_A1,0,0,2,0,0,2
CTTCGATTGCGCAAGC-1_V10B01-087_A1,0,0,0,0,0,0
GTGCCTGAGACCAAAC-1_V10B01-087_A1,1,1,2,0,1,5
TCATCCTCAGCTGCTT-1_V10B01-087_A1,0,0,1,0,1,2
TGCAACTACTGGTTGA-1_V10B01-087_A1,1,3,0,0,0,4
ATGTTGATTAGAGACT-1_V10B01-087_A1,4,1,1,0,0,6
GTTTCTAGAGGCGCGG-1_V10B01-087_A1,4,1,0,0,0,5
TACAAGGGCTTCTTTA-1_V10B01-087_A1,0,3,2,0,2,7
ACAGGCACGGATCCTT-1_V10B01-087_A1,0,1,0,0,2,3
CCCAAGTCATTACACT-1_V10B01-087_A1,1,0,1,0,1,3
ACTCTGACCTAATAGA-1_V10B01-087_A1,1,0,0,0,1,2
GGATGGCTTGAAGTAT-1_V10B01-087_A1,0,1,1,0,2,4
ACCCTCCCGTCAGGGC-1_V10B01-087_A1,0,0,1,0,1,2
AGCTTCTTCTCGAGCA-1_V10B01-087_A1,1,0,1,0,2,4
TGGGTGTAATAGATTT-1_V10B01-087_A1,0,2,1,0,1,4
TTGCCTTCTCGCCGGG-1_V10B01-087_A1,0,0,0,0,0,0
GCTGAAGGGTTCTTGG-1_V10B01-087_A1,0,0,0,1,0,1
TAATTGCGCTGATTAC-1_V10B01-087_A1,0,0,0,0,0,0
TCGCGCGTTTACATGA-1_V10B01-087_A1,2,0,0,0,0,2
TAACTGAAATACGCCT-1_V10B01-087_A1,0,0,0,0,0,0
CCTGTCGTGTATGAAG-1_V10B01-087_A1,1,0,1,0,0,2
CGGGAACGCCCTGCAT-1_V10B01-087_A1,0,0,0,5,0,5
AGTTGCGGTCCTCAAC-1_V10B01-087_A1,1,0,0,2,0,3
GGGTCCTTGGAAGAAG-1_V10B01-087_A1,1,0,0,0,0,1
CGGGAAGTACCGTGGC-1_V10B01-087_A1,0,0,0,0,0,0
ACGGTCACCGAGAACA-1_V10B01-087_A1,0,0,0,0,0,0
TAGACTCAGTTGGCCT-1_V10B01-087_A1,3,0,0,0,0,3
CCTTCCGCAACGCTGC-1_V10B01-087_A1,3,0,0,0,0,3
CAGTGTTAATCTCTCA-1_V10B01-087_A1,0,0,0,0,0,0
CAGGCCAGTACCACCT-1_V10B01-087_A1,3,1,0,0,0,4
GATCGCTGTGGTGCGT-1_V10B01-087_A1,1,0,0,0,0,1
GTATCTCGGGCGCTTT-1_V10B01-087_A1,1,0,0,0,0,1
CCGGGCTAAGAATTTC-1_V10B01-087_A1,8,3,0,0,0,11
CTTCACGCCCTGGTAC-1_V10B01-087_A1,3,0,0,0,0,3
CGGATGAATGCTGTGA-1_V10B01-087_A1,3,0,0,0,0,3
CTCTGCAGGCATTCTT-1_V10B01-087_A1,3,0,1,0,0,4
TCAAAGTCACGGCGTC-1_V10B01-087_A1,1,0,0,0,0,1
TGGGTTTCGGGCGTAC-1_V10B01-087_A1,0,0,0,0,0,0
TGCTATGGCAAAGGGA-1_V10B01-087_A1,0,0,1,0,0,1
TTCACGGTCGTCACGT-1_V10B01-087_A1,2,0,1,0,0,3
CGTAAAGCAAGAAATC-1_V10B01-087_A1,3,1,0,0,1,5
CTGATCCCTTTATGCA-1_V10B01-087_A1,3,2,0,0,0,5
GAGTATACCCTAATCA-1_V10B01-087_A1,3,0,1,0,0,4
CCACGGCAGGTGTAGG-1_V10B01-087_A1,1,1,0,0,0,2
ACGTACTTTGGCACGG-1_V10B01-087_A1,0,0,1,0,0,1
CCTGAGAATAAATGCA-1_V10B01-087_A1,2,0,1,0,0,3
TTGATGCCGCTCGTCG-1_V10B01-087_A1,0,3,1,0,1,5
GCCAGGAAAGAACACT-1_V10B01-087_A1,1,1,0,0,1,3
TCCGACCGCTAATCAA-1_V10B01-087_A1,1,1,1,0,1,4
TATATCAAAGTGATCT-1_V10B01-087_A1,4,0,0,0,0,4
CCTCGGTTTCCTTGCC-1_V10B01-087_A1,1,0,0,0,0,1
TAAATTTAGTAACACC-1_V10B01-087_A1,1,0,0,0,0,1
CTCGTTACGGCTACCA-1_V10B01-087_A1,3,0,1,0,0,4
GCCGTCGGTTTCGGGC-1_V10B01-087_A1,1,1,1,0,1,4
GTTCCGTCCGCCTGCA-1_V10B01-087_A1,4,1,0,0,0,5
CTAGGGATAGGGACAA-1_V10B01-087_A1,4,0,3,0,0,7
GTCCAGGCACGTGTGC-1_V10B01-087_A1,2,0,0,0,1,3
GAGGAATATCTCTTTG-1_V10B01-087_A1,2,0,0,0,1,3
CGTTCAAGGAAACGGA-1_V10B01-087_A1,2,0,2,0,1,5
GTGGGAACAAACCGGG-1_V10B01-087_A1,1,0,0,0,0,1
GGGCACGTAGTACTGT-1_V10B01-087_A1,3,0,1,0,0,4
ACTACAAAGAGAGGTG-1_V10B01-087_A1,1,0,0,0,1,2
GGTGTAGGTAAGTAAA-1_V10B01-087_A1,2,1,1,0,2,6
CCTGTTCAACCTCGGG-1_V10B01-087_A1,1,0,0,0,0,1
TGAGGTGTGTGGCGGA-1_V10B01-087_A1,1,0,2,0,0,3
ATTGTCTGTTTCATGT-1_V10B01-087_A1,1,2,0,0,0,3
GCCGGTCGTATCTCTC-1_V10B01-087_A1,0,0,1,0,0,1
ATATGGGATAGCAACT-1_V10B01-087_A1,1,1,2,0,1,5
GATAGAACCCGCTAGG-1_V10B01-087_A1,2,1,1,0,1,5
ATCCCATTTCCGTGGG-1_V10B01-087_A1,1,1,3,0,0,5
GATGCTACCTTCGATG-1_V10B01-087_A1,2,0,0,0,1,3
TGCAAAGTTCGTCTGT-1_V10B01-087_A1,3,0,0,0,0,3
GTTCAGTCGCCAAATG-1_V10B01-087_A1,1,0,0,0,0,1
GTCTCCGCCTCAATAC-1_V10B01-087_A1,1,0,2,0,0,3
AGTAGAAGGCGCCTCA-1_V10B01-087_A1,1,1,0,0,0,2
GTTGTAGATTTATGAG-1_V10B01-087_A1,4,2,1,0,0,7
CTATTTGCTTGGAGGA-1_V10B01-087_A1,2,0,0,0,0,2
AGCCATATAGTATGTG-1_V10B01-087_A1,0,3,1,0,1,5
TGTTCCGGCCTGAGCT-1_V10B01-087_A1,2,0,0,0,0,2
TGCCGTGGGACCCAAT-1_V10B01-087_A1,1,1,0,0,1,3
TTGCAAGAAGACTCCT-1_V10B01-087_A1,1,1,0,0,1,3
CCGCTCCAGGGCGATC-1_V10B01-087_A1,1,1,0,0,1,3
CAAACCCTCCGGCGGG-1_V10B01-087_A1,2,0,0,0,1,3
CGGACCTTTACGTCCC-1_V10B01-087_A1,0,0,0,0,0,0
ACGTAGGAGAGTCGCT-1_V10B01-087_A1,0,0,0,0,1,1
CTGCGACCTCGCCGAA-1_V10B01-087_A1,2,0,0,0,2,4
GGCCCAGCTGGTTTGC-1_V10B01-087_A1,2,0,0,0,0,2
GGATTAATCATGGACC-1_V10B01-087_A1,3,1,1,0,0,5
GAGATGGCTTTAATCA-1_V10B01-087_A1,1,0,0,0,0,1
AGTACAGAAGCTTATA-1_V10B01-087_A1,2,4,0,0,1,7
GCGGCTTTAGCAAGTT-1_V10B01-087_A1,0,0,1,0,2,3
ACCGAGTCTCCTTATT-1_V10B01-087_A1,3,1,1,0,1,6
GACCACACTTCCCTTT-1_V10B01-087_A1,5,0,3,0,0,8
TGTAGCCAATTCCGTT-1_V10B01-087_A1,0,1,1,0,1,3
CTCGTCTGTGCCTTCG-1_V10B01-087_A1,0,0,0,0,0,0
GGACTCTTTGACTAAG-1_V10B01-087_A1,0,1,0,0,2,3
TCATCGACGACCGTCG-1_V10B01-087_A1,2,1,0,0,0,3
TACTACGTGCAATGCG-1_V10B01-087_A1,0,0,0,0,1,1
CCCTACTTGAACAATG-1_V10B01-087_A1,4,1,0,0,1,6
GCAGCTGTCAACGCAT-1_V10B01-087_A1,1,1,0,0,0,2
ATCTACCATCTGCTCC-1_V10B01-087_A1,0,0,0,0,2,2
TCTCAAATCAATCGGG-1_V10B01-087_A1,1,1,0,0,3,5
ACTCCGGCCGACCACT-1_V10B01-087_A1,1,1,3,0,0,5
TACACCTCTTCGAATC-1_V10B01-087_A1,0,2,2,0,1,5
GTGGCTGTTTCTGTTC-1_V10B01-087_A1,4,3,1,0,2,10
ACGACTCTAGGGCCGA-1_V10B01-087_A1,0,0,0,0,0,0
TCGTTTACGCGACCCT-1_V10B01-087_A1,4,0,1,0,1,6
GACACTTCCAATTACC-1_V10B01-087_A1,2,2,0,0,0,4
TGACAGAAATCTTGCT-1_V10B01-087_A1,0,0,0,3,0,3
TAGCCATGATTGCCTA-1_V10B01-087_A1,0,0,0,3,0,3
CGAAGCCACAGCATGG-1_V10B01-087_A1,0,0,0,1,0,1
ACCCGTAGCAGAGAAT-1_V10B01-087_A1,0,0,0,1,0,1
AGCTTGATCAGGGTAG-1_V10B01-087_A1,1,0,0,0,0,1
CTATAAGTAGGGTTTG-1_V10B01-087_A1,4,0,0,0,0,4
TATAGTTAGGTGTACT-1_V10B01-087_A1,1,0,0,2,0,3
TACGCTGATAGTTGTA-1_V10B01-087_A1,0,0,0,0,0,0
TTCTCAATTGCTACAA-1_V10B01-087_A1,2,0,0,0,0,2
GTTGCCCTAACGGGTG-1_V10B01-087_A1,1,0,1,0,0,2
GACATTTCGCCCAGCC-1_V10B01-087_A1,2,0,0,0,0,2
GTAACTACGTAGACCT-1_V10B01-087_A1,1,0,0,0,0,1
CCAGTGTACAGACCGA-1_V10B01-087_A1,3,0,1,0,0,4
GCCCGATGCCCAGTTC-1_V10B01-087_A1,1,0,0,0,0,1
CGAACCTCTTTCCTAG-1_V10B01-087_A1,6,2,0,0,0,8
CATGCACATGAGAGGC-1_V10B01-087_A1,2,2,0,0,0,4
CCAAATCAAAGGGCAA-1_V10B01-087_A1,1,1,1,0,0,3
GTAGTTTAAGCACACG-1_V10B01-087_A1,4,0,0,0,0,4
TAAGTGAATAGTCTAC-1_V10B01-087_A1,1,0,0,0,1,2
GGTCCACGTCTATTTG-1_V10B01-087_A1,2,1,1,0,0,4
CCCTCAGATCGAGAAC-1_V10B01-087_A1,2,0,0,0,0,2
ACATTCGCGCGGAATA-1_V10B01-087_A1,0,1,0,0,0,1
CTATGAACACCTTGCC-1_V10B01-087_A1,1,1,0,0,1,3
CGAATGGTAGGTCGTC-1_V10B01-087_A1,1,0,0,0,1,2
TCGACATAGCGTAGCG-1_V10B01-087_A1,2,0,0,0,0,2
GACGTTGCTCGGCGGC-1_V10B01-087_A1,3,0,0,0,1,4
CTCGAGGCAAGTTTCA-1_V10B01-087_A1,3,0,1,0,0,4
GCTGGGAGCGCGTCAA-1_V10B01-087_A1,0,0,0,0,0,0
GACGATATCACTGGGT-1_V10B01-087_A1,5,0,0,0,0,5
CAGCTCTGGGCTCACT-1_V10B01-087_A1,3,0,0,0,0,3
TAGTCTGCGGCACATT-1_V10B01-087_A1,1,0,1,0,1,3
TGGTCGATATACCTCT-1_V10B01-087_A1,3,0,0,0,1,4
TTCAGTTCAAGAGGAG-1_V10B01-087_A1,0,2,0,0,2,4
GTCTGTAGGTTGAACA-1_V10B01-087_A1,3,1,1,0,0,5
GAGAGTCTCGGGAGAG-1_V10B01-087_A1,0,1,1,0,0,2
TTGTTTGTATTACACG-1_V10B01-087_A1,1,0,1,0,1,3
GCACAGCACGGGCCGA-1_V10B01-087_A1,0,2,0,0,0,2
AAACAGTGTTCCTGGG-1_V10B01-087_A1,3,0,0,0,1,4
TGGAGAATAATCGTCC-1_V10B01-087_A1,2,1,0,0,0,3
CGCCGCGTTCTGAACG-1_V10B01-087_A1,0,1,0,0,1,2
CATGCGTTGAGAGGAG-1_V10B01-087_A1,3,2,0,0,1,6
TACGCTCCTAGAACTG-1_V10B01-087_A1,0,0,1,0,1,2
CCTTGTGAACGTGGTT-1_V10B01-087_A1,5,0,1,0,0,6
TTAAAGGCGATGCTCG-1_V10B01-087_A1,1,0,0,0,2,3
TAAAGTGCACGTCTCG-1_V10B01-087_A1,3,1,2,0,0,6
TGTCCGCAAACAATTC-1_V10B01-087_A1,2,0,0,0,0,2
AGGCCTATCATACCAA-1_V10B01-087_A1,0,0,0,0,0,0
ACTGGGATGCCAGTGC-1_V10B01-087_A1,2,0,0,0,0,2
CGATCCACCATTGTTG-1_V10B01-087_A1,2,0,3,0,0,5
GGGCATGCATGTCGAG-1_V10B01-087_A1,2,1,2,0,0,5
TCCAGGCAGGACGATC-1_V10B01-087_A1,1,0,2,0,1,4
CAATGACCCTTAATTT-1_V10B01-087_A1,2,0,2,0,1,5
ATCAAGATCCCAGGAC-1_V10B01-087_A1,0,0,0,0,1,1
CTCAGAGCTAATGTCG-1_V10B01-087_A1,2,0,0,0,0,2
CTGCGATTTCGAGATT-1_V10B01-087_A1,2,1,0,0,0,3
ATGGTATTGGGAACCG-1_V10B01-087_A1,1,0,1,0,0,2
TAGGTTCTGCTGAGAA-1_V10B01-087_A1,0,0,0,0,0,0
GCCTGTCCCGGTGCAT-1_V10B01-087_A1,1,0,0,0,2,3
GGCCTGCTCTGATGTT-1_V10B01-087_A1,3,0,0,0,0,3
TAGAGGGAGTTTATCT-1_V10B01-087_A1,6,1,0,0,0,7
CTCTACATCCTGCGTG-1_V10B01-087_A1,3,2,0,0,0,5
ACACATTTCCGTAGAC-1_V10B01-087_A1,1,1,0,0,1,3
TGGGTGTTAAGTAGAA-1_V10B01-087_A1,1,2,0,0,0,3
GAGCTCAACATGAGCG-1_V10B01-087_A1,3,1,2,0,4,10
GCACACAGCTATTACC-1_V10B01-087_A1,3,0,0,0,2,5
GCGACGGTAGTCTCCT-1_V10B01-087_A1,2,0,1,0,3,6
GTATCAAGGTACTTCC-1_V10B01-087_A1,1,0,1,0,1,3
GGAAAGGGAATTGAGC-1_V10B01-087_A1,0,0,0,0,1,1
TACACAGCCGTGGTGC-1_V10B01-087_A1,2,2,3,0,0,7
CGGTTGGGCAGGGTCC-1_V10B01-087_A1,1,0,2,0,5,8
GCACGCCGATTCCCGC-1_V10B01-087_A1,1,0,0,0,1,2
CGCTTTCCGCCAAGGT-1_V10B01-087_A1,0,0,2,0,1,3
TGCCCGATAGTTAGAA-1_V10B01-087_A1,3,0,3,0,2,8
TCAGAACGGCGGTAAT-1_V10B01-087_A1,3,1,0,0,1,5
CCACTCAGATCCGCAA-1_V10B01-087_A1,2,0,0,0,0,2
GAAGGGTCATTAAGAC-1_V10B01-087_A1,1,0,0,0,3,4
GCGGTCTTGCTTTCAC-1_V10B01-087_A1,1,1,1,0,1,4
GGAAGGACACCGTATA-1_V10B01-087_A1,1,0,0,0,0,1
CGCGGGAATTCCTTTC-1_V10B01-087_A1,2,0,0,0,1,3
TCTATCCGATTGCACA-1_V10B01-087_A1,0,5,0,0,1,6
TACTCGTTTGAATCAA-1_V10B01-087_A1,1,1,0,0,0,2
GTCTGCCGACTCGACG-1_V10B01-087_A1,0,0,0,0,0,0
TACGGGTAATAACATA-1_V10B01-087_A1,0,0,1,0,0,1
CGTGCACACCACTGTA-1_V10B01-087_A1,0,0,0,0,0,0
CGCCAGTAGTACCTTG-1_V10B01-087_A1,1,0,0,1,0,2
CTCCCTTGTATCAAGG-1_V10B01-087_A1,0,0,0,0,0,0
ACTTTATACACCACTT-1_V10B01-087_A1,4,0,1,0,0,5
AGATCTGGAGAGGATA-1_V10B01-087_A1,0,0,0,0,0,0
TCATCCATCTGATCAC-1_V10B01-087_A1,1,0,0,0,0,1
AGAACACGGCGATGGT-1_V10B01-087_A1,5,1,0,0,0,6
CCGCTCCGGATAAGCT-1_V10B01-087_A1,1,1,0,0,0,2
TGGTCGGGTACAGGGC-1_V10B01-087_A1,1,0,0,0,0,1
ACGGACGCAGCGACAA-1_V10B01-087_A1,0,0,0,0,0,0
ACATGCTTACGGCAGC-1_V10B01-087_A1,2,0,0,0,0,2
CAGGGAGATAGGCCAG-1_V10B01-087_A1,3,0,0,0,0,3
TCGCCACCCGGATTAC-1_V10B01-087_A1,1,0,0,0,0,1
TCTTGGTCAATGATAC-1_V10B01-087_A1,4,1,0,0,0,5
CATAGGGACACTTGTG-1_V10B01-087_A1,5,0,0,0,0,5
CACGAGCAAACCAGAC-1_V10B01-087_A1,2,0,0,0,0,2
GGGATATTGATCGCCA-1_V10B01-087_A1,7,0,0,0,0,7
TAATGTCGGTTCATGG-1_V10B01-087_A1,5,0,0,0,0,5
CGATTTGTCATTAATG-1_V10B01-087_A1,3,1,1,0,0,5
TTAAGATACCCAGAGA-1_V10B01-087_A1,4,2,0,0,0,6
CGACCGTTGGTATTCG-1_V10B01-087_A1,3,0,1,0,1,5
ACTACCATCCGAGGGC-1_V10B01-087_A1,0,0,0,0,0,0
TCTACGCACGATCTCC-1_V10B01-087_A1,2,1,0,0,1,4
AAGCCACTTGCAGGTA-1_V10B01-087_A1,5,0,0,0,0,5
ACGTTGTCGTTGAAAG-1_V10B01-087_A1,1,3,0,0,1,5
ACCGCTAGTCATTGGT-1_V10B01-087_A1,1,1,1,0,1,4
CATGAGTCCATCACGG-1_V10B01-087_A1,0,0,0,0,1,1
ATGTCTTGTTTGACTC-1_V10B01-087_A1,0,2,0,0,0,2
TCCCAAACATCCTCTA-1_V10B01-087_A1,1,0,0,0,0,1
CAACGCGATGAGCCAA-1_V10B01-087_A1,1,1,0,0,0,2
GACACCCAAAGACGCG-1_V10B01-087_A1,5,0,0,0,2,7
ACGTTCACTATGCCGC-1_V10B01-087_A1,3,0,0,0,0,3
ATGGACTGCTTAGTTG-1_V10B01-087_A1,0,0,0,0,0,0
CCATGGCAAACGCTCA-1_V10B01-087_A1,4,0,0,0,1,5
TTGTCTCGGCAAGATG-1_V10B01-087_A1,1,1,0,0,0,2
TTCGAACGAAACATGC-1_V10B01-087_A1,1,0,1,0,2,4
GGAAAGTCTTGATTGT-1_V10B01-087_A1,0,1,0,0,0,1
ATCATAGATCGACGAG-1_V10B01-087_A1,1,0,0,0,1,2
GATTAGAAACAAGCGT-1_V10B01-087_A1,2,0,1,0,1,4
GCTGCGAAGAATTATT-1_V10B01-087_A1,1,0,2,0,0,3
TTCCAGTGGGTTTCGT-1_V10B01-087_A1,2,1,0,0,0,3
GCTCATTGATCATATC-1_V10B01-087_A1,2,1,1,0,1,5
ATACGAGGTTTGTAAG-1_V10B01-087_A1,0,0,1,0,0,1
GTCTATACACGCATGG-1_V10B01-087_A1,0,0,0,0,1,1
GATTTGCGCTAACACC-1_V10B01-087_A1,2,0,0,0,2,4
TGGTGCCCTGCCTTAC-1_V10B01-087_A1,2,0,1,0,1,4
TCGAATCGCAGGGTAG-1_V10B01-087_A1,4,5,2,0,0,11
GGTAGGCCAATATCAC-1_V10B01-087_A1,0,0,0,0,0,0
CGTAAATAACAAAGGG-1_V10B01-087_A1,1,1,0,0,0,2
GACTCTAGAGTTCCAA-1_V10B01-087_A1,1,0,1,0,0,2
ACTTGTTACCGGATCA-1_V10B01-087_A1,2,0,0,0,0,2
GGCATTGAACATCTCA-1_V10B01-087_A1,3,0,0,0,0,3
AACCCGCTGTATTCCA-1_V10B01-087_A1,6,0,2,0,1,9
TAACAGGTTCCCTTAG-1_V10B01-087_A1,2,1,0,0,2,5
GTTCTTGTAACTCAAT-1_V10B01-087_A1,0,0,0,0,0,0
GATTCTGTTAATGAGT-1_V10B01-087_A1,1,0,0,0,0,1
GGACACCTCGGTGTTG-1_V10B01-087_A1,0,0,0,0,0,0
CGATCGAGAAGCACCA-1_V10B01-087_A1,2,0,2,0,1,5
CTGCTCTGACGGCAAA-1_V10B01-087_A1,0,0,0,0,3,3
CCCAGGAAGAATTCGA-1_V10B01-087_A1,1,0,0,0,1,2
TGTCGTGGGTATAGGC-1_V10B01-087_A1,1,0,1,0,1,3
ATATGTCTAGAGCGTG-1_V10B01-087_A1,4,1,0,0,0,5
GCGGGCAGACGGGTGA-1_V10B01-087_A1,2,0,0,0,0,2
CGAAGATCAGTTTCAT-1_V10B01-087_A1,3,0,0,0,0,3
ACGCCACTCGAAACAG-1_V10B01-087_A1,2,1,0,0,1,4
CTTAGATGTTTCATCC-1_V10B01-087_A1,3,0,0,0,3,6
GCGAATGGACTAGCGA-1_V10B01-087_A1,4,0,3,0,0,7
TAAATTGTGGGTAAAG-1_V10B01-087_A1,4,0,3,0,1,8
ATTTATACTGGTAAAG-1_V10B01-087_A1,1,0,0,0,0,1
GCGTCGTAACATGGTC-1_V10B01-087_A1,5,0,1,0,0,6
CGGTATGGGCACTCTG-1_V10B01-087_A1,2,2,0,0,0,4
CTATCACAACGCTGGA-1_V10B01-087_A1,1,0,2,0,4,7
ACCACACGGTTGATGG-1_V10B01-087_A1,1,0,2,0,2,5
TCAGCGCACGCCGTTT-1_V10B01-087_A1,0,0,0,0,2,2
AATGTTAAGACCCTGA-1_V10B01-087_A1,0,0,0,0,1,1
CTTACATAGATTTCTT-1_V10B01-087_A1,0,0,4,0,0,4
AGCAGTCGAAGCATGC-1_V10B01-087_A1,1,3,0,0,1,5
CAACGAGCTTATTATG-1_V10B01-087_A1,0,0,0,0,0,0
GATCCAACCTTTAAAC-1_V10B01-087_A1,0,0,0,0,0,0
TTGTGGAGACAGCCGG-1_V10B01-087_A1,0,0,0,0,0,0
AGATAATCACACCTAT-1_V10B01-087_A1,4,0,0,0,0,4
GGTTAGGGATGCTAAT-1_V10B01-087_A1,2,0,0,0,0,2
TCATGAAGCGCTGCAT-1_V10B01-087_A1,1,0,0,0,0,1
CCAGGCGAGATGGTCT-1_V10B01-087_A1,4,0,0,0,0,4
CGACTTGCCGGGAAAT-1_V10B01-087_A1,4,2,0,0,0,6
GTGCCAAACGTTTCGA-1_V10B01-087_A1,0,1,1,0,1,3
TGCTCAAAGGATGCAC-1_V10B01-087_A1,1,0,0,0,0,1
GCCTCAGGTACCGGTC-1_V10B01-087_A1,1,0,0,0,0,1
ACAAGTAATTGTAAGG-1_V10B01-087_A1,1,0,0,0,0,1
TTAGAGTATTGTCGAG-1_V10B01-087_A1,4,0,1,0,0,5
GTCATCCCAAACTCAC-1_V10B01-087_A1,3,0,0,0,0,3
CTCCTAGTAATCGTGA-1_V10B01-087_A1,1,0,0,0,0,1
GGAAACAGAGCTTGGG-1_V10B01-087_A1,0,0,0,0,0,0
TTAGCCATAGGGCTCG-1_V10B01-087_A1,0,1,0,0,0,1
TTGTTGGCAATGACTG-1_V10B01-087_A1,3,1,0,0,0,4
GGTGGGATTAGGTCCC-1_V10B01-087_A1,1,0,0,0,2,3
GAGGTCCGTTCGCTGT-1_V10B01-087_A1,5,0,0,0,0,5
AGCTAAGCTCCGTCCG-1_V10B01-087_A1,2,0,1,0,1,4
CCCAGATTCCCGTGAC-1_V10B01-087_A1,1,0,0,0,1,2
ACAAACTCCATCAGAG-1_V10B01-087_A1,2,0,0,0,0,2
TTGCGGAAAGCTGCCC-1_V10B01-087_A1,0,0,0,0,1,1
GGTTACCGCTCCCTAC-1_V10B01-087_A1,0,0,0,0,0,0
CCGTTTCCTTTCCGTG-1_V10B01-087_A1,3,0,0,0,0,3
CAAGTCGTTGAAATCT-1_V10B01-087_A1,1,1,0,0,0,2
GGCTGTCCTACTGCGG-1_V10B01-087_A1,2,1,0,0,2,5
CGGACCTCTGTAGTTA-1_V10B01-087_A1,3,0,0,0,2,5
GTAACAGGTTAACGGC-1_V10B01-087_A1,3,0,0,0,1,4
AATCCCGCTCAGAGCC-1_V10B01-087_A1,4,0,0,0,0,4
CTCGTGGCACTGAAAG-1_V10B01-087_A1,2,0,1,0,1,4
AAATGACTGATCAAAC-1_V10B01-087_A1,2,0,1,0,0,3
ATCAAAGAGCCGTGGT-1_V10B01-087_A1,3,0,1,0,0,4
ATGTCATAATAAACGA-1_V10B01-087_A1,0,1,0,0,1,2
CTTAATCGACTTAGTA-1_V10B01-087_A1,0,0,0,0,0,0
CTAAAGGATGAGATAC-1_V10B01-087_A1,3,0,0,0,0,3
GTGCTATCCAGCTGGA-1_V10B01-087_A1,3,0,0,0,1,4
GACAGAGGTCTTCAGT-1_V10B01-087_A1,4,1,0,0,0,5
TCGATTTACGAAACGA-1_V10B01-087_A1,0,0,0,0,0,0
AGGCTTAAGTTGCACA-1_V10B01-087_A1,1,0,0,0,1,2
TAGGATCTTAACCGCA-1_V10B01-087_A1,5,0,1,0,0,6
GACTTTCGAGCGGTTC-1_V10B01-087_A1,5,0,0,0,0,5
CCCTGGGAGGGATCCT-1_V10B01-087_A1,2,0,1,0,0,3
TAGTAGTTGCCGGACA-1_V10B01-087_A1,10,2,0,0,1,13
GCCCTAAGTGCAGGAT-1_V10B01-087_A1,0,1,3,0,4,8
ACTTGGGCTTTCGCCA-1_V10B01-087_A1,2,0,0,0,1,3
CATGATACGGTGAAAC-1_V10B01-087_A1,0,5,3,0,3,11
TCCTGCAGCCGCCAAT-1_V10B01-087_A1,0,0,0,0,0,0
GTCCGTTAGAGGGCCT-1_V10B01-087_A1,1,2,0,0,2,5
AATCGAGGTCTCAAGG-1_V10B01-087_A1,0,0,0,0,0,0
